,atm_id,location,s_amt,w_amt,bal,ration,action
0,1,HBR Layout,170450,55450,115000,0.6746846582575535,0
1,2,Marathahalli,42100,6880,35220,0.8365795724465558,-1
2,3,Varthur,86000,54860,31140,0.36209302325581394,1
3,4,Jalahalli,286100,59970,226130,0.7903879762320867,0
4,5,Vasanth Nagar,356600,32290,324310,0.9094503645541223,-1
5,6,Vasanth Nagar,55950,46600,9350,0.1671134941912422,1
6,7,Horamavu,204050,106460,97590,0.47826513109531976,1
7,8,Kammanahalli,439650,40690,398960,0.907449107244399,-1
8,9,Banaswadi,223800,25530,198270,0.8859249329758713,-1
9,10,Horamavu,127650,61250,66400,0.5201723462593028,0
10,11,CV Raman Nagar,69000,96010,-27010,-0.3914492753623188,1
11,12,Jalahalli,105450,132930,-27480,-0.26059743954480796,1
12,13,Whitefield,182150,90430,91720,0.5035410376063684,0
13,14,Hebbal,50200,127970,-77770,-1.549203187250996,1
14,15,Mahadevapura,125050,19370,105680,0.8451019592163135,-1
15,16,CV Raman Nagar,305400,109840,195560,0.6403405370006549,0
16,17,Jalahalli,110950,96350,14600,0.13159080666967102,1
17,18,Kalyan Nagar,326600,59190,267410,0.8187691365584813,-1
18,19,Mahadevapura,346850,62750,284100,0.819086060256595,-1
19,20,Kalyan Nagar,223700,53060,170640,0.7628073312472061,0
20,21,Krishnarajapuram,289650,9950,279700,0.9656481960987399,-1
21,22,Varthur,86500,46370,40130,0.4639306358381503,1
22,23,Indiranagar,291500,62360,229140,0.7860720411663807,0
23,24,Jalahalli,162200,66280,95920,0.5913686806411838,0
24,25,Hoodi,169800,105030,64770,0.3814487632508834,1
25,26,Marathahalli,292850,145450,147400,0.5033293494963291,0
26,27,Jalahalli,403100,114090,289010,0.716968494170181,0
27,28,Varthur,407600,64740,342860,0.8411678115799803,-1
28,29,Shivajinagar,154200,32310,121890,0.7904669260700389,0
29,30,Whitefield,338450,34390,304060,0.8983897178312897,-1
30,31,Marathahalli,31200,29620,1580,0.05064102564102564,1
31,32,Krishnarajapuram,350950,9050,341900,0.9742128508334521,-1
32,33,Whitefield,264200,41520,222680,0.8428463285389857,-1
33,34,Hoodi,257750,89480,168270,0.6528419010669253,0
34,35,Rajajinagar,94600,25790,68810,0.7273784355179704,0
35,36,Varthur,274000,118880,155120,0.5661313868613139,0
36,37,Varthur,391400,45330,346070,0.8841849770056208,-1
37,38,CV Raman Nagar,420750,27090,393660,0.9356149732620321,-1
38,39,Marathahalli,128050,71090,56960,0.4448262397500976,1
39,40,HBR Layout,271850,87060,184790,0.6797498620562811,0
40,41,Hebbal,403050,67840,335210,0.8316834139684902,-1
41,42,HBR Layout,408000,50180,357820,0.8770098039215686,-1
42,43,Rajajinagar,301950,50400,251550,0.8330849478390462,-1
43,44,Kalyan Nagar,214700,133260,81440,0.3793199813693526,1
44,45,Hoodi,260050,83090,176960,0.6804845222072679,0
45,46,Whitefield,218500,21660,196840,0.9008695652173913,-1
46,47,Varthur,183500,85060,98440,0.536457765667575,0
47,48,Kammanahalli,441400,31370,410030,0.9289306751246036,-1
48,49,Hebbal,270650,30250,240400,0.8882320339922409,-1
49,50,Krishnarajapuram,144800,63550,81250,0.5611187845303868,0
50,51,Kammanahalli,200100,32880,167220,0.8356821589205398,-1
51,52,Indiranagar,358250,104550,253700,0.7081646894626658,0
52,53,CV Raman Nagar,399000,31910,367090,0.9200250626566416,-1
53,54,Hebbal,157850,51000,106850,0.6769084573962623,0
54,55,Malleswaram,217200,33750,183450,0.8446132596685083,-1
55,56,Hoodi,441050,51260,389790,0.8837773495068586,-1
56,57,Kammanahalli,283050,16190,266860,0.9428016251545663,-1
57,58,Rajajinagar,35300,35880,-580,-0.01643059490084986,1
58,59,HBR Layout,146350,77500,68850,0.4704475572258285,1
59,60,Kammanahalli,162000,70520,91480,0.5646913580246914,0
60,61,Krishnarajapuram,380800,36130,344670,0.9051207983193277,-1
61,62,Hebbal,163100,21290,141810,0.8694665849172287,-1
62,63,CV Raman Nagar,349800,55900,293900,0.8401943967981704,-1
63,64,Kammanahalli,361200,64700,296500,0.820874861572536,-1
64,65,Kalyan Nagar,216600,76630,139970,0.6462142197599261,0
65,66,Krishnarajapuram,236850,57430,179420,0.7575258602491028,0
66,67,Indiranagar,72000,103060,-31060,-0.4313888888888889,1
67,68,Krishnarajapuram,290700,66090,224610,0.7726522187822498,0
68,69,Krishnarajapuram,245450,78180,167270,0.6814829904257487,0
69,70,Kalyan Nagar,102050,65080,36970,0.3622733953944145,1
70,71,CV Raman Nagar,362400,83710,278690,0.7690121412803532,0
71,72,Mahadevapura,277250,15850,261400,0.9428313796212804,-1
72,73,Indiranagar,26150,105950,-79800,-3.051625239005736,1
73,74,Hebbal,60850,82090,-21240,-0.34905505341002463,1
74,75,Jalahalli,211100,62480,148620,0.7040265277119848,0
75,76,Mahadevapura,430150,142070,288080,0.6697198651633152,0
76,77,Malleswaram,448350,21360,426990,0.9523586483773837,-1
77,78,Indiranagar,68350,37860,30490,0.4460863204096562,1
78,79,Marathahalli,109850,154860,-45010,-0.4097405553026855,1
79,80,Jalahalli,381250,62860,318390,0.8351213114754098,-1
80,81,Jalahalli,242950,38220,204730,0.8426836797694999,-1
81,82,Rajajinagar,370900,8460,362440,0.9771906174170936,-1
82,83,Shivajinagar,168100,94690,73410,0.43670434265318264,1
83,84,Whitefield,305600,73790,231810,0.7585405759162304,0
84,85,Malleswaram,266850,97380,169470,0.6350758853288364,0
85,86,Hebbal,320950,46950,274000,0.8537155320143325,-1
86,87,Vasanth Nagar,255950,133420,122530,0.478726313733151,1
87,88,HBR Layout,221100,65010,156090,0.7059701492537314,0
88,89,Malleswaram,443650,28930,414720,0.9347909388031106,-1
89,90,Krishnarajapuram,261750,32560,229190,0.8756064947468959,-1
90,91,Kammanahalli,379850,65520,314330,0.8275108595498223,-1
91,92,Marathahalli,198800,46950,151850,0.7638329979879276,0
92,93,Rajajinagar,415000,143670,271330,0.6538072289156627,0
93,94,Varthur,440100,68440,371660,0.8444898886616679,-1
94,95,Varthur,333500,32610,300890,0.9022188905547226,-1
95,96,Horamavu,352200,60470,291730,0.8283077796706417,-1
96,97,Hoodi,336750,67840,268910,0.7985449146250928,0
97,98,Indiranagar,372550,41340,331210,0.8890350288551873,-1
98,99,Whitefield,159250,51960,107290,0.6737205651491366,0
99,100,Vasanth Nagar,200400,93960,106440,0.5311377245508982,0
100,101,Banaswadi,363700,74320,289380,0.7956557602419576,0
101,102,Whitefield,163450,90920,72530,0.4437442643010095,1
102,103,Shivajinagar,64800,58130,6670,0.10293209876543209,1
103,104,Marathahalli,300350,40520,259830,0.8650907274846013,-1
104,105,Krishnarajapuram,54400,9120,45280,0.8323529411764706,-1
105,106,Mahadevapura,212900,92490,120410,0.5655706904650071,0
106,107,Jalahalli,178550,64450,114100,0.6390366844021282,0
107,108,Banaswadi,71050,32980,38070,0.5358198451794511,0
108,109,Kalyan Nagar,245900,127810,118090,0.4802358682391216,1
109,110,Hoodi,42650,65830,-23180,-0.5434935521688159,1
110,111,Whitefield,109700,79140,30560,0.2785779398359161,1
111,112,Jalahalli,369650,4540,365110,0.9877181117273096,-1
112,113,Vasanth Nagar,84450,43040,41410,0.49034931912374186,1
113,114,Rajajinagar,134750,107690,27060,0.20081632653061224,1
114,115,HBR Layout,157450,73660,83790,0.5321689425214354,0
115,116,Krishnarajapuram,151300,44840,106460,0.7036351619299405,0
116,117,HBR Layout,292050,20210,271840,0.9307995206300291,-1
117,118,CV Raman Nagar,390450,34340,356110,0.912050198488923,-1
118,119,Vasanth Nagar,157500,0,157500,1.0,-1
119,120,Kammanahalli,173650,74320,99330,0.5720126691621077,0
120,121,Marathahalli,446100,71120,374980,0.8405738623626989,-1
121,122,Indiranagar,66400,42490,23910,0.36009036144578316,1
122,123,Rajajinagar,49500,68390,-18890,-0.38161616161616163,1
123,124,Krishnarajapuram,272500,88610,183890,0.6748256880733945,0
124,125,Vasanth Nagar,128650,82820,45830,0.356237854644384,1
125,126,Krishnarajapuram,373900,124280,249620,0.6676116608718908,0
126,127,Kalyan Nagar,236000,41200,194800,0.8254237288135593,-1
127,128,Horamavu,176900,82140,94760,0.5356698699830412,0
128,129,Indiranagar,182250,56680,125570,0.6889986282578875,0
129,130,HBR Layout,420950,29320,391630,0.930348022330443,-1
130,131,Banaswadi,233600,65450,168150,0.719820205479452,0
131,132,Hebbal,249350,67070,182280,0.731020653699619,0
132,133,Marathahalli,292550,45210,247340,0.845462314134336,-1
133,134,Varthur,340200,60230,279970,0.8229570840681952,-1
134,135,Whitefield,146200,49660,96540,0.660328317373461,0
135,136,Rajajinagar,45200,31800,13400,0.29646017699115046,1
136,137,CV Raman Nagar,248300,39750,208550,0.8399113975030206,-1
137,138,Jalahalli,226350,107180,119170,0.526485531256903,0
138,139,Vasanth Nagar,85400,61570,23830,0.27903981264637,1
139,140,Indiranagar,147250,93700,53550,0.36366723259762307,1
140,141,Rajajinagar,245850,56060,189790,0.7719747813707545,0
141,142,Hoodi,341600,24210,317390,0.9291276346604216,-1
142,143,Horamavu,82150,17250,64900,0.7900182592818016,0
143,144,Banaswadi,35250,118730,-83480,-2.36822695035461,1
144,145,HBR Layout,113850,126750,-12900,-0.11330698287220026,1
145,146,Whitefield,34950,93690,-58740,-1.6806866952789699,1
146,147,Hebbal,340100,16800,323300,0.9506027638929726,-1
147,148,Kalyan Nagar,257450,83590,173860,0.6753155952612158,0
148,149,Indiranagar,440200,38960,401240,0.9114947751022262,-1
149,150,Jalahalli,428550,74610,353940,0.8259012950647532,-1
150,151,Malleswaram,189100,105440,83660,0.4424114225277631,1
151,152,CV Raman Nagar,210550,90710,119840,0.5691759677036333,0
152,153,Malleswaram,269350,58050,211300,0.7844811583441619,0
153,154,Hebbal,167650,36170,131480,0.784252907843722,0
154,155,HBR Layout,80100,61770,18330,0.22883895131086143,1
155,156,Kammanahalli,113900,14200,99700,0.8753292361720808,-1
156,157,Hebbal,401650,80400,321250,0.7998257189094983,0
157,158,CV Raman Nagar,157600,102810,54790,0.3476522842639594,1
158,159,Mahadevapura,192600,60380,132220,0.6865005192107996,0
159,160,Vasanth Nagar,229500,68970,160530,0.6994771241830066,0
160,161,Mahadevapura,309250,78340,230910,0.746677445432498,0
161,162,Marathahalli,92900,25110,67790,0.7297093649085038,0
162,163,Whitefield,275950,46970,228980,0.8297880050733829,-1
163,164,Marathahalli,227950,44740,183210,0.8037288879140162,-1
164,165,Rajajinagar,286400,52360,234040,0.8171787709497207,-1
165,166,Kalyan Nagar,370150,52660,317490,0.8577333513440497,-1
166,167,HBR Layout,328850,87100,241750,0.735137600729816,0
167,168,Indiranagar,361400,61580,299820,0.8296070835639181,-1
168,169,Malleswaram,437200,102850,334350,0.7647529734675206,0
169,170,Rajajinagar,137950,41830,96120,0.6967741935483871,0
170,171,Kammanahalli,329100,70540,258560,0.7856578547553935,0
171,172,Horamavu,156750,150880,5870,0.0374481658692185,1
172,173,Horamavu,143300,63410,79890,0.5575017445917655,0
173,174,Rajajinagar,282000,29120,252880,0.8967375886524823,-1
174,175,Hebbal,373750,93280,280470,0.7504214046822743,0
175,176,Shivajinagar,31450,21020,10430,0.331637519872814,1
176,177,Hoodi,95650,24780,70870,0.7409304756926294,0
177,178,Marathahalli,196850,44610,152240,0.7733807467614935,0
178,179,Malleswaram,127900,23160,104740,0.818921032056294,-1
179,180,Banaswadi,429950,20090,409860,0.9532736364693569,-1
180,181,Horamavu,38400,58280,-19880,-0.5177083333333333,1
181,182,Kalyan Nagar,412050,123070,288980,0.7013226550175949,0
182,183,Shivajinagar,60600,67190,-6590,-0.10874587458745874,1
183,184,HBR Layout,99900,92490,7410,0.07417417417417417,1
184,185,Krishnarajapuram,64600,76360,-11760,-0.18204334365325078,1
185,186,HBR Layout,368700,15120,353580,0.9589910496338486,-1
186,187,Krishnarajapuram,41650,106180,-64530,-1.5493397358943577,1
187,188,Mahadevapura,388450,104520,283930,0.7309306217016347,0
188,189,Rajajinagar,381700,48370,333330,0.873277443018077,-1
189,190,Whitefield,349400,67530,281870,0.8067258156840298,-1
190,191,Banaswadi,239050,48920,190130,0.7953566199539845,0
191,192,Mahadevapura,424400,83350,341050,0.8036050895381716,-1
192,193,Horamavu,433850,33740,400110,0.9222311858937421,-1
193,194,CV Raman Nagar,271250,139660,131590,0.48512442396313366,1
194,195,Banaswadi,320850,36670,284180,0.8857098332554153,-1
195,196,HBR Layout,228050,41540,186510,0.8178469633852226,-1
196,197,HBR Layout,157550,127190,30360,0.1927007299270073,1
197,198,Marathahalli,384800,60960,323840,0.8415800415800416,-1
198,199,Varthur,404050,41900,362150,0.8962999628758817,-1
199,200,Marathahalli,123600,10500,113100,0.9150485436893204,-1
200,201,Hoodi,440500,75650,364850,0.8282633371169126,-1
201,202,Krishnarajapuram,393050,40810,352240,0.8961709706144256,-1
202,203,Banaswadi,201400,50230,151170,0.7505958291956306,0
203,204,Hoodi,109900,22870,87030,0.791901728844404,0
204,205,Varthur,165750,107770,57980,0.34980392156862744,1
205,206,Jalahalli,68750,104680,-35930,-0.5226181818181819,1
206,207,Hebbal,94000,63590,30410,0.32351063829787235,1
207,208,Horamavu,131600,107630,23970,0.18214285714285713,1
208,209,HBR Layout,282400,57930,224470,0.7948654390934844,0
209,210,Marathahalli,163100,55480,107620,0.6598405885959534,0
210,211,Shivajinagar,254450,14800,239650,0.9418353311063077,-1
211,212,CV Raman Nagar,195400,90850,104550,0.5350562947799385,0
212,213,Varthur,400000,47620,352380,0.88095,-1
213,214,Kammanahalli,424850,76060,348790,0.8209721078027539,-1
214,215,Horamavu,181150,113470,67680,0.37361302787744965,1
215,216,Mahadevapura,376750,78220,298530,0.7923822163238221,0
216,217,Rajajinagar,349350,102410,246940,0.7068555889509088,0
217,218,Banaswadi,272350,39980,232370,0.8532035983109969,-1
218,219,Hoodi,350250,46950,303300,0.8659528907922912,-1
219,220,Jalahalli,420600,45650,374950,0.8914645744174988,-1
220,221,HBR Layout,396250,78340,317910,0.8022965299684542,-1
221,222,Malleswaram,381800,62130,319670,0.8372708224201152,-1
222,223,Mahadevapura,339700,45700,294000,0.865469531939947,-1
223,224,Hoodi,386700,52970,333730,0.8630204292733386,-1
224,225,Vasanth Nagar,383950,73610,310340,0.8082823284281807,-1
225,226,Shivajinagar,273300,68220,205080,0.750384193194292,0
226,227,HBR Layout,256700,40530,216170,0.8421114141020647,-1
227,228,Shivajinagar,59800,74770,-14970,-0.25033444816053513,1
228,229,Whitefield,105350,79260,26090,0.24765068818224964,1
229,230,Hoodi,261200,69810,191390,0.7327335375191424,0
230,231,Whitefield,195050,54980,140070,0.7181235580620354,0
231,232,Kalyan Nagar,150250,105100,45150,0.3004991680532446,1
232,233,Marathahalli,100250,58430,41820,0.4171571072319202,1
233,234,HBR Layout,146300,32560,113740,0.7774436090225564,0
234,235,Whitefield,328050,30670,297380,0.9065081542447797,-1
235,236,HBR Layout,332800,62290,270510,0.8128305288461538,-1
236,237,Krishnarajapuram,327500,109400,218100,0.6659541984732824,0
237,238,Indiranagar,173400,139690,33710,0.19440599769319492,1
238,239,Mahadevapura,354250,51910,302340,0.8534650670430487,-1
239,240,Horamavu,61550,17110,44440,0.7220146222583266,0
240,241,Jalahalli,83600,46700,36900,0.44138755980861244,1
241,242,HBR Layout,315700,41420,274280,0.868799493189737,-1
242,243,CV Raman Nagar,30100,46420,-16320,-0.5421926910299003,1
243,244,Shivajinagar,263400,62950,200450,0.7610098709187547,0
244,245,Hebbal,116250,106370,9880,0.08498924731182796,1
245,246,Hoodi,378700,50420,328280,0.8668603115922894,-1
246,247,Malleswaram,359500,50090,309410,0.8606675938803894,-1
247,248,Banaswadi,212750,42880,169870,0.798448883666275,0
248,249,Jalahalli,235150,15820,219330,0.9327237933234106,-1
249,250,Varthur,26150,41070,-14920,-0.5705544933078394,1
250,251,CV Raman Nagar,397700,33860,363840,0.9148604475735479,-1
251,252,HBR Layout,36950,11890,25060,0.6782138024357239,0
252,253,Kalyan Nagar,270350,65110,205240,0.7591640466062511,0
253,254,Vasanth Nagar,380850,72610,308240,0.8093475121438887,-1
254,255,Banaswadi,267350,77170,190180,0.71135216008977,0
255,256,Jalahalli,208000,55800,152200,0.7317307692307692,0
256,257,Hoodi,350550,97900,252650,0.7207245756668093,0
257,258,Shivajinagar,139500,69140,70360,0.5043727598566308,0
258,259,Varthur,232400,62460,169940,0.7312392426850258,0
259,260,Hoodi,322000,43360,278640,0.8653416149068323,-1
260,261,Rajajinagar,371400,22740,348660,0.9387722132471729,-1
261,262,Marathahalli,389150,40560,348590,0.8957728382371836,-1
262,263,Whitefield,105850,40310,65540,0.6191780821917808,0
263,264,Hebbal,191750,123180,68570,0.35760104302477186,1
264,265,Whitefield,116050,101790,14260,0.12287806979750107,1
265,266,CV Raman Nagar,346400,87060,259340,0.7486720554272517,0
266,267,Kalyan Nagar,275300,54190,221110,0.8031601888848529,-1
267,268,Malleswaram,427850,10280,417570,0.9759728876942854,-1
268,269,Hoodi,131950,48480,83470,0.6325881015536188,0
269,270,Horamavu,127000,79310,47690,0.375511811023622,1
270,271,Marathahalli,264450,45910,218540,0.8263944034789185,-1
271,272,CV Raman Nagar,175200,72700,102500,0.5850456621004566,0
272,273,Kalyan Nagar,409300,55860,353440,0.8635230881993647,-1
273,274,Krishnarajapuram,79500,54530,24970,0.3140880503144654,1
274,275,CV Raman Nagar,377900,110260,267640,0.7082296903942842,0
275,276,Horamavu,387000,26500,360500,0.9315245478036176,-1
276,277,Malleswaram,178200,82740,95460,0.5356902356902357,0
277,278,Marathahalli,51900,71490,-19590,-0.37745664739884394,1
278,279,Kalyan Nagar,145200,14980,130220,0.896831955922865,-1
279,280,Hebbal,117450,106210,11240,0.09570029799914857,1
280,281,Hoodi,156250,43730,112520,0.720128,0
281,282,Indiranagar,384500,71040,313460,0.8152405721716515,-1
282,283,Marathahalli,170850,72400,98450,0.5762364647351478,0
283,284,Whitefield,210700,70650,140050,0.6646891314665401,0
284,285,Malleswaram,182450,53910,128540,0.7045217867909016,0
285,286,Banaswadi,325000,50030,274970,0.8460615384615384,-1
286,287,Marathahalli,237050,92890,144160,0.6081417422484708,0
287,288,Shivajinagar,276750,26390,250360,0.904643179765131,-1
288,289,Mahadevapura,407600,66140,341460,0.8377330716388617,-1
289,290,Banaswadi,158900,51810,107090,0.6739458779106356,0
290,291,Vasanth Nagar,31250,53640,-22390,-0.71648,1
291,292,Marathahalli,177100,67490,109610,0.6189158667419536,0
292,293,Rajajinagar,45550,40930,4620,0.10142700329308452,1
293,294,Malleswaram,419700,22510,397190,0.9463664522277817,-1
294,295,Varthur,92000,155310,-63310,-0.6881521739130435,1
295,296,Krishnarajapuram,369750,68170,301580,0.8156321839080459,-1
296,297,Marathahalli,287500,80420,207080,0.7202782608695653,0
297,298,Banaswadi,387050,114890,272160,0.7031649657666968,0
298,299,Shivajinagar,395850,115080,280770,0.7092838196286472,0
299,300,Horamavu,321700,85520,236180,0.7341622629779297,0
300,301,Banaswadi,297900,28030,269870,0.9059080228264518,-1
301,302,Whitefield,314700,67600,247100,0.7851922465840483,0
302,303,Hoodi,317400,87470,229930,0.7244171392564587,0
303,304,Horamavu,304650,162120,142530,0.46784835056622354,1
304,305,Jalahalli,363050,66270,296780,0.8174631593444429,-1
305,306,Varthur,289300,72080,217220,0.7508468717594193,0
306,307,Varthur,414050,66120,347930,0.8403091414080425,-1
307,308,Kammanahalli,193850,57610,136240,0.7028114521537271,0
308,309,Rajajinagar,156200,90680,65520,0.41946222791293214,1
309,310,Rajajinagar,295500,101560,193940,0.6563113367174281,0
310,311,Krishnarajapuram,392750,31500,361250,0.9197963080840229,-1
311,312,Hebbal,444950,121440,323510,0.727070457354759,0
312,313,Indiranagar,374800,62690,312110,0.8327374599786553,-1
313,314,Jalahalli,430800,37060,393740,0.9139740018570102,-1
314,315,Hoodi,393600,108180,285420,0.7251524390243902,0
315,316,Rajajinagar,98400,47450,50950,0.5177845528455285,0
316,317,Banaswadi,198850,67100,131750,0.662559718380689,0
317,318,Mahadevapura,249650,103790,145860,0.5842579611456038,0
318,319,Kalyan Nagar,210150,49510,160640,0.7644063763978111,0
319,320,HBR Layout,338400,61170,277230,0.8192375886524823,-1
320,321,Indiranagar,38050,74070,-36020,-0.9466491458607096,1
321,322,Jalahalli,132950,54530,78420,0.5898458066942459,0
322,323,Krishnarajapuram,442950,27730,415220,0.9373969974037701,-1
323,324,Vasanth Nagar,381950,32240,349710,0.9155910459484226,-1
324,325,Horamavu,165450,127370,38080,0.23016016923541854,1
325,326,Kammanahalli,258000,42110,215890,0.8367829457364341,-1
326,327,Banaswadi,170250,8000,162250,0.9530102790014684,-1
327,328,Banaswadi,158200,51560,106640,0.6740834386852086,0
328,329,Vasanth Nagar,171450,91670,79780,0.4653251676873724,1
329,330,Shivajinagar,48450,86200,-37750,-0.7791537667698658,1
330,331,Jalahalli,229150,53720,175430,0.7655684049749073,0
331,332,Hoodi,264150,70550,193600,0.7329169032746545,0
332,333,Kammanahalli,205250,33660,171590,0.8360048721071863,-1
333,334,Hebbal,417850,93760,324090,0.7756132583462965,0
334,335,Malleswaram,317000,38270,278730,0.8792744479495268,-1
335,336,Marathahalli,356900,42780,314120,0.8801344914541889,-1
336,337,Whitefield,322000,27440,294560,0.9147826086956522,-1
337,338,Hebbal,267550,42640,224910,0.8406279200149505,-1
338,339,Indiranagar,284100,53760,230340,0.8107708553326294,-1
339,340,Rajajinagar,171150,68770,102380,0.5981887233420976,0
340,341,CV Raman Nagar,210250,101790,108460,0.5158620689655172,0
341,342,Marathahalli,365700,33030,332670,0.9096800656275635,-1
342,343,Krishnarajapuram,140300,66160,74140,0.5284390591589451,0
343,344,HBR Layout,100500,67790,32710,0.3254726368159204,1
344,345,Mahadevapura,334650,26600,308050,0.9205139698192141,-1
345,346,Hoodi,112050,66470,45580,0.4067826863007586,1
346,347,Marathahalli,428400,73420,354980,0.8286181139122316,-1
347,348,Shivajinagar,150500,48990,101510,0.674485049833887,0
348,349,Horamavu,240850,122300,118550,0.4922150716213411,1
349,350,Hoodi,394900,110180,284720,0.7209926563687009,0
350,351,Jalahalli,128650,79730,48920,0.38025650991061016,1
351,352,Marathahalli,400000,103330,296670,0.741675,0
352,353,Kammanahalli,198000,45650,152350,0.7694444444444445,0
353,354,Hoodi,372800,53660,319140,0.8560622317596567,-1
354,355,Horamavu,103700,29780,73920,0.7128254580520733,0
355,356,Whitefield,266800,114090,152710,0.572376311844078,0
356,357,Jalahalli,279550,25000,254550,0.9105705598282955,-1
357,358,Hoodi,357650,109400,248250,0.6941143576121906,0
358,359,Kalyan Nagar,258500,64890,193610,0.7489748549323018,0
359,360,Kammanahalli,82050,82700,-650,-0.007921998781230956,1
360,361,Indiranagar,98550,32580,65970,0.6694063926940639,0
361,362,Hoodi,66800,71080,-4280,-0.06407185628742515,1
362,363,Vasanth Nagar,54900,30610,24290,0.4424408014571949,1
363,364,Hoodi,56400,9810,46590,0.826063829787234,-1
364,365,Hoodi,343900,59450,284450,0.8271299796452457,-1
365,366,Horamavu,221200,85200,136000,0.6148282097649186,0
366,367,Vasanth Nagar,205900,60820,145080,0.7046138902379796,0
367,368,Hoodi,114950,100100,14850,0.1291866028708134,1
368,369,CV Raman Nagar,76600,105060,-28460,-0.37154046997389034,1
369,370,Kalyan Nagar,311800,93860,217940,0.6989737010904425,0
370,371,Hoodi,304300,105340,198960,0.6538284587578048,0
371,372,Shivajinagar,323150,46630,276520,0.8557016865232864,-1
372,373,Mahadevapura,289300,45940,243360,0.841202903560318,-1
373,374,Mahadevapura,285150,74820,210330,0.7376117832719621,0
374,375,Hoodi,374950,69310,305640,0.8151486864915322,-1
375,376,Marathahalli,248700,45730,202970,0.8161238439887415,-1
376,377,Indiranagar,285750,121970,163780,0.5731583552055993,0
377,378,Malleswaram,80250,56460,23790,0.2964485981308411,1
378,379,Malleswaram,120550,36670,83880,0.695810866860224,0
379,380,Jalahalli,393700,84670,309030,0.7849377698755398,0
380,381,Varthur,353150,110780,242370,0.6863089338807872,0
381,382,Marathahalli,210300,88490,121810,0.5792201616737993,0
382,383,Indiranagar,417200,91490,325710,0.7807046979865772,0
383,384,Whitefield,279000,44270,234730,0.8413261648745519,-1
384,385,Krishnarajapuram,339400,61580,277820,0.8185621685327048,-1
385,386,Marathahalli,387100,65300,321800,0.8313097390855076,-1
386,387,Banaswadi,132950,53750,79200,0.5957126739375705,0
387,388,Varthur,68850,69420,-570,-0.008278867102396514,1
388,389,Rajajinagar,44000,43440,560,0.012727272727272728,1
389,390,Marathahalli,197500,65560,131940,0.6680506329113924,0
390,391,Marathahalli,236050,95930,140120,0.5936030502012285,0
391,392,Kammanahalli,148500,35720,112780,0.7594612794612795,0
392,393,Kammanahalli,337500,51460,286040,0.8475259259259259,-1
393,394,Whitefield,73850,19000,54850,0.7427217332430602,0
394,395,HBR Layout,383100,48020,335080,0.8746541373009658,-1
395,396,Banaswadi,229350,30880,198470,0.8653586221931545,-1
396,397,Marathahalli,328600,71930,256670,0.7811016433353621,0
397,398,Indiranagar,256350,58870,197480,0.7703530329627463,0
398,399,Rajajinagar,234400,53270,181130,0.7727389078498293,0
399,400,Hoodi,54950,58930,-3980,-0.0724294813466788,1
400,401,Rajajinagar,434100,93960,340140,0.7835521769177609,0
401,402,CV Raman Nagar,32450,72720,-40270,-1.2409861325115563,1
402,403,Hebbal,244250,89690,154560,0.6327942681678608,0
403,404,Whitefield,296500,57790,238710,0.8050927487352445,-1
404,405,Hebbal,35850,41230,-5380,-0.1500697350069735,1
405,406,Varthur,374800,63590,311210,0.8303361792956243,-1
406,407,Varthur,160000,32400,127600,0.7975,0
407,408,Vasanth Nagar,227550,57160,170390,0.748802460997583,0
408,409,Rajajinagar,42200,149520,-107320,-2.543127962085308,1
409,410,Rajajinagar,244450,82830,161620,0.6611577009613417,0
410,411,CV Raman Nagar,293950,30720,263230,0.8954924306854908,-1
411,412,Banaswadi,177650,50100,127550,0.7179848015761329,0
412,413,Jalahalli,130850,24480,106370,0.8129155521589606,-1
413,414,Hebbal,299850,38410,261440,0.8719026179756545,-1
414,415,Rajajinagar,416250,20710,395540,0.9502462462462462,-1
415,416,Mahadevapura,107550,10720,96830,0.900325430032543,-1
416,417,Malleswaram,27200,84920,-57720,-2.1220588235294118,1
417,418,Whitefield,374950,34910,340040,0.906894252567009,-1
418,419,CV Raman Nagar,261800,60510,201290,0.7688693659281894,0
419,420,Shivajinagar,101200,74920,26280,0.25968379446640316,1
420,421,Vasanth Nagar,26500,37900,-11400,-0.43018867924528303,1
421,422,Vasanth Nagar,433300,48170,385130,0.8888299099930764,-1
422,423,Varthur,420000,150140,269860,0.6425238095238095,0
423,424,Whitefield,101100,97090,4010,0.03966369930761622,1
424,425,Banaswadi,425900,48290,377610,0.8866165766611881,-1
425,426,HBR Layout,182300,23600,158700,0.8705430608886451,-1
426,427,Rajajinagar,275450,28480,246970,0.8966055545471048,-1
427,428,Hoodi,38750,104190,-65440,-1.688774193548387,1
428,429,Marathahalli,221250,95110,126140,0.5701242937853107,0
429,430,Rajajinagar,85450,43650,41800,0.489174956114687,1
430,431,Varthur,326500,75070,251430,0.7700765696784073,0
431,432,Mahadevapura,58550,54560,3990,0.06814688300597779,1
432,433,Krishnarajapuram,245950,40300,205650,0.836145558040252,-1
433,434,Shivajinagar,322750,54930,267820,0.8298063516653756,-1
434,435,Whitefield,308250,93890,214360,0.6954095701540957,0
435,436,Banaswadi,136450,72180,64270,0.47101502381824845,1
436,437,Hoodi,348000,87340,260660,0.7490229885057471,0
437,438,HBR Layout,60000,13920,46080,0.768,0
438,439,HBR Layout,344100,16510,327590,0.952019761697181,-1
439,440,Rajajinagar,196550,50280,146270,0.7441872297125414,0
440,441,Shivajinagar,98100,71360,26740,0.272579001019368,1
441,442,Whitefield,393000,70400,322600,0.8208651399491094,-1
442,443,Rajajinagar,59200,84680,-25480,-0.4304054054054054,1
443,444,Horamavu,217750,63890,153860,0.7065901262916189,0
444,445,Whitefield,35450,47170,-11720,-0.3306064880112835,1
445,446,Krishnarajapuram,273550,81630,191920,0.7015902028879547,0
446,447,Mahadevapura,372350,40530,331820,0.8911507989794548,-1
447,448,Mahadevapura,247450,47680,199770,0.8073146090119216,-1
448,449,Jalahalli,406050,66130,339920,0.8371382834626278,-1
449,450,Mahadevapura,182350,107150,75200,0.4123937482862627,1
450,451,Jalahalli,313600,62530,251070,0.8006058673469387,-1
451,452,Krishnarajapuram,427600,46140,381460,0.8920954162768943,-1
452,453,HBR Layout,361100,58410,302690,0.8382442536693436,-1
453,454,Mahadevapura,424300,31040,393260,0.9268442139995287,-1
454,455,Shivajinagar,54850,26610,28240,0.5148587055606199,0
455,456,Mahadevapura,239250,55750,183500,0.7669801462904912,0
456,457,Marathahalli,249200,63680,185520,0.74446227929374,0
457,458,Whitefield,36950,81280,-44330,-1.1997293640054127,1
458,459,Banaswadi,176950,38730,138220,0.7811246114721673,0
459,460,Varthur,187900,46380,141520,0.7531665779670037,0
460,461,Vasanth Nagar,333850,15450,318400,0.9537217313164595,-1
461,462,Kalyan Nagar,268850,115250,153600,0.5713222986795611,0
462,463,Varthur,396400,86980,309420,0.7805751765893038,0
463,464,Rajajinagar,65700,59980,5720,0.08706240487062405,1
464,465,Rajajinagar,245800,5910,239890,0.9759560618388934,-1
465,466,Mahadevapura,49800,48030,1770,0.035542168674698796,1
466,467,CV Raman Nagar,419850,49810,370040,0.881362391330237,-1
467,468,Varthur,98750,68200,30550,0.30936708860759493,1
468,469,Horamavu,404300,23320,380980,0.94232005936186,-1
469,470,Banaswadi,440200,40220,399980,0.9086324398000909,-1
470,471,Whitefield,332400,133340,199060,0.5988567990373045,0
471,472,Kammanahalli,185300,37600,147700,0.7970858067997841,0
472,473,Malleswaram,166250,42040,124210,0.7471278195488722,0
473,474,Rajajinagar,251850,43160,208690,0.8286281516775859,-1
474,475,Jalahalli,72350,103290,-30940,-0.427643400138217,1
475,476,Kalyan Nagar,194900,104060,90840,0.46608517188301696,1
476,477,Horamavu,388900,6370,382530,0.9836204679866289,-1
477,478,Hoodi,300000,90410,209590,0.6986333333333333,0
478,479,Vasanth Nagar,439400,158570,280830,0.6391215293582158,0
479,480,Marathahalli,87600,86230,1370,0.015639269406392695,1
480,481,Marathahalli,107850,92410,15440,0.14316179879462215,1
481,482,Malleswaram,25200,129890,-104690,-4.154365079365079,1
482,483,Indiranagar,191150,65040,126110,0.6597436568140204,0
483,484,Vasanth Nagar,356950,40400,316550,0.886818882196386,-1
484,485,Kalyan Nagar,321550,62930,258620,0.8042917120199036,-1
485,486,Hoodi,239250,66810,172440,0.7207523510971787,0
486,487,Marathahalli,165900,77050,88850,0.5355635925256178,0
487,488,Whitefield,264500,55450,209050,0.790359168241966,0
488,489,Whitefield,41350,72220,-30870,-0.7465538089480048,1
489,490,Mahadevapura,203450,35530,167920,0.8253624969279921,-1
490,491,Banaswadi,412100,22800,389300,0.9446736229070614,-1
491,492,Shivajinagar,381100,68950,312150,0.8190763579113094,-1
492,493,Indiranagar,363200,55370,307830,0.8475495594713657,-1
493,494,Krishnarajapuram,167050,58290,108760,0.6510625561209219,0
494,495,Jalahalli,373400,15820,357580,0.9576325656132834,-1
495,496,Whitefield,308000,15590,292410,0.9493831168831168,-1
496,497,HBR Layout,276000,24160,251840,0.912463768115942,-1
497,498,Hoodi,250450,53900,196550,0.78478738271112,0
498,499,Marathahalli,81300,80460,840,0.010332103321033211,1
499,500,Vasanth Nagar,25450,51790,-26340,-1.0349705304518664,1
500,501,Indiranagar,310050,104700,205350,0.6623125302370585,0
501,502,Whitefield,129500,102990,26510,0.20471042471042472,1
502,503,Malleswaram,190300,76150,114150,0.5998423541776143,0
503,504,Banaswadi,204000,63430,140570,0.6890686274509804,0
504,505,Malleswaram,178200,85060,93140,0.5226711560044893,0
505,506,Rajajinagar,199400,60650,138750,0.6958375125376128,0
506,507,Jalahalli,40700,43970,-3270,-0.08034398034398034,1
507,508,Jalahalli,410400,55430,354970,0.8649366471734893,-1
508,509,Horamavu,154650,16470,138180,0.8935014548981571,-1
509,510,Vasanth Nagar,220400,53990,166410,0.7550362976406534,0
510,511,Horamavu,138400,50850,87550,0.6325867052023122,0
511,512,Mahadevapura,177050,59300,117750,0.6650663654334934,0
512,513,Malleswaram,336450,64460,271990,0.8084113538415812,-1
513,514,Kammanahalli,325150,63520,261630,0.8046440104567123,-1
514,515,Shivajinagar,373650,91040,282610,0.7563495249565101,0
515,516,Hebbal,216250,82380,133870,0.6190520231213873,0
516,517,CV Raman Nagar,340400,56580,283820,0.8337837837837838,-1
517,518,Marathahalli,398000,80280,317720,0.7982914572864321,0
518,519,Jalahalli,240050,33630,206420,0.8599041866277859,-1
519,520,Jalahalli,418150,42430,375720,0.8985292359201243,-1
520,521,Malleswaram,104050,80950,23100,0.22200864968765016,1
521,522,Marathahalli,360400,82420,277980,0.7713096559378468,0
522,523,Marathahalli,325250,77550,247700,0.7615680245964642,0
523,524,Horamavu,440750,89900,350850,0.7960294951786727,0
524,525,Vasanth Nagar,353250,58240,295010,0.8351309271054494,-1
525,526,CV Raman Nagar,165050,115110,49940,0.30257497727961224,1
526,527,Whitefield,172350,43200,129150,0.7493472584856397,0
527,528,Malleswaram,373050,121760,251290,0.6736094357324756,0
528,529,Malleswaram,298950,91510,207440,0.6938953002174276,0
529,530,Varthur,319100,23420,295680,0.9266060795988719,-1
530,531,Whitefield,77950,58820,19130,0.24541372674791534,1
531,532,Jalahalli,66850,65450,1400,0.020942408376963352,1
532,533,Shivajinagar,171550,68270,103280,0.6020402215097639,0
533,534,Marathahalli,299450,65200,234250,0.782267490399065,0
534,535,Malleswaram,171200,57500,113700,0.6641355140186916,0
535,536,HBR Layout,417450,66200,351250,0.8414181339082525,-1
536,537,Varthur,49150,59300,-10150,-0.20651068158697863,1
537,538,HBR Layout,168250,20530,147720,0.8779791976225855,-1
538,539,Rajajinagar,173000,38510,134490,0.7773988439306359,0
539,540,Horamavu,129950,37370,92580,0.7124278568680261,0
540,541,HBR Layout,387950,64220,323730,0.8344632040211367,-1
541,542,Shivajinagar,440250,58470,381780,0.8671890971039182,-1
542,543,Vasanth Nagar,303950,27590,276360,0.9092284915282118,-1
543,544,Kammanahalli,53650,12580,41070,0.7655172413793103,0
544,545,Banaswadi,191300,113330,77970,0.40757971772085727,1
545,546,Kammanahalli,242300,81040,161260,0.6655385885266198,0
546,547,HBR Layout,440400,18640,421760,0.9576748410535877,-1
547,548,Varthur,370550,71860,298690,0.8060720550532992,-1
548,549,Banaswadi,307600,57480,250120,0.8131339401820546,-1
549,550,Vasanth Nagar,67250,10000,57250,0.8513011152416357,-1
550,551,Rajajinagar,65450,32330,33120,0.506035141329259,0
551,552,Mahadevapura,210850,59700,151150,0.716860327246858,0
552,553,Kammanahalli,45650,21670,23980,0.5253012048192771,0
553,554,Whitefield,78400,48970,29430,0.3753826530612245,1
554,555,Vasanth Nagar,93700,87700,6000,0.064034151547492,1
555,556,Krishnarajapuram,61600,51040,10560,0.17142857142857143,1
556,557,Hoodi,259050,50340,208710,0.8056745801968732,-1
557,558,Kalyan Nagar,92800,79970,12830,0.13825431034482757,1
558,559,Rajajinagar,368600,89550,279050,0.7570537167661422,0
559,560,Kammanahalli,169350,24090,145260,0.8577502214348981,-1
560,561,HBR Layout,362850,122310,240540,0.6629185613890037,0
561,562,HBR Layout,337700,79210,258490,0.7654427006218537,0
562,563,Banaswadi,110850,101180,9670,0.08723500225529995,1
563,564,Rajajinagar,360700,66190,294510,0.8164957028001109,-1
564,565,Indiranagar,203500,89470,114030,0.5603439803439804,0
565,566,Hebbal,45350,133160,-87810,-1.9362734288864387,1
566,567,Hebbal,155250,91110,64140,0.4131400966183575,1
567,568,Hoodi,33350,47190,-13840,-0.41499250374812596,1
568,569,Shivajinagar,57200,76150,-18950,-0.3312937062937063,1
569,570,Whitefield,55900,95950,-40050,-0.7164579606440071,1
570,571,Indiranagar,68750,54410,14340,0.20858181818181817,1
571,572,Indiranagar,47350,89560,-42210,-0.8914466737064414,1
572,573,Banaswadi,128150,108150,20000,0.15606710885680844,1
573,574,Vasanth Nagar,197050,44370,152680,0.7748287236741944,0
574,575,Marathahalli,235800,106800,129000,0.5470737913486005,0
575,576,Rajajinagar,220500,34260,186240,0.844625850340136,-1
576,577,Varthur,115050,48810,66240,0.5757496740547589,0
577,578,Kammanahalli,38650,24280,14370,0.3717981888745149,1
578,579,HBR Layout,123450,112520,10930,0.08853786958282706,1
579,580,Whitefield,319350,70790,248560,0.7783309848129012,0
580,581,Krishnarajapuram,113350,67810,45540,0.40176444640494047,1
581,582,CV Raman Nagar,119750,6030,113720,0.9496450939457203,-1
582,583,Whitefield,216100,101470,114630,0.5304488662656178,0
583,584,Mahadevapura,46000,36310,9690,0.21065217391304347,1
584,585,Marathahalli,84250,77960,6290,0.07465875370919882,1
585,586,Kammanahalli,377050,33230,343820,0.9118684524598859,-1
586,587,Varthur,110500,29320,81180,0.7346606334841629,0
587,588,Hoodi,25650,92900,-67250,-2.621832358674464,1
588,589,Krishnarajapuram,135000,43470,91530,0.678,0
589,590,CV Raman Nagar,428800,77670,351130,0.818866604477612,-1
590,591,Shivajinagar,73850,69240,4610,0.06242383209207854,1
591,592,Vasanth Nagar,161800,5460,156340,0.9662546353522867,-1
592,593,Indiranagar,84950,58720,26230,0.3087698646262507,1
593,594,Horamavu,43750,31540,12210,0.27908571428571427,1
594,595,Shivajinagar,440900,138990,301910,0.6847584486278068,0
595,596,Vasanth Nagar,100950,102420,-1470,-0.014561664190193165,1
596,597,Vasanth Nagar,412150,129520,282630,0.6857454810141939,0
597,598,Krishnarajapuram,89050,35840,53210,0.5975294778214486,0
598,599,CV Raman Nagar,102050,85830,16220,0.15894169524742774,1
599,600,CV Raman Nagar,319950,72140,247810,0.7745272698859197,0
600,601,Whitefield,130350,104550,25800,0.19792865362485615,1
601,602,Kammanahalli,197450,29560,167890,0.8502912129653076,-1
602,603,Shivajinagar,127750,15290,112460,0.8803131115459882,-1
603,604,Kammanahalli,436950,49110,387840,0.887607277720563,-1
604,605,Marathahalli,375700,141380,234320,0.6236891136545116,0
605,606,Kalyan Nagar,217500,90730,126770,0.5828505747126437,0
606,607,Vasanth Nagar,326350,61670,264680,0.8110311015780604,-1
607,608,Malleswaram,176000,50640,125360,0.7122727272727273,0
608,609,HBR Layout,278350,40330,238020,0.8551104724268008,-1
609,610,Kalyan Nagar,310350,58140,252210,0.8126631222812953,-1
610,611,Hoodi,75450,85160,-9710,-0.12869449966865473,1
611,612,Mahadevapura,153000,37200,115800,0.7568627450980392,0
612,613,Shivajinagar,45400,76030,-30630,-0.6746696035242291,1
613,614,Rajajinagar,327050,45140,281910,0.8619782907812261,-1
614,615,Jalahalli,368750,61160,307590,0.834142372881356,-1
615,616,Banaswadi,337600,43650,293950,0.8707049763033176,-1
616,617,Kalyan Nagar,335650,73840,261810,0.780008937881722,0
617,618,Whitefield,80950,60220,20730,0.2560840024706609,1
618,619,Banaswadi,414200,87650,326550,0.7883872525350072,0
619,620,Whitefield,174650,53590,121060,0.6931577440595477,0
620,621,Varthur,49150,65100,-15950,-0.32451678535096645,1
621,622,CV Raman Nagar,119750,87170,32580,0.27206680584551146,1
622,623,Krishnarajapuram,391950,76260,315690,0.8054343666283965,-1
623,624,Marathahalli,304250,108810,195440,0.6423664749383731,0
624,625,Vasanth Nagar,155550,81260,74290,0.47759562841530057,1
625,626,Mahadevapura,163400,78830,84570,0.5175642594859241,0
626,627,Whitefield,343150,66460,276690,0.8063237651172956,-1
627,628,Vasanth Nagar,30850,80350,-49500,-1.6045380875202593,1
628,629,HBR Layout,211250,19620,191630,0.9071242603550296,-1
629,630,Kammanahalli,380300,87670,292630,0.7694714698921904,0
630,631,Malleswaram,175750,5790,169960,0.9670554765291607,-1
631,632,Kammanahalli,350000,51010,298990,0.8542571428571428,-1
632,633,Banaswadi,76150,131660,-55510,-0.7289560078791858,1
633,634,Hebbal,59000,40990,18010,0.3052542372881356,1
634,635,Hebbal,81500,51710,29790,0.36552147239263805,1
635,636,Hebbal,223900,196910,26990,0.12054488610987048,1
636,637,Malleswaram,394600,15250,379350,0.9613532691332995,-1
637,638,Horamavu,328900,54280,274620,0.8349650349650349,-1
638,639,Banaswadi,119600,64160,55440,0.4635451505016722,1
639,640,Jalahalli,224700,110540,114160,0.5080551846906987,0
640,641,Hoodi,194550,93290,101260,0.5204831662811616,0
641,642,Horamavu,182500,134310,48190,0.2640547945205479,1
642,643,Indiranagar,148900,115610,33290,0.22357286769644055,1
643,644,Varthur,279300,44820,234480,0.8395273899033298,-1
644,645,HBR Layout,112750,31280,81470,0.7225720620842572,0
645,646,Rajajinagar,214300,118250,96050,0.4482034531031265,1
646,647,Hoodi,422350,54690,367660,0.8705102403220079,-1
647,648,Kammanahalli,330550,108070,222480,0.6730600514294358,0
648,649,Indiranagar,254550,82500,172050,0.6758986446670595,0
649,650,Rajajinagar,314000,144720,169280,0.5391082802547771,0
650,651,Rajajinagar,276700,96850,179850,0.6499819298879653,0
651,652,Mahadevapura,167950,63090,104860,0.6243524858588866,0
652,653,Whitefield,446450,38850,407600,0.9129801769515064,-1
653,654,Malleswaram,47450,81700,-34250,-0.7218124341412012,1
654,655,Horamavu,122600,84480,38120,0.3109298531810767,1
655,656,Whitefield,274800,62110,212690,0.773981077147016,0
656,657,Hoodi,204850,108240,96610,0.4716133756407127,1
657,658,Jalahalli,203000,81770,121230,0.597192118226601,0
658,659,Krishnarajapuram,126400,30430,95970,0.759256329113924,0
659,660,Horamavu,353950,41570,312380,0.8825540330555163,-1
660,661,CV Raman Nagar,101950,35030,66920,0.6564001961745954,0
661,662,Hebbal,63900,42200,21700,0.3395931142410016,1
662,663,Jalahalli,436550,48610,387940,0.8886496392165846,-1
663,664,Hoodi,35400,58110,-22710,-0.6415254237288136,1
664,665,Malleswaram,434550,98080,336470,0.7742952479576574,0
665,666,Indiranagar,303700,59910,243790,0.8027329601580507,-1
666,667,Hoodi,281900,83440,198460,0.7040085136573253,0
667,668,Kammanahalli,60350,106270,-45920,-0.7608947804473902,1
668,669,Hebbal,392650,63770,328880,0.8375907296574557,-1
669,670,CV Raman Nagar,369900,13520,356380,0.9634495809678292,-1
670,671,Mahadevapura,353050,67820,285230,0.8079025633762923,-1
671,672,Varthur,380850,26980,353870,0.9291584613364842,-1
672,673,Kammanahalli,165800,99410,66390,0.40042219541616403,1
673,674,Kammanahalli,418650,75430,343220,0.8198256300011943,-1
674,675,HBR Layout,89150,154870,-65720,-0.737184520471116,1
675,676,Marathahalli,133650,134910,-1260,-0.009427609427609427,1
676,677,Rajajinagar,30900,45020,-14120,-0.456957928802589,1
677,678,CV Raman Nagar,131250,44410,86840,0.6616380952380952,0
678,679,Krishnarajapuram,237400,50280,187120,0.7882055602358888,0
679,680,Vasanth Nagar,276000,91420,184580,0.668768115942029,0
680,681,Hebbal,195500,60670,134830,0.6896675191815856,0
681,682,Jalahalli,69400,42830,26570,0.3828530259365994,1
682,683,Rajajinagar,278200,38610,239590,0.861214953271028,-1
683,684,Kammanahalli,51600,47580,4020,0.07790697674418605,1
684,685,Mahadevapura,309500,116070,193430,0.6249757673667206,0
685,686,Marathahalli,339750,7570,332180,0.977718910963944,-1
686,687,Marathahalli,425550,71730,353820,0.8314416637292915,-1
687,688,Indiranagar,90200,44910,45290,0.5021064301552106,0
688,689,Banaswadi,85650,14020,71630,0.8363105662580268,-1
689,690,Hebbal,125400,33790,91610,0.730542264752791,0
690,691,Hebbal,28350,56460,-28110,-0.9915343915343915,1
691,692,Horamavu,216500,47990,168510,0.778337182448037,0
692,693,Malleswaram,55400,52440,2960,0.053429602888086646,1
693,694,Vasanth Nagar,174650,42740,131910,0.7552819925565416,0
694,695,Kammanahalli,381400,48030,333370,0.874069218668065,-1
695,696,Rajajinagar,332050,38130,293920,0.8851678964011445,-1
696,697,Banaswadi,373350,79310,294040,0.7875719833935985,0
697,698,Horamavu,310750,23830,286920,0.9233145615446501,-1
698,699,Krishnarajapuram,96750,71320,25430,0.2628423772609819,1
699,700,Hoodi,411600,76120,335480,0.8150631681243926,-1
700,701,Whitefield,317250,53020,264230,0.832876280535855,-1
701,702,Malleswaram,364800,76780,288020,0.7895285087719298,0
702,703,Kalyan Nagar,26950,103480,-76530,-2.8397031539888684,1
703,704,Shivajinagar,313650,13980,299670,0.955428024868484,-1
704,705,Malleswaram,385250,27270,357980,0.929214795587281,-1
705,706,Hoodi,142450,35560,106890,0.7503685503685503,0
706,707,Marathahalli,325950,37150,288800,0.8860254640282252,-1
707,708,Vasanth Nagar,235050,134960,100090,0.42582429270368005,1
708,709,CV Raman Nagar,325450,86140,239310,0.735320325702873,0
709,710,Hoodi,44650,77540,-32890,-0.7366181410974244,1
710,711,Kammanahalli,261650,45460,216190,0.8262564494553793,-1
711,712,Indiranagar,197850,74820,123030,0.6218347232752085,0
712,713,HBR Layout,282600,55530,227070,0.8035031847133758,-1
713,714,Banaswadi,177050,92720,84330,0.4763061282123694,1
714,715,Indiranagar,80150,55800,24350,0.3038053649407361,1
715,716,Jalahalli,213900,16490,197410,0.9229079008882656,-1
716,717,Kammanahalli,438100,18820,419280,0.9570417712850947,-1
717,718,Marathahalli,295400,87270,208130,0.7045700744752877,0
718,719,Krishnarajapuram,396000,21430,374570,0.9458838383838384,-1
719,720,Malleswaram,190700,94970,95730,0.5019926586261143,0
720,721,Shivajinagar,71450,80790,-9340,-0.13072078376487054,1
721,722,Jalahalli,52400,71380,-18980,-0.36221374045801524,1
722,723,Indiranagar,332300,56600,275700,0.829671983147758,-1
723,724,Hebbal,301200,6580,294620,0.9781540504648074,-1
724,725,Shivajinagar,302200,95190,207010,0.6850099272005294,0
725,726,Banaswadi,246800,6640,240160,0.9730956239870341,-1
726,727,Marathahalli,383250,88780,294470,0.7683496412263535,0
727,728,Kammanahalli,442000,0,442000,1.0,-1
728,729,HBR Layout,244850,86780,158070,0.6455789258729835,0
729,730,Whitefield,54850,73770,-18920,-0.34494074749316317,1
730,731,Kalyan Nagar,335500,88370,247130,0.7366020864381521,0
731,732,Hebbal,80850,123260,-42410,-0.5245516388373531,1
732,733,Marathahalli,440100,83920,356180,0.8093160645307884,-1
733,734,Varthur,323400,53990,269410,0.8330550401978973,-1
734,735,Malleswaram,166750,66610,100140,0.6005397301349326,0
735,736,Vasanth Nagar,258600,64290,194310,0.7513921113689095,0
736,737,Hoodi,298550,79750,218800,0.7328755652319544,0
737,738,Varthur,249900,36890,213010,0.8523809523809524,-1
738,739,Banaswadi,119200,93490,25710,0.21568791946308724,1
739,740,Indiranagar,155850,32670,123180,0.7903753609239653,0
740,741,Horamavu,247900,97210,150690,0.6078660750302541,0
741,742,Indiranagar,297400,112520,184880,0.621654337592468,0
742,743,Malleswaram,61100,28210,32890,0.5382978723404256,0
743,744,Whitefield,163350,77780,85570,0.5238445056626875,0
744,745,Vasanth Nagar,352700,101170,251530,0.7131556563651829,0
745,746,Marathahalli,163800,124390,39410,0.2405982905982906,1
746,747,Indiranagar,67400,78100,-10700,-0.15875370919881307,1
747,748,Malleswaram,198000,100950,97050,0.49015151515151517,1
748,749,Kammanahalli,239000,35640,203360,0.8508786610878661,-1
749,750,Hoodi,105050,72930,32120,0.3057591623036649,1
750,751,HBR Layout,135000,109830,25170,0.18644444444444444,1
751,752,Rajajinagar,348200,70400,277800,0.7978173463526709,0
752,753,Whitefield,34000,96120,-62120,-1.8270588235294118,1
753,754,Whitefield,313500,125500,188000,0.5996810207336523,0
754,755,Indiranagar,54700,17790,36910,0.6747714808043875,0
755,756,Hoodi,45100,39160,5940,0.13170731707317074,1
756,757,Hoodi,46450,30980,15470,0.33304628632938643,1
757,758,Shivajinagar,375150,48490,326660,0.8707450353192057,-1
758,759,Vasanth Nagar,128850,39040,89810,0.697012029491657,0
759,760,Shivajinagar,276950,117590,159360,0.575410723957393,0
760,761,Mahadevapura,99600,43790,55810,0.5603413654618474,0
761,762,Kammanahalli,239400,60120,179280,0.7488721804511278,0
762,763,Kalyan Nagar,146050,70930,75120,0.5143444026018487,0
763,764,Whitefield,266600,34960,231640,0.8688672168042011,-1
764,765,Vasanth Nagar,429100,128420,300680,0.7007224423211372,0
765,766,Varthur,137900,69750,68150,0.4941986947063089,1
766,767,Shivajinagar,444250,90830,353420,0.795543050084412,0
767,768,Marathahalli,445250,59980,385270,0.8652891633913532,-1
768,769,Hoodi,425950,96480,329470,0.7734945416128653,0
769,770,HBR Layout,56650,58450,-1800,-0.03177405119152692,1
770,771,Horamavu,326150,136900,189250,0.5802544841330676,0
771,772,Kammanahalli,252800,62470,190330,0.7528876582278481,0
772,773,CV Raman Nagar,242700,27410,215290,0.8870622167284714,-1
773,774,Malleswaram,73600,59330,14270,0.1938858695652174,1
774,775,Jalahalli,271900,83030,188870,0.6946303788157411,0
775,776,Marathahalli,32150,49600,-17450,-0.5427682737169518,1
776,777,HBR Layout,246250,98660,147590,0.5993502538071066,0
777,778,Whitefield,325750,64450,261300,0.8021488871834229,-1
778,779,Marathahalli,114550,66240,48310,0.42173723264949803,1
779,780,Jalahalli,53900,19650,34250,0.6354359925788498,0
780,781,Indiranagar,166650,50240,116410,0.6985298529852986,0
781,782,Horamavu,279350,44080,235270,0.8422051190263111,-1
782,783,Hoodi,140600,97460,43140,0.30682788051209103,1
783,784,Whitefield,398400,59750,338650,0.8500251004016064,-1
784,785,Marathahalli,169350,53380,115970,0.6847948036610569,0
785,786,Mahadevapura,187350,100220,87130,0.4650653856418468,1
786,787,Marathahalli,50150,51820,-1670,-0.033300099700897305,1
787,788,Krishnarajapuram,364400,30130,334270,0.9173161361141603,-1
788,789,Horamavu,374350,91020,283330,0.7568585548283692,0
789,790,Vasanth Nagar,371350,65920,305430,0.8224855257843006,-1
790,791,Hoodi,397250,143810,253440,0.6379861548143486,0
791,792,Horamavu,63450,134630,-71180,-1.1218282111899134,1
792,793,Rajajinagar,124850,51900,72950,0.5843011613936724,0
793,794,Varthur,85950,70670,15280,0.17777777777777778,1
794,795,Shivajinagar,308100,82710,225390,0.7315481986368062,0
795,796,Jalahalli,202550,31900,170650,0.8425080227104419,-1
796,797,Whitefield,103650,123270,-19620,-0.18929088277858178,1
797,798,CV Raman Nagar,316750,34140,282610,0.8922178374112075,-1
798,799,Shivajinagar,442850,193360,249490,0.5633736028000451,0
799,800,Banaswadi,248250,23960,224290,0.903484390735146,-1
800,801,Mahadevapura,299000,53160,245840,0.8222073578595318,-1
801,802,CV Raman Nagar,261150,32980,228170,0.873712425808922,-1
802,803,Vasanth Nagar,383800,41050,342750,0.8930432516935904,-1
803,804,Shivajinagar,88250,45750,42500,0.48158640226628896,1
804,805,Marathahalli,436750,68110,368640,0.8440526617057813,-1
805,806,Jalahalli,343600,63630,279970,0.814813736903376,-1
806,807,CV Raman Nagar,165700,37930,127770,0.7710923355461677,0
807,808,Indiranagar,65750,76200,-10450,-0.15893536121673005,1
808,809,Malleswaram,236650,59220,177430,0.7497570251426157,0
809,810,Varthur,410500,88690,321810,0.7839464068209501,0
810,811,Horamavu,197600,54510,143090,0.7241396761133603,0
811,812,CV Raman Nagar,437900,94210,343690,0.7848595569764787,0
812,813,Varthur,189350,24900,164450,0.868497491418009,-1
813,814,Rajajinagar,214550,60440,154110,0.7182941039384759,0
814,815,Banaswadi,269450,108770,160680,0.596325848951568,0
815,816,Vasanth Nagar,121200,164090,-42890,-0.3538778877887789,1
816,817,Hebbal,234200,94730,139470,0.5955166524338172,0
817,818,Whitefield,350450,104650,245800,0.7013839349407904,0
818,819,Hoodi,199350,9040,190310,0.9546526210183095,-1
819,820,Hoodi,209000,39980,169020,0.8087081339712918,-1
820,821,Krishnarajapuram,410950,121090,289860,0.7053412823944519,0
821,822,Horamavu,277000,20450,256550,0.9261732851985559,-1
822,823,CV Raman Nagar,245550,36330,209220,0.8520464263897374,-1
823,824,Indiranagar,48900,74150,-25250,-0.516359918200409,1
824,825,Kammanahalli,401800,68700,333100,0.829019412643106,-1
825,826,Hoodi,204450,26110,178340,0.8722915138175593,-1
826,827,Jalahalli,251400,75370,176030,0.7001988862370724,0
827,828,Malleswaram,195750,35530,160220,0.8184929757343551,-1
828,829,Horamavu,147150,50020,97130,0.6600747536527353,0
829,830,Rajajinagar,424050,34300,389750,0.919113312109421,-1
830,831,Hoodi,404600,97520,307080,0.7589718240237271,0
831,832,Mahadevapura,283350,98450,184900,0.652549850008823,0
832,833,Kalyan Nagar,374100,96810,277290,0.7412189254210104,0
833,834,Malleswaram,123850,86180,37670,0.304158255954784,1
834,835,Kalyan Nagar,161900,92560,69340,0.4282890673255096,1
835,836,Indiranagar,137450,64850,72600,0.5281920698435795,0
836,837,Shivajinagar,185400,60500,124900,0.6736785329018339,0
837,838,CV Raman Nagar,25800,115950,-90150,-3.494186046511628,1
838,839,Jalahalli,88150,56490,31660,0.3591605218377765,1
839,840,Indiranagar,112150,34600,77550,0.6914846188140883,0
840,841,Horamavu,363500,100190,263310,0.7243741403026135,0
841,842,Kalyan Nagar,329400,58890,270510,0.8212204007285975,-1
842,843,Hebbal,274150,72860,201290,0.7342330840780594,0
843,844,Krishnarajapuram,69050,34950,34100,0.49384503982621286,1
844,845,Rajajinagar,352100,36370,315730,0.8967054813973303,-1
845,846,Mahadevapura,207200,66740,140460,0.6778957528957529,0
846,847,Malleswaram,108850,40970,67880,0.623610473128158,0
847,848,Marathahalli,98700,48970,49730,0.5038500506585613,0
848,849,Hebbal,287600,78500,209100,0.7270514603616134,0
849,850,Malleswaram,298950,69900,229050,0.7661816357250376,0
850,851,Kammanahalli,258950,67490,191460,0.7393705348522881,0
851,852,Varthur,300350,78390,221960,0.7390044947561178,0
852,853,Horamavu,33250,29440,3810,0.11458646616541353,1
853,854,HBR Layout,142550,63810,78740,0.5523675903191863,0
854,855,Horamavu,288350,24800,263550,0.9139934107855038,-1
855,856,Horamavu,76700,75880,820,0.010691003911342895,1
856,857,Mahadevapura,215700,32170,183530,0.8508576726935558,-1
857,858,Krishnarajapuram,371300,46780,324520,0.8740102343118772,-1
858,859,Indiranagar,437450,135900,301550,0.6893359241056121,0
859,860,Mahadevapura,212850,61970,150880,0.7088560018792577,0
860,861,Rajajinagar,381250,59510,321740,0.8439081967213115,-1
861,862,Mahadevapura,162900,42320,120580,0.7402087170042971,0
862,863,Jalahalli,402500,54900,347600,0.8636024844720497,-1
863,864,Shivajinagar,438750,29850,408900,0.931965811965812,-1
864,865,Jalahalli,221200,86380,134820,0.609493670886076,0
865,866,Horamavu,376700,106380,270320,0.7176002123705867,0
866,867,Hebbal,246600,82360,164240,0.6660178426601784,0
867,868,Banaswadi,174650,53920,120730,0.6912682507872888,0
868,869,Hebbal,360250,42000,318250,0.8834142956280361,-1
869,870,Malleswaram,64550,67010,-2460,-0.03810999225406662,1
870,871,Hebbal,426450,32080,394370,0.924774299448939,-1
871,872,Mahadevapura,147450,109340,38110,0.258460495083079,1
872,873,Kalyan Nagar,148550,11970,136580,0.9194210703466846,-1
873,874,Whitefield,236950,77100,159850,0.6746148976577337,0
874,875,Hoodi,66750,51830,14920,0.22352059925093634,1
875,876,Varthur,86100,95610,-9510,-0.11045296167247387,1
876,877,Whitefield,361850,22170,339680,0.9387315185850491,-1
877,878,Vasanth Nagar,179450,1840,177610,0.9897464474784062,-1
878,879,Indiranagar,391400,45180,346220,0.8845682166581502,-1
879,880,Shivajinagar,309900,43320,266580,0.8602129719264279,-1
880,881,CV Raman Nagar,206250,101820,104430,0.5063272727272727,0
881,882,CV Raman Nagar,40600,83940,-43340,-1.067487684729064,1
882,883,Hoodi,210100,154530,55570,0.26449309852451214,1
883,884,Rajajinagar,119900,58080,61820,0.5155963302752293,0
884,885,HBR Layout,43350,85760,-42410,-0.9783160322952711,1
885,886,Kalyan Nagar,252450,56180,196270,0.7774608833432363,0
886,887,Horamavu,233650,57480,176170,0.7539910121977317,0
887,888,Shivajinagar,222550,54420,168130,0.7554706807458998,0
888,889,Shivajinagar,390400,105010,285390,0.7310194672131147,0
889,890,Shivajinagar,166400,69460,96940,0.5825721153846154,0
890,891,Shivajinagar,123700,123250,450,0.003637833468067906,1
891,892,Varthur,227900,86480,141420,0.6205353225098728,0
892,893,Shivajinagar,432850,49300,383550,0.8861037310846713,-1
893,894,CV Raman Nagar,405800,67500,338300,0.8336619024149827,-1
894,895,Rajajinagar,229200,75400,153800,0.6710296684118674,0
895,896,Malleswaram,334850,60870,273980,0.8182171121397641,-1
896,897,Horamavu,409400,83020,326380,0.7972154372252076,0
897,898,Jalahalli,363000,51040,311960,0.8593939393939394,-1
898,899,Mahadevapura,355100,92380,262720,0.7398479301605182,0
899,900,Shivajinagar,91750,48250,43500,0.47411444141689374,1
900,901,Hoodi,118800,111340,7460,0.06279461279461279,1
901,902,Horamavu,199900,55460,144440,0.7225612806403202,0
902,903,Mahadevapura,418050,2990,415060,0.9928477454849899,-1
903,904,Rajajinagar,98550,73500,25050,0.2541856925418569,1
904,905,Krishnarajapuram,359750,48200,311550,0.8660180681028492,-1
905,906,Malleswaram,173750,136860,36890,0.21231654676258993,1
906,907,Rajajinagar,247500,103700,143800,0.581010101010101,0
907,908,Horamavu,133500,9440,124060,0.9292883895131087,-1
908,909,Krishnarajapuram,136750,117920,18830,0.1376965265082267,1
909,910,Indiranagar,414250,56870,357380,0.8627157513578757,-1
910,911,Horamavu,244500,43890,200610,0.8204907975460123,-1
911,912,Indiranagar,36100,34310,1790,0.04958448753462604,1
912,913,HBR Layout,58200,74730,-16530,-0.284020618556701,1
913,914,Hebbal,268500,7000,261500,0.9739292364990689,-1
914,915,Indiranagar,442600,54540,388060,0.8767736104835065,-1
915,916,Hoodi,196450,23450,173000,0.8806312038686689,-1
916,917,Marathahalli,217450,64380,153070,0.7039319383766383,0
917,918,Hoodi,137850,36990,100860,0.731664853101197,0
918,919,Whitefield,124750,99080,25670,0.20577154308617235,1
919,920,Kalyan Nagar,117350,53550,63800,0.5436727737537281,0
920,921,Krishnarajapuram,109400,64530,44870,0.41014625228519197,1
921,922,CV Raman Nagar,84650,94360,-9710,-0.11470761961015948,1
922,923,Indiranagar,100600,41040,59560,0.5920477137176938,0
923,924,Rajajinagar,107200,109050,-1850,-0.017257462686567165,1
924,925,Mahadevapura,102400,100110,2290,0.02236328125,1
925,926,Mahadevapura,402550,76250,326300,0.8105825363308906,-1
926,927,Marathahalli,27550,55520,-27970,-1.01524500907441,1
927,928,Hoodi,427250,10780,416470,0.9747688706846109,-1
928,929,Banaswadi,256450,28380,228070,0.8893351530512771,-1
929,930,Rajajinagar,56550,174510,-117960,-2.085941644562334,1
930,931,Krishnarajapuram,415600,61540,354060,0.8519249278152069,-1
931,932,CV Raman Nagar,310500,69270,241230,0.7769082125603864,0
932,933,Whitefield,414150,45730,368420,0.8895810696607509,-1
933,934,Kammanahalli,447950,25420,422530,0.9432525951557094,-1
934,935,Hoodi,27000,85940,-58940,-2.182962962962963,1
935,936,Vasanth Nagar,131250,41640,89610,0.6827428571428571,0
936,937,Hoodi,269100,50780,218320,0.8112969156447417,-1
937,938,Kammanahalli,369900,47320,322580,0.872073533387402,-1
938,939,Kammanahalli,270000,29940,240060,0.8891111111111111,-1
939,940,Varthur,428650,86870,341780,0.7973404875772775,0
940,941,Vasanth Nagar,299650,94850,204800,0.6834640413816119,0
941,942,Indiranagar,87600,68510,19090,0.21792237442922374,1
942,943,Vasanth Nagar,309650,44380,265270,0.8566768932665914,-1
943,944,Jalahalli,332500,49530,282970,0.8510375939849624,-1
944,945,Whitefield,151850,36770,115080,0.7578531445505433,0
945,946,Whitefield,301350,14700,286650,0.9512195121951219,-1
946,947,Krishnarajapuram,191250,15510,175740,0.9189019607843137,-1
947,948,Varthur,73250,71110,2140,0.029215017064846416,1
948,949,Indiranagar,447850,48630,399220,0.8914145361170035,-1
949,950,CV Raman Nagar,32900,31610,1290,0.039209726443768994,1
950,951,Mahadevapura,427500,67280,360220,0.8426198830409357,-1
951,952,CV Raman Nagar,425400,76710,348690,0.8196755994358251,-1
952,953,Hoodi,271150,62540,208610,0.7693527567766919,0
953,954,Hoodi,93850,78480,15370,0.16377197655833778,1
954,955,Malleswaram,270000,91130,178870,0.6624814814814814,0
955,956,Krishnarajapuram,347100,57760,289340,0.8335926246038605,-1
956,957,Rajajinagar,390900,111210,279690,0.7155026861089793,0
957,958,Whitefield,155900,69560,86340,0.5538165490699166,0
958,959,Indiranagar,246850,35300,211550,0.8569981770305853,-1
959,960,Whitefield,197450,21330,176120,0.8919726513041276,-1
960,961,Rajajinagar,256700,20420,236280,0.9204518893650175,-1
961,962,Shivajinagar,318300,67200,251100,0.7888784165881244,0
962,963,Shivajinagar,32100,57720,-25620,-0.7981308411214953,1
963,964,Marathahalli,348500,28020,320480,0.9195982783357245,-1
964,965,Hoodi,159000,32330,126670,0.7966666666666666,0
965,966,Marathahalli,235100,78860,156240,0.664568268821778,0
966,967,Indiranagar,292400,33970,258430,0.8838235294117647,-1
967,968,Jalahalli,417750,114260,303490,0.7264871334530222,0
968,969,Vasanth Nagar,64200,89150,-24950,-0.3886292834890966,1
969,970,Banaswadi,366400,49570,316830,0.8647106986899563,-1
970,971,Hebbal,33700,40130,-6430,-0.19080118694362017,1
971,972,Shivajinagar,261100,38420,222680,0.8528533129069322,-1
972,973,Shivajinagar,449050,62470,386580,0.8608840886315555,-1
973,974,Kalyan Nagar,285800,71800,214000,0.7487753673897831,0
974,975,Whitefield,88000,54330,33670,0.3826136363636364,1
975,976,Hebbal,427800,52650,375150,0.8769284712482468,-1
976,977,Banaswadi,334950,32400,302550,0.903269144648455,-1
977,978,Whitefield,446500,71020,375480,0.8409406494960806,-1
978,979,Marathahalli,311100,49090,262010,0.8422050787528126,-1
979,980,Mahadevapura,210800,46050,164750,0.7815464895635673,0
980,981,Indiranagar,241850,39100,202750,0.8383295431052306,-1
981,982,Jalahalli,397200,73200,324000,0.8157099697885196,-1
982,983,Indiranagar,87650,47240,40410,0.46103822019395324,1
983,984,Malleswaram,98000,50560,47440,0.4840816326530612,1
984,985,Vasanth Nagar,326350,115910,210440,0.6448291711352842,0
985,986,Hoodi,431900,90090,341810,0.7914100486223663,0
986,987,Banaswadi,309950,53740,256210,0.8266171963219874,-1
987,988,Whitefield,388750,5490,383260,0.9858778135048232,-1
988,989,Mahadevapura,188100,52170,135930,0.7226475279106858,0
989,990,Hoodi,341700,51670,290030,0.848785484342991,-1
990,991,Kalyan Nagar,178450,57740,120710,0.6764359764639956,0
991,992,CV Raman Nagar,53600,163440,-109840,-2.0492537313432835,1
992,993,Banaswadi,371750,35850,335900,0.9035642232683255,-1
993,994,Kalyan Nagar,66650,15790,50860,0.7630907726931733,0
994,995,HBR Layout,141100,79380,61720,0.4374202693125443,1
995,996,Hoodi,341150,112980,228170,0.6688260296057452,0
996,997,Hoodi,372200,23490,348710,0.9368887694787749,-1
997,998,Banaswadi,187950,37500,150450,0.8004788507581804,-1
998,999,Indiranagar,100050,38370,61680,0.6164917541229386,0
999,1000,Indiranagar,304350,84910,219440,0.7210119927714802,0
1000,1001,Kalyan Nagar,358500,82770,275730,0.7691213389121339,0
1001,1002,Shivajinagar,422750,115740,307010,0.7262211709047901,0
1002,1003,Rajajinagar,366950,25830,341120,0.929608938547486,-1
1003,1004,HBR Layout,259100,73990,185110,0.7144345812427634,0
1004,1005,Marathahalli,291850,41810,250040,0.8567414767860202,-1
1005,1006,Whitefield,312700,96560,216140,0.6912056283978254,0
1006,1007,Malleswaram,25550,87150,-61600,-2.410958904109589,1
1007,1008,Varthur,55650,0,55650,1.0,-1
1008,1009,Indiranagar,140750,125950,14800,0.10515097690941386,1
1009,1010,Horamavu,96000,26190,69810,0.7271875,0
1010,1011,Vasanth Nagar,131900,59390,72510,0.5497346474601971,0
1011,1012,HBR Layout,31900,56340,-24440,-0.7661442006269592,1
1012,1013,HBR Layout,43100,50450,-7350,-0.17053364269141533,1
1013,1014,Malleswaram,84800,90010,-5210,-0.06143867924528302,1
1014,1015,Krishnarajapuram,112100,96840,15260,0.136128456735058,1
1015,1016,Whitefield,315950,104010,211940,0.6708023421427441,0
1016,1017,Shivajinagar,198550,49460,149090,0.7508939813648955,0
1017,1018,Indiranagar,244600,78700,165900,0.678250204415372,0
1018,1019,Jalahalli,429400,73670,355730,0.8284350256171402,-1
1019,1020,Vasanth Nagar,240150,44260,195890,0.815698521757235,-1
1020,1021,Malleswaram,381350,109250,272100,0.713517765831913,0
1021,1022,Vasanth Nagar,103150,118890,-15740,-0.15259331071255453,1
1022,1023,Marathahalli,249000,52380,196620,0.7896385542168675,0
1023,1024,Indiranagar,203650,34090,169560,0.8326049594893199,-1
1024,1025,Indiranagar,316350,52530,263820,0.8339497392128971,-1
1025,1026,Mahadevapura,177300,25190,152110,0.8579244218838128,-1
1026,1027,Kalyan Nagar,410000,54390,355610,0.8673414634146341,-1
1027,1028,Shivajinagar,438000,47980,390020,0.8904566210045662,-1
1028,1029,Mahadevapura,392050,37370,354680,0.9046805254431832,-1
1029,1030,Kalyan Nagar,254850,11350,243500,0.9554639984304493,-1
1030,1031,Kammanahalli,84700,60990,23710,0.27992916174734356,1
1031,1032,Whitefield,96350,65530,30820,0.31987545407368967,1
1032,1033,Kammanahalli,249550,29130,220420,0.88326988579443,-1
1033,1034,Banaswadi,74200,76200,-2000,-0.026954177897574125,1
1034,1035,HBR Layout,137950,74930,63020,0.4568321855744835,1
1035,1036,Kalyan Nagar,410650,23280,387370,0.9433093875563132,-1
1036,1037,Whitefield,391600,94190,297410,0.7594739530132788,0
1037,1038,Horamavu,387200,84440,302760,0.7819214876033058,0
1038,1039,Malleswaram,315250,32500,282750,0.8969072164948454,-1
1039,1040,Jalahalli,214950,39320,175630,0.8170737380786229,-1
1040,1041,Whitefield,400900,84660,316240,0.7888251434272886,0
1041,1042,Shivajinagar,256650,84110,172540,0.672277420611728,0
1042,1043,Whitefield,345950,56820,289130,0.8357566122272004,-1
1043,1044,Malleswaram,137400,77280,60120,0.4375545851528384,1
1044,1045,Hoodi,154800,50950,103850,0.6708656330749354,0
1045,1046,Kammanahalli,220950,95370,125580,0.5683638832315003,0
1046,1047,Vasanth Nagar,144950,93280,51670,0.3564677474991376,1
1047,1048,Whitefield,222100,174480,47620,0.21440792435839712,1
1048,1049,Vasanth Nagar,323700,58390,265310,0.8196169292554835,-1
1049,1050,CV Raman Nagar,233250,27820,205430,0.8807288317256163,-1
1050,1051,Kammanahalli,87550,137940,-50390,-0.5755568246716162,1
1051,1052,Mahadevapura,132800,28260,104540,0.7871987951807229,0
1052,1053,CV Raman Nagar,33000,145390,-112390,-3.4057575757575758,1
1053,1054,Shivajinagar,208350,41100,167250,0.802735781137509,-1
1054,1055,Hebbal,239500,55020,184480,0.7702713987473904,0
1055,1056,Hoodi,302600,182910,119690,0.3955386649041639,1
1056,1057,Marathahalli,174750,58800,115950,0.663519313304721,0
1057,1058,HBR Layout,209000,37710,171290,0.8195693779904306,-1
1058,1059,Horamavu,78550,55580,22970,0.29242520687460216,1
1059,1060,Vasanth Nagar,154450,67490,86960,0.5630301068306895,0
1060,1061,Shivajinagar,270500,49780,220720,0.8159704251386322,-1
1061,1062,Marathahalli,417200,0,417200,1.0,-1
1062,1063,Hoodi,315950,45770,270180,0.8551353062193385,-1
1063,1064,Banaswadi,421450,84520,336930,0.7994542650373709,0
1064,1065,Horamavu,375800,88180,287620,0.7653539116551357,0
1065,1066,Shivajinagar,121850,104020,17830,0.14632745178498152,1
1066,1067,Hebbal,417150,31220,385930,0.9251588157737025,-1
1067,1068,Varthur,422850,26500,396350,0.9373300224665957,-1
1068,1069,Rajajinagar,283550,82130,201420,0.7103509081290778,0
1069,1070,Horamavu,247650,54040,193610,0.781788814859681,0
1070,1071,Whitefield,294900,44380,250520,0.8495083079009834,-1
1071,1072,Kalyan Nagar,328350,56250,272100,0.8286888990406578,-1
1072,1073,Shivajinagar,55000,79550,-24550,-0.44636363636363635,1
1073,1074,HBR Layout,46850,59750,-12900,-0.2753468516542156,1
1074,1075,Horamavu,374150,26540,347610,0.9290658826673794,-1
1075,1076,Hoodi,38550,16180,22370,0.5802853437094683,0
1076,1077,Kammanahalli,399100,13130,385970,0.967100977198697,-1
1077,1078,Hoodi,444900,82270,362630,0.8150820409080692,-1
1078,1079,Malleswaram,185250,41920,143330,0.7737112010796221,0
1079,1080,Banaswadi,225850,103130,122720,0.543369493026345,0
1080,1081,Hoodi,414100,54540,359560,0.8682926829268293,-1
1081,1082,Hebbal,339400,62110,277290,0.8170005892751915,-1
1082,1083,Krishnarajapuram,224900,41580,183320,0.8151178301467319,-1
1083,1084,Krishnarajapuram,257300,36460,220840,0.8582977069568597,-1
1084,1085,CV Raman Nagar,257250,27500,229750,0.8931000971817298,-1
1085,1086,Whitefield,371750,107200,264550,0.7116341627437794,0
1086,1087,Mahadevapura,144900,45400,99500,0.6866804692891649,0
1087,1088,Vasanth Nagar,388250,97450,290800,0.7490019317450096,0
1088,1089,Kalyan Nagar,220600,44100,176500,0.800090661831369,-1
1089,1090,Banaswadi,356800,67710,289090,0.8102298206278027,-1
1090,1091,CV Raman Nagar,64750,186840,-122090,-1.8855598455598455,1
1091,1092,CV Raman Nagar,88300,79690,8610,0.09750849377123443,1
1092,1093,HBR Layout,207850,66160,141690,0.6816935289872504,0
1093,1094,Hebbal,42500,86020,-43520,-1.024,1
1094,1095,Vasanth Nagar,227950,43360,184590,0.8097828471155956,-1
1095,1096,Varthur,39550,82000,-42450,-1.0733249051833123,1
1096,1097,Hebbal,361100,45500,315600,0.8739961229576295,-1
1097,1098,Indiranagar,365150,20170,344980,0.9447624264001095,-1
1098,1099,Varthur,362700,112810,249890,0.6889716018748276,0
1099,1100,Indiranagar,270450,43100,227350,0.840635977075245,-1
1100,1101,Hebbal,83600,41980,41620,0.4978468899521531,1
1101,1102,Hebbal,401850,53290,348560,0.8673883289784745,-1
1102,1103,Hebbal,159500,7170,152330,0.9550470219435737,-1
1103,1104,Banaswadi,184550,39690,144860,0.7849363316174478,0
1104,1105,Mahadevapura,319150,58280,260870,0.8173899420335266,-1
1105,1106,Jalahalli,166800,66910,99890,0.5988609112709832,0
1106,1107,Rajajinagar,307750,75150,232600,0.755808285946385,0
1107,1108,Varthur,423600,30450,393150,0.9281161473087819,-1
1108,1109,HBR Layout,194550,53380,141170,0.7256232331020304,0
1109,1110,Vasanth Nagar,430000,104580,325420,0.7567906976744186,0
1110,1111,Vasanth Nagar,151950,82700,69250,0.45574202040144784,1
1111,1112,HBR Layout,415650,63040,352610,0.8483339348009142,-1
1112,1113,Kammanahalli,290250,10450,279800,0.9639965546942291,-1
1113,1114,Banaswadi,113650,103960,9690,0.08526176858776947,1
1114,1115,Marathahalli,380300,88180,292120,0.7681304233499868,0
1115,1116,Indiranagar,324000,10500,313500,0.9675925925925926,-1
1116,1117,Rajajinagar,355000,88990,266010,0.7493239436619719,0
1117,1118,Jalahalli,288400,60150,228250,0.7914355062413315,0
1118,1119,Whitefield,367700,72370,295330,0.8031819418003807,-1
1119,1120,CV Raman Nagar,215700,46990,168710,0.7821511358368104,0
1120,1121,Hebbal,136150,118290,17860,0.1311788468600808,1
1121,1122,Krishnarajapuram,124850,44940,79910,0.640048057669203,0
1122,1123,Rajajinagar,328350,60920,267430,0.8144662707476777,-1
1123,1124,Banaswadi,339550,49450,290100,0.8543660727433368,-1
1124,1125,CV Raman Nagar,321150,91080,230070,0.716394208313872,0
1125,1126,Kammanahalli,53300,89220,-35920,-0.673921200750469,1
1126,1127,Banaswadi,126800,126070,730,0.005757097791798107,1
1127,1128,Rajajinagar,42550,85210,-42660,-1.0025851938895418,1
1128,1129,Varthur,353450,65230,288220,0.8154477295232706,-1
1129,1130,HBR Layout,124800,63110,61690,0.49431089743589746,1
1130,1131,HBR Layout,104350,61920,42430,0.4066123622424533,1
1131,1132,Whitefield,413400,13990,399410,0.9661586840832124,-1
1132,1133,Shivajinagar,377300,43120,334180,0.8857142857142857,-1
1133,1134,Marathahalli,126750,26400,100350,0.7917159763313609,0
1134,1135,Whitefield,52250,61550,-9300,-0.17799043062200956,1
1135,1136,Krishnarajapuram,272000,39210,232790,0.8558455882352941,-1
1136,1137,Kammanahalli,227300,8160,219140,0.9641003079630445,-1
1137,1138,CV Raman Nagar,374150,28920,345230,0.9227047975410931,-1
1138,1139,Jalahalli,27600,101580,-73980,-2.6804347826086956,1
1139,1140,Varthur,342750,74910,267840,0.7814442013129103,0
1140,1141,Jalahalli,394050,49040,345010,0.8755487882248446,-1
1141,1142,Krishnarajapuram,418900,74130,344770,0.8230365242301265,-1
1142,1143,Kalyan Nagar,188800,40700,148100,0.784427966101695,0
1143,1144,Whitefield,416050,72370,343680,0.8260545607499099,-1
1144,1145,CV Raman Nagar,264800,109370,155430,0.5869712990936556,0
1145,1146,Jalahalli,266700,53400,213300,0.7997750281214848,0
1146,1147,Hoodi,359900,55420,304480,0.8460127813281467,-1
1147,1148,Vasanth Nagar,404600,48150,356450,0.8809935739001483,-1
1148,1149,CV Raman Nagar,424600,99600,325000,0.7654262835609986,0
1149,1150,Marathahalli,276100,96640,179460,0.6499818906193409,0
1150,1151,Kammanahalli,372850,91520,281330,0.7545393589915516,0
1151,1152,Indiranagar,424600,100000,324600,0.7644842204427696,0
1152,1153,Mahadevapura,65850,63950,1900,0.02885345482156416,1
1153,1154,Varthur,298300,59230,239070,0.8014415018437814,-1
1154,1155,Krishnarajapuram,280700,46450,234250,0.8345208407552547,-1
1155,1156,Malleswaram,109950,31160,78790,0.7165984538426557,0
1156,1157,Hebbal,384650,77440,307210,0.7986741193292604,0
1157,1158,Shivajinagar,315200,79830,235370,0.746732233502538,0
1158,1159,Kalyan Nagar,131800,94590,37210,0.28232169954476477,1
1159,1160,Kammanahalli,95350,39380,55970,0.5869952805453592,0
1160,1161,Hebbal,418150,62520,355630,0.8504842759775201,-1
1161,1162,CV Raman Nagar,286150,64650,221500,0.7740695439454831,0
1162,1163,Jalahalli,32750,80410,-47660,-1.455267175572519,1
1163,1164,Horamavu,135700,60030,75670,0.5576271186440678,0
1164,1165,Mahadevapura,211800,87940,123860,0.5847969782813975,0
1165,1166,Mahadevapura,354000,140620,213380,0.6027683615819209,0
1166,1167,Banaswadi,91500,79020,12480,0.13639344262295083,1
1167,1168,Varthur,389600,51390,338210,0.8680954825462013,-1
1168,1169,Malleswaram,329750,67650,262100,0.7948445792266868,0
1169,1170,Hoodi,224350,75200,149150,0.664809449520838,0
1170,1171,Vasanth Nagar,243350,18910,224440,0.9222929936305733,-1
1171,1172,Hebbal,233200,54140,179060,0.7678387650085763,0
1172,1173,Horamavu,192650,6110,186540,0.968284453672463,-1
1173,1174,Hoodi,105850,5380,100470,0.9491733585262163,-1
1174,1175,Krishnarajapuram,333400,32910,300490,0.9012897420515897,-1
1175,1176,CV Raman Nagar,105850,43310,62540,0.5908360888049126,0
1176,1177,Hoodi,39150,76260,-37110,-0.9478927203065134,1
1177,1178,Kammanahalli,201450,47060,154390,0.7663936460660213,0
1178,1179,Banaswadi,418000,23490,394510,0.9438038277511962,-1
1179,1180,CV Raman Nagar,274750,85540,189210,0.6886624203821656,0
1180,1181,Banaswadi,332900,88200,244700,0.735055572243917,0
1181,1182,Rajajinagar,305050,106050,199000,0.6523520734305851,0
1182,1183,Hoodi,151250,32450,118800,0.7854545454545454,0
1183,1184,Hebbal,107750,39110,68640,0.637030162412993,0
1184,1185,Malleswaram,421600,97230,324370,0.7693785578747628,0
1185,1186,Varthur,394250,58910,335340,0.850577045022194,-1
1186,1187,Rajajinagar,140150,62780,77370,0.5520513735283624,0
1187,1188,Hoodi,164650,51020,113630,0.6901305800182205,0
1188,1189,Banaswadi,105200,44320,60880,0.5787072243346008,0
1189,1190,Mahadevapura,347750,65200,282550,0.8125089863407621,-1
1190,1191,Vasanth Nagar,249750,39750,210000,0.8408408408408409,-1
1191,1192,Kalyan Nagar,119100,41800,77300,0.6490344248530646,0
1192,1193,Horamavu,162400,32630,129770,0.799076354679803,0
1193,1194,Kalyan Nagar,326500,28820,297680,0.9117304747320061,-1
1194,1195,Horamavu,94400,12270,82130,0.8700211864406779,-1
1195,1196,Jalahalli,247600,71590,176010,0.7108642972536349,0
1196,1197,Kammanahalli,222950,102460,120490,0.5404350751289527,0
1197,1198,Krishnarajapuram,411400,82660,328740,0.799076324744774,0
1198,1199,Varthur,388550,84090,304460,0.7835799768369579,0
1199,1200,Marathahalli,152350,84220,68130,0.4471939612733837,1
1200,1201,Whitefield,401700,22370,379330,0.9443116753796366,-1
1201,1202,Mahadevapura,43450,120730,-77280,-1.778596087456847,1
1202,1203,Whitefield,91700,61930,29770,0.3246455834242094,1
1203,1204,Kammanahalli,223350,37880,185470,0.8304007163644505,-1
1204,1205,Vasanth Nagar,369250,27440,341810,0.9256872037914692,-1
1205,1206,Whitefield,272000,36380,235620,0.86625,-1
1206,1207,CV Raman Nagar,295550,65270,230280,0.779157502960582,0
1207,1208,Whitefield,203300,65970,137330,0.6755041810132809,0
1208,1209,HBR Layout,277600,42470,235130,0.8470100864553314,-1
1209,1210,HBR Layout,343450,107510,235940,0.6869704469355074,0
1210,1211,Malleswaram,416650,15250,401400,0.9633985359414377,-1
1211,1212,Vasanth Nagar,364400,19310,345090,0.9470087815587267,-1
1212,1213,Banaswadi,296450,47850,248600,0.8385899814471243,-1
1213,1214,Whitefield,251100,76870,174230,0.6938669852648347,0
1214,1215,Vasanth Nagar,242500,48520,193980,0.7999175257731959,0
1215,1216,Mahadevapura,404950,88640,316310,0.7811087788615878,0
1216,1217,Marathahalli,344600,27170,317430,0.9211549622751015,-1
1217,1218,Kammanahalli,181750,101530,80220,0.44137551581843193,1
1218,1219,Kalyan Nagar,231050,46420,184630,0.7990911058212508,0
1219,1220,CV Raman Nagar,314850,132970,181880,0.5776719072574241,0
1220,1221,Hoodi,32000,71490,-39490,-1.2340625,1
1221,1222,Malleswaram,100800,61900,38900,0.38591269841269843,1
1222,1223,Kammanahalli,237150,45030,192120,0.8101201771030994,-1
1223,1224,Hoodi,155100,58690,96410,0.6215989684074791,0
1224,1225,Varthur,35050,69720,-34670,-0.9891583452211127,1
1225,1226,Jalahalli,79300,68840,10460,0.13190416141235814,1
1226,1227,Shivajinagar,50250,104780,-54530,-1.0851741293532338,1
1227,1228,Kalyan Nagar,97250,83200,14050,0.14447300771208227,1
1228,1229,Hoodi,163550,12150,151400,0.925710791806787,-1
1229,1230,Whitefield,403100,86900,316200,0.7844207392706525,0
1230,1231,Mahadevapura,440250,76400,363850,0.8264622373651335,-1
1231,1232,Varthur,119750,45280,74470,0.6218789144050104,0
1232,1233,Mahadevapura,326400,95310,231090,0.7079963235294118,0
1233,1234,Krishnarajapuram,145600,76570,69030,0.47410714285714284,1
1234,1235,Kammanahalli,349000,75310,273690,0.7842120343839541,0
1235,1236,Shivajinagar,284800,128680,156120,0.5481741573033708,0
1236,1237,Hebbal,312750,54270,258480,0.8264748201438848,-1
1237,1238,Horamavu,243450,65550,177900,0.7307455329636475,0
1238,1239,Horamavu,227500,66720,160780,0.7067252747252747,0
1239,1240,Malleswaram,411700,28500,383200,0.9307748360456644,-1
1240,1241,Rajajinagar,107900,55100,52800,0.4893419833178869,1
1241,1242,Varthur,244050,49480,194570,0.7972546609301373,0
1242,1243,Hoodi,239350,57940,181410,0.7579277209108001,0
1243,1244,Kalyan Nagar,374700,62240,312460,0.8338937816920203,-1
1244,1245,Horamavu,112750,40440,72310,0.6413303769401331,0
1245,1246,CV Raman Nagar,423350,32730,390620,0.9226880831463328,-1
1246,1247,CV Raman Nagar,385300,46640,338660,0.8789514663898261,-1
1247,1248,Hebbal,33200,35300,-2100,-0.06325301204819277,1
1248,1249,Jalahalli,134700,58890,75810,0.5628062360801782,0
1249,1250,CV Raman Nagar,134500,48210,86290,0.6415613382899629,0
1250,1251,HBR Layout,30850,76630,-45780,-1.4839546191247974,1
1251,1252,Varthur,239000,31010,207990,0.8702510460251046,-1
1252,1253,Hoodi,126550,67990,58560,0.46274199920979847,1
1253,1254,Horamavu,362350,133910,228440,0.6304401821443356,0
1254,1255,Mahadevapura,39850,88430,-48580,-1.2190715181932246,1
1255,1256,Mahadevapura,88150,43820,44330,0.5028927963698242,0
1256,1257,Hebbal,206300,85240,121060,0.5868153174987881,0
1257,1258,Marathahalli,401750,100580,301170,0.7496453018046049,0
1258,1259,Shivajinagar,277600,60900,216700,0.7806195965417867,0
1259,1260,HBR Layout,436550,32410,404140,0.9257587905165502,-1
1260,1261,Varthur,283850,119880,163970,0.5776642592918795,0
1261,1262,Hoodi,271850,21070,250780,0.9224940224388449,-1
1262,1263,Hoodi,369100,112990,256110,0.693876998103495,0
1263,1264,Vasanth Nagar,431600,14150,417450,0.9672150139017609,-1
1264,1265,Indiranagar,28100,42670,-14570,-0.5185053380782918,1
1265,1266,Jalahalli,47250,61500,-14250,-0.30158730158730157,1
1266,1267,Malleswaram,115300,136360,-21060,-0.1826539462272333,1
1267,1268,Whitefield,51850,81950,-30100,-0.5805207328833173,1
1268,1269,Kalyan Nagar,112950,47060,65890,0.5833554670208057,0
1269,1270,Kalyan Nagar,404300,51150,353150,0.8734850358644571,-1
1270,1271,Banaswadi,138250,189110,-50860,-0.3678842676311031,1
1271,1272,Hebbal,414150,89260,324890,0.7844742243148618,0
1272,1273,Horamavu,409500,124350,285150,0.6963369963369963,0
1273,1274,Shivajinagar,309200,42380,266820,0.8629366106080207,-1
1274,1275,HBR Layout,205050,44040,161010,0.7852231163130944,0
1275,1276,Jalahalli,306150,52270,253880,0.8292666993303937,-1
1276,1277,Malleswaram,427200,91720,335480,0.7852996254681648,0
1277,1278,Kammanahalli,284750,95850,188900,0.663388937664618,0
1278,1279,Hebbal,329400,91360,238040,0.7226472374013357,0
1279,1280,Varthur,194250,57570,136680,0.7036293436293436,0
1280,1281,Shivajinagar,362700,58760,303940,0.8379928315412186,-1
1281,1282,Whitefield,274350,110140,164210,0.5985420083834518,0
1282,1283,Hoodi,391500,78760,312740,0.7988250319284802,0
1283,1284,Varthur,369100,23910,345190,0.9352208073692766,-1
1284,1285,Shivajinagar,91250,57200,34050,0.3731506849315068,1
1285,1286,Varthur,47800,96400,-48600,-1.0167364016736402,1
1286,1287,Varthur,180100,79770,100330,0.5570794003331483,0
1287,1288,Mahadevapura,108200,64430,43770,0.4045286506469501,1
1288,1289,Krishnarajapuram,77450,82660,-5210,-0.0672692059393157,1
1289,1290,Malleswaram,35750,51220,-15470,-0.43272727272727274,1
1290,1291,HBR Layout,47150,0,47150,1.0,-1
1291,1292,Hoodi,314500,82890,231610,0.7364387917329094,0
1292,1293,Krishnarajapuram,213050,48890,164160,0.7705233513259798,0
1293,1294,Indiranagar,355350,60050,295300,0.8310116786267061,-1
1294,1295,Kammanahalli,127950,34720,93230,0.7286440015631106,0
1295,1296,Vasanth Nagar,228750,62900,165850,0.7250273224043716,0
1296,1297,Whitefield,322650,33580,289070,0.8959243762591043,-1
1297,1298,Kalyan Nagar,384950,196600,188350,0.4892843226393038,1
1298,1299,Vasanth Nagar,329100,61690,267410,0.8125493770890307,-1
1299,1300,Malleswaram,334300,19240,315060,0.9424469039784624,-1
1300,1301,Mahadevapura,261800,50030,211770,0.808899923605806,-1
1301,1302,Banaswadi,387050,82100,304950,0.7878827024932179,0
1302,1303,Hebbal,375350,40930,334420,0.890955108565339,-1
1303,1304,Rajajinagar,223100,26240,196860,0.8823845809054236,-1
1304,1305,Jalahalli,39000,33180,5820,0.14923076923076922,1
1305,1306,Malleswaram,380050,22550,357500,0.9406657018813314,-1
1306,1307,Kammanahalli,360450,59000,301450,0.8363157164655292,-1
1307,1308,Whitefield,173800,39120,134680,0.7749136939010357,0
1308,1309,Indiranagar,348850,81840,267010,0.7654006019779275,0
1309,1310,Mahadevapura,255600,76830,178770,0.6994131455399061,0
1310,1311,Horamavu,362700,62540,300160,0.8275709953129308,-1
1311,1312,Vasanth Nagar,225550,0,225550,1.0,-1
1312,1313,Malleswaram,79300,75930,3370,0.042496847414880204,1
1313,1314,Shivajinagar,177350,65370,111980,0.6314068226670426,0
1314,1315,Hoodi,424950,121720,303230,0.7135663019178727,0
1315,1316,Whitefield,44200,83280,-39080,-0.8841628959276018,1
1316,1317,Hoodi,164050,46300,117750,0.7177689728741238,0
1317,1318,Krishnarajapuram,366350,63080,303270,0.8278149310768391,-1
1318,1319,Banaswadi,438750,21380,417370,0.9512706552706552,-1
1319,1320,Shivajinagar,259550,84950,174600,0.6727027547678675,0
1320,1321,Mahadevapura,407600,126460,281140,0.6897448478900883,0
1321,1322,Krishnarajapuram,289400,16470,272930,0.9430891499654458,-1
1322,1323,HBR Layout,257800,94260,163540,0.6343677269200931,0
1323,1324,Shivajinagar,262850,51880,210970,0.8026250713334602,-1
1324,1325,Whitefield,263250,47520,215730,0.8194871794871795,-1
1325,1326,Mahadevapura,149400,72320,77080,0.5159303882195448,0
1326,1327,Kalyan Nagar,215150,41480,173670,0.8072042760864513,-1
1327,1328,Krishnarajapuram,207000,62940,144060,0.6959420289855073,0
1328,1329,Kammanahalli,138100,125540,12560,0.09094858797972484,1
1329,1330,Shivajinagar,233250,44640,188610,0.8086173633440514,-1
1330,1331,Mahadevapura,408850,39690,369160,0.902922832334597,-1
1331,1332,Vasanth Nagar,162850,21850,141000,0.8658274485723058,-1
1332,1333,Indiranagar,340150,48000,292150,0.858885785682787,-1
1333,1334,HBR Layout,227550,81620,145930,0.641309602285212,0
1334,1335,Whitefield,322550,103500,219050,0.6791195163540537,0
1335,1336,Horamavu,393800,6120,387680,0.9844591163026917,-1
1336,1337,Kalyan Nagar,229550,68540,161010,0.7014158135482466,0
1337,1338,Hebbal,220600,49550,171050,0.7753853127833182,0
1338,1339,Indiranagar,107450,37720,69730,0.6489530013959981,0
1339,1340,HBR Layout,398500,76860,321640,0.8071267252195734,-1
1340,1341,Kalyan Nagar,254600,42540,212060,0.8329143754909663,-1
1341,1342,Hoodi,62650,129520,-66870,-1.0673583399840383,1
1342,1343,Krishnarajapuram,175700,54210,121490,0.6914627205463859,0
1343,1344,CV Raman Nagar,282500,26160,256340,0.9073982300884956,-1
1344,1345,Horamavu,197800,18880,178920,0.9045500505561173,-1
1345,1346,Indiranagar,347050,35480,311570,0.8977668923786198,-1
1346,1347,Horamavu,347500,25850,321650,0.9256115107913669,-1
1347,1348,Varthur,330350,70320,260030,0.7871348569698804,0
1348,1349,Indiranagar,388850,51960,336890,0.8663752089494664,-1
1349,1350,Vasanth Nagar,373750,73350,300400,0.8037458193979933,-1
1350,1351,Jalahalli,377250,100850,276400,0.7326706428098079,0
1351,1352,Whitefield,34500,66520,-32020,-0.9281159420289855,1
1352,1353,Malleswaram,428400,95050,333350,0.7781279178338002,0
1353,1354,Marathahalli,47200,66250,-19050,-0.4036016949152542,1
1354,1355,Mahadevapura,446250,4230,442020,0.9905210084033613,-1
1355,1356,Kalyan Nagar,88550,99830,-11280,-0.12738565782044042,1
1356,1357,Banaswadi,139650,60480,79170,0.5669172932330827,0
1357,1358,Mahadevapura,47400,101620,-54220,-1.1438818565400843,1
1358,1359,Rajajinagar,289900,8810,281090,0.9696102104173853,-1
1359,1360,Shivajinagar,329050,87710,241340,0.7334447652332472,0
1360,1361,Varthur,60500,33060,27440,0.45355371900826447,1
1361,1362,Whitefield,49400,64280,-14880,-0.30121457489878545,1
1362,1363,Whitefield,178250,92180,86070,0.48286115007012625,1
1363,1364,Marathahalli,147150,65290,81860,0.5563030920829086,0
1364,1365,Kalyan Nagar,144800,39290,105510,0.7286602209944751,0
1365,1366,Shivajinagar,414350,121310,293040,0.7072281887293351,0
1366,1367,Banaswadi,88450,66300,22150,0.250423968343697,1
1367,1368,Hoodi,433100,59890,373210,0.8617178480720388,-1
1368,1369,Varthur,248650,48340,200310,0.8055901870098532,-1
1369,1370,Mahadevapura,147600,88420,59180,0.40094850948509486,1
1370,1371,Jalahalli,423550,31840,391710,0.9248258765198913,-1
1371,1372,CV Raman Nagar,203250,74360,128890,0.6341451414514145,0
1372,1373,Whitefield,124900,43950,80950,0.6481184947958367,0
1373,1374,Mahadevapura,100350,117020,-16670,-0.16611858495266568,1
1374,1375,Varthur,359500,43890,315610,0.877913769123783,-1
1375,1376,Shivajinagar,285150,57020,228130,0.800035069261792,-1
1376,1377,Whitefield,143000,75260,67740,0.4737062937062937,1
1377,1378,Krishnarajapuram,192250,113700,78550,0.4085825747724317,1
1378,1379,HBR Layout,391450,21640,369810,0.9447183548345893,-1
1379,1380,Horamavu,242350,69490,172860,0.7132659376934186,0
1380,1381,Kalyan Nagar,74000,60650,13350,0.1804054054054054,1
1381,1382,Kammanahalli,389200,65090,324110,0.83275950668037,-1
1382,1383,Indiranagar,399000,38220,360780,0.9042105263157895,-1
1383,1384,Kammanahalli,316550,42850,273700,0.8646343389669878,-1
1384,1385,Hoodi,116750,25890,90860,0.7782441113490364,0
1385,1386,Rajajinagar,394100,103580,290520,0.7371733062674448,0
1386,1387,Horamavu,441150,93520,347630,0.7880086138501643,0
1387,1388,Varthur,200500,67860,132640,0.6615461346633417,0
1388,1389,Hoodi,42400,65980,-23580,-0.5561320754716981,1
1389,1390,Whitefield,267100,108160,158940,0.5950580307001123,0
1390,1391,CV Raman Nagar,80850,34650,46200,0.5714285714285714,0
1391,1392,Banaswadi,165900,85380,80520,0.48535262206148283,1
1392,1393,HBR Layout,412900,72660,340240,0.8240251876967789,-1
1393,1394,Malleswaram,358650,29740,328910,0.9170779311306287,-1
1394,1395,Varthur,190550,35500,155050,0.813697192337969,-1
1395,1396,Krishnarajapuram,125550,80320,45230,0.36025487853444843,1
1396,1397,Marathahalli,218350,29270,189080,0.86594916418594,-1
1397,1398,Rajajinagar,448100,50220,397880,0.8879268020531131,-1
1398,1399,Kammanahalli,166700,58330,108370,0.6500899820035992,0
1399,1400,Kammanahalli,332450,46970,285480,0.8587155963302753,-1
1400,1401,HBR Layout,91100,54170,36930,0.4053787047200878,1
1401,1402,Malleswaram,362450,37330,325120,0.8970064836529177,-1
1402,1403,Shivajinagar,164200,24070,140130,0.8534104750304506,-1
1403,1404,Vasanth Nagar,335600,37200,298400,0.8891537544696066,-1
1404,1405,Shivajinagar,445250,53000,392250,0.8809657495788883,-1
1405,1406,Rajajinagar,339450,60480,278970,0.8218294299602298,-1
1406,1407,Varthur,226650,14910,211740,0.9342157511581733,-1
1407,1408,Krishnarajapuram,282950,63190,219760,0.7766743240855275,0
1408,1409,Jalahalli,228350,57390,170960,0.7486752791767024,0
1409,1410,Horamavu,429300,53790,375510,0.8747030048916842,-1
1410,1411,Rajajinagar,179950,38980,140970,0.7833842734092804,0
1411,1412,Vasanth Nagar,161750,65850,95900,0.5928902627511592,0
1412,1413,Shivajinagar,31150,80630,-49480,-1.5884430176565008,1
1413,1414,HBR Layout,91950,36170,55780,0.6066340402392605,0
1414,1415,Shivajinagar,238750,2880,235870,0.9879371727748691,-1
1415,1416,Malleswaram,330350,68000,262350,0.7941577115180869,0
1416,1417,Kammanahalli,390100,54840,335260,0.8594206613688797,-1
1417,1418,Whitefield,272850,49250,223600,0.81949789261499,-1
1418,1419,Shivajinagar,119750,71240,48510,0.40509394572025054,1
1419,1420,Indiranagar,163550,22850,140700,0.8602873738917762,-1
1420,1421,Indiranagar,398000,52630,345370,0.8677638190954774,-1
1421,1422,Jalahalli,67550,45470,22080,0.32686898593634345,1
1422,1423,Vasanth Nagar,262650,76320,186330,0.7094231867504284,0
1423,1424,Hoodi,113200,62100,51100,0.45141342756183744,1
1424,1425,Horamavu,304350,141870,162480,0.5338590438639724,0
1425,1426,Rajajinagar,257000,47970,209030,0.8133463035019455,-1
1426,1427,Hebbal,132250,52680,79570,0.6016635160680529,0
1427,1428,Kammanahalli,216350,48310,168040,0.7767044141437486,0
1428,1429,Kammanahalli,246900,69860,177040,0.7170514378290807,0
1429,1430,Mahadevapura,245100,113080,132020,0.5386372909016728,0
1430,1431,Marathahalli,384500,63070,321430,0.8359687906371912,-1
1431,1432,Indiranagar,164150,44560,119590,0.7285409686262565,0
1432,1433,Hebbal,391800,96310,295490,0.7541858090862685,0
1433,1434,Krishnarajapuram,448700,37640,411060,0.9161132159572097,-1
1434,1435,Indiranagar,430350,93100,337250,0.7836644591611479,0
1435,1436,Marathahalli,396700,58060,338640,0.8536425510461306,-1
1436,1437,Hoodi,176500,22790,153710,0.8708781869688386,-1
1437,1438,CV Raman Nagar,269950,5040,264910,0.981329875902945,-1
1438,1439,Horamavu,114550,74630,39920,0.3484941073766914,1
1439,1440,Hoodi,112150,129380,-17230,-0.1536335265269728,1
1440,1441,Kammanahalli,276200,57050,219150,0.7934467776973207,0
1441,1442,Kalyan Nagar,362150,50190,311960,0.8614110175341709,-1
1442,1443,Varthur,305150,9850,295300,0.9677207930525971,-1
1443,1444,Marathahalli,28300,50170,-21870,-0.772791519434629,1
1444,1445,CV Raman Nagar,164250,83820,80430,0.48968036529680364,1
1445,1446,Whitefield,302500,60950,241550,0.7985123966942149,0
1446,1447,Indiranagar,411200,102980,308220,0.7495622568093385,0
1447,1448,Whitefield,182350,79500,102850,0.5640252262133261,0
1448,1449,Hebbal,186500,67030,119470,0.6405898123324397,0
1449,1450,Banaswadi,266450,52110,214340,0.8044285982360668,-1
1450,1451,Shivajinagar,344250,40900,303350,0.8811909949164851,-1
1451,1452,Marathahalli,380700,39720,340980,0.895665878644602,-1
1452,1453,Varthur,429100,33020,396080,0.9230482405033792,-1
1453,1454,Indiranagar,331500,44340,287160,0.8662443438914027,-1
1454,1455,Malleswaram,349200,89690,259510,0.74315578465063,0
1455,1456,Mahadevapura,77900,0,77900,1.0,-1
1456,1457,CV Raman Nagar,325500,40850,284650,0.8745007680491551,-1
1457,1458,Hoodi,445600,59710,385890,0.8660008976660682,-1
1458,1459,Hebbal,50500,70070,-19570,-0.38752475247524754,1
1459,1460,Whitefield,186600,58730,127870,0.6852625937834941,0
1460,1461,Hoodi,327250,44210,283040,0.8649045072574484,-1
1461,1462,Hoodi,331850,111710,220140,0.6633720054241374,0
1462,1463,CV Raman Nagar,284450,59310,225140,0.7914923536649675,0
1463,1464,HBR Layout,369050,43390,325660,0.8824278553041593,-1
1464,1465,Mahadevapura,210650,91900,118750,0.5637313078566343,0
1465,1466,Whitefield,88600,38260,50340,0.5681715575620767,0
1466,1467,Rajajinagar,278250,83200,195050,0.7009883198562444,0
1467,1468,Horamavu,145250,43120,102130,0.7031325301204819,0
1468,1469,Rajajinagar,448850,32540,416310,0.9275036203631503,-1
1469,1470,Indiranagar,413400,91150,322250,0.7795113691340106,0
1470,1471,Hoodi,326650,60170,266480,0.8157967243226695,-1
1471,1472,Kammanahalli,294400,31570,262830,0.8927649456521739,-1
1472,1473,Whitefield,290050,86240,203810,0.7026719531115325,0
1473,1474,Marathahalli,118450,24840,93610,0.7902912621359224,0
1474,1475,Shivajinagar,324350,32360,291990,0.9002312316941575,-1
1475,1476,Shivajinagar,119650,119490,160,0.0013372335979941496,1
1476,1477,Hoodi,33550,36090,-2540,-0.07570789865871833,1
1477,1478,Malleswaram,74000,31150,42850,0.5790540540540541,0
1478,1479,Malleswaram,128350,96950,31400,0.24464355278535255,1
1479,1480,Vasanth Nagar,299100,66060,233040,0.7791374122367102,0
1480,1481,Marathahalli,424700,105230,319470,0.7522251000706381,0
1481,1482,Shivajinagar,46300,30650,15650,0.33801295896328293,1
1482,1483,Marathahalli,78050,42600,35450,0.45419602818705956,1
1483,1484,Hoodi,71150,49210,21940,0.30836261419536193,1
1484,1485,Indiranagar,304800,53160,251640,0.8255905511811024,-1
1485,1486,Whitefield,112100,29930,82170,0.7330062444246209,0
1486,1487,Jalahalli,332450,85980,246470,0.7413746428034291,0
1487,1488,Jalahalli,277100,82770,194330,0.7012991699747384,0
1488,1489,Kalyan Nagar,68650,45740,22910,0.33372177713037143,1
1489,1490,HBR Layout,265750,40230,225520,0.8486171213546566,-1
1490,1491,HBR Layout,295450,28470,266980,0.903638517515654,-1
1491,1492,Marathahalli,60550,78670,-18120,-0.29925681255161024,1
1492,1493,Rajajinagar,49550,59680,-10130,-0.20443995963673056,1
1493,1494,Whitefield,445600,39130,406470,0.9121858168761221,-1
1494,1495,Whitefield,160950,109720,51230,0.3182976079527804,1
1495,1496,Indiranagar,169350,54630,114720,0.6774136403897254,0
1496,1497,Kalyan Nagar,225700,69200,156500,0.6933983163491361,0
1497,1498,CV Raman Nagar,407450,52750,354700,0.8705362621180512,-1
1498,1499,CV Raman Nagar,81550,55650,25900,0.31759656652360513,1
1499,1500,Kalyan Nagar,129350,32850,96500,0.7460378817162737,0
1500,1501,CV Raman Nagar,254950,80140,174810,0.6856638556579722,0
1501,1502,Mahadevapura,193300,114190,79110,0.40926021727884115,1
1502,1503,Vasanth Nagar,53650,32280,21370,0.3983224603914259,1
1503,1504,Krishnarajapuram,311800,32240,279560,0.896600384862091,-1
1504,1505,Shivajinagar,303150,21430,281720,0.9293089229754247,-1
1505,1506,Horamavu,408250,64110,344140,0.8429638701775872,-1
1506,1507,Shivajinagar,126300,60220,66080,0.5231987331749802,0
1507,1508,Krishnarajapuram,350250,51800,298450,0.8521056388294076,-1
1508,1509,Whitefield,364900,110760,254140,0.6964647848725678,0
1509,1510,Marathahalli,175100,118280,56820,0.32450028555111365,1
1510,1511,Whitefield,185900,113760,72140,0.38805809575040345,1
1511,1512,Varthur,252100,29710,222390,0.8821499404998017,-1
1512,1513,Indiranagar,260600,100970,159630,0.6125479662317729,0
1513,1514,Jalahalli,106200,69330,36870,0.34717514124293786,1
1514,1515,Krishnarajapuram,110600,59080,51520,0.46582278481012657,1
1515,1516,Rajajinagar,207900,60500,147400,0.708994708994709,0
1516,1517,HBR Layout,29450,45960,-16510,-0.5606112054329372,1
1517,1518,Indiranagar,142800,74120,68680,0.48095238095238096,1
1518,1519,Krishnarajapuram,197050,96830,100220,0.5086018776960163,0
1519,1520,Marathahalli,444900,20080,424820,0.9548662620813666,-1
1520,1521,Horamavu,355750,61170,294580,0.8280534082923401,-1
1521,1522,Vasanth Nagar,368250,39030,329220,0.8940122199592668,-1
1522,1523,HBR Layout,350500,94170,256330,0.7313266761768902,0
1523,1524,Marathahalli,30650,27840,2810,0.09168026101141925,1
1524,1525,Horamavu,260150,8570,251580,0.9670574668460503,-1
1525,1526,Whitefield,67800,89600,-21800,-0.3215339233038348,1
1526,1527,Mahadevapura,241200,14540,226660,0.9397180762852405,-1
1527,1528,Malleswaram,205000,48050,156950,0.765609756097561,0
1528,1529,HBR Layout,269950,27450,242500,0.8983145026856826,-1
1529,1530,Jalahalli,407450,42320,365130,0.896134495030065,-1
1530,1531,Kammanahalli,85600,28240,57360,0.6700934579439253,0
1531,1532,Marathahalli,360400,48940,311460,0.8642064372918979,-1
1532,1533,Marathahalli,411550,50030,361520,0.87843518406026,-1
1533,1534,Mahadevapura,205350,35890,169460,0.8252252252252252,-1
1534,1535,Malleswaram,242900,33610,209290,0.8616303005351996,-1
1535,1536,CV Raman Nagar,272250,28080,244170,0.8968595041322314,-1
1536,1537,Malleswaram,201950,23830,178120,0.8820004951720722,-1
1537,1538,Krishnarajapuram,94400,60340,34060,0.3608050847457627,1
1538,1539,Hoodi,102150,38680,63470,0.6213411649534998,0
1539,1540,CV Raman Nagar,236950,19670,217280,0.91698670605613,-1
1540,1541,Jalahalli,70400,35440,34960,0.4965909090909091,1
1541,1542,Varthur,73550,123220,-49670,-0.6753229095853162,1
1542,1543,Whitefield,71450,40270,31180,0.4363890832750175,1
1543,1544,Hebbal,159050,85840,73210,0.46029550455831497,1
1544,1545,Shivajinagar,66350,64650,1700,0.02562170308967596,1
1545,1546,Varthur,136200,47760,88440,0.6493392070484582,0
1546,1547,Kalyan Nagar,125600,99250,26350,0.20979299363057324,1
1547,1548,Kalyan Nagar,147650,44630,103020,0.6977311208940061,0
1548,1549,Kalyan Nagar,54000,90050,-36050,-0.6675925925925926,1
1549,1550,Rajajinagar,269750,43380,226370,0.8391844300278035,-1
1550,1551,Rajajinagar,34800,55810,-21010,-0.603735632183908,1
1551,1552,Whitefield,68350,57250,11100,0.1623994147768837,1
1552,1553,Marathahalli,226200,80180,146020,0.6455349248452696,0
1553,1554,Mahadevapura,209500,34770,174730,0.8340334128878282,-1
1554,1555,Jalahalli,427500,102960,324540,0.7591578947368421,0
1555,1556,Malleswaram,136300,79980,56320,0.4132061628760088,1
1556,1557,Jalahalli,39050,12040,27010,0.6916773367477593,0
1557,1558,Marathahalli,36050,126270,-90220,-2.502635228848821,1
1558,1559,Shivajinagar,143000,22050,120950,0.8458041958041959,-1
1559,1560,Indiranagar,282450,28390,254060,0.8994866348026199,-1
1560,1561,Hebbal,311450,64560,246890,0.792711510675871,0
1561,1562,HBR Layout,295350,34110,261240,0.8845099035043169,-1
1562,1563,Varthur,255000,38780,216220,0.8479215686274509,-1
1563,1564,Horamavu,123350,40350,83000,0.6728820429671666,0
1564,1565,Jalahalli,211950,23920,188030,0.8871431941495636,-1
1565,1566,Shivajinagar,360850,120620,240230,0.6657336843563808,0
1566,1567,Varthur,399600,20750,378850,0.9480730730730731,-1
1567,1568,Hoodi,328700,37120,291580,0.8870702768481898,-1
1568,1569,Hebbal,440450,150600,289850,0.6580769667385629,0
1569,1570,Krishnarajapuram,206750,35310,171440,0.8292140266021766,-1
1570,1571,CV Raman Nagar,61250,61280,-30,-0.0004897959183673469,1
1571,1572,Whitefield,103900,49420,54480,0.5243503368623676,0
1572,1573,Indiranagar,336700,58030,278670,0.8276507276507277,-1
1573,1574,Krishnarajapuram,221800,72570,149230,0.6728133453561768,0
1574,1575,Shivajinagar,440950,71100,369850,0.8387572287107382,-1
1575,1576,Whitefield,287850,68200,219650,0.7630710439464999,0
1576,1577,Hebbal,240200,86410,153790,0.6402581182348043,0
1577,1578,Mahadevapura,174100,68350,105750,0.6074095347501436,0
1578,1579,Banaswadi,122050,43600,78450,0.642769356820975,0
1579,1580,Kammanahalli,132750,25540,107210,0.807608286252354,-1
1580,1581,Shivajinagar,79250,32490,46760,0.5900315457413249,0
1581,1582,HBR Layout,28450,59270,-30820,-1.083304042179262,1
1582,1583,Jalahalli,80800,88580,-7780,-0.09628712871287129,1
1583,1584,Whitefield,26800,45690,-18890,-0.7048507462686567,1
1584,1585,Rajajinagar,402200,79660,322540,0.8019393336648434,-1
1585,1586,Rajajinagar,297150,48160,248990,0.8379269729093051,-1
1586,1587,Kammanahalli,338350,52440,285910,0.8450125609575883,-1
1587,1588,Horamavu,371250,54990,316260,0.8518787878787879,-1
1588,1589,Vasanth Nagar,227050,16480,210570,0.9274168685311606,-1
1589,1590,Malleswaram,442250,77550,364700,0.8246466930469192,-1
1590,1591,Krishnarajapuram,225950,62230,163720,0.7245850851958398,0
1591,1592,Hebbal,398750,77320,321430,0.8060940438871473,-1
1592,1593,Varthur,316400,66390,250010,0.7901706700379266,0
1593,1594,Shivajinagar,389650,78220,311430,0.7992557423328628,0
1594,1595,Rajajinagar,185200,134550,50650,0.273488120950324,1
1595,1596,Horamavu,299650,17520,282130,0.9415317870849325,-1
1596,1597,Mahadevapura,117800,75340,42460,0.3604414261460102,1
1597,1598,HBR Layout,82750,79570,3180,0.03842900302114804,1
1598,1599,Hebbal,255750,71790,183960,0.7192961876832844,0
1599,1600,Indiranagar,340900,10100,330800,0.9703725432678205,-1
1600,1601,Rajajinagar,280000,41160,238840,0.853,-1
1601,1602,Jalahalli,300700,46000,254700,0.8470236115729963,-1
1602,1603,Banaswadi,196650,95510,101140,0.5143147724383422,0
1603,1604,Kalyan Nagar,390550,79730,310820,0.7958520035846882,0
1604,1605,Vasanth Nagar,182950,61030,121920,0.666411587865537,0
1605,1606,Rajajinagar,189350,43280,146070,0.7714285714285715,0
1606,1607,Malleswaram,214950,96670,118280,0.5502675040707141,0
1607,1608,Mahadevapura,230900,68160,162740,0.704807275877003,0
1608,1609,Horamavu,432950,69820,363130,0.8387342649266659,-1
1609,1610,Shivajinagar,139150,85560,53590,0.3851239669421488,1
1610,1611,Hebbal,97900,73940,23960,0.24473953013278857,1
1611,1612,Rajajinagar,193300,26190,167110,0.8645111226073461,-1
1612,1613,Banaswadi,376350,114670,261680,0.6953102165537399,0
1613,1614,Whitefield,85550,14720,70830,0.8279368790181181,-1
1614,1615,Indiranagar,317150,97210,219940,0.6934888853854643,0
1615,1616,Marathahalli,386850,74230,312620,0.8081168411529016,-1
1616,1617,CV Raman Nagar,150000,84460,65540,0.43693333333333334,1
1617,1618,CV Raman Nagar,440450,43560,396890,0.90110114655466,-1
1618,1619,Vasanth Nagar,288500,36280,252220,0.8742461005199307,-1
1619,1620,Krishnarajapuram,394600,49350,345250,0.8749366447034972,-1
1620,1621,Indiranagar,31300,68310,-37010,-1.1824281150159743,1
1621,1622,Kammanahalli,25000,15620,9380,0.3752,1
1622,1623,HBR Layout,178000,12580,165420,0.9293258426966292,-1
1623,1624,Horamavu,60550,80890,-20340,-0.33592072667217177,1
1624,1625,Kammanahalli,394000,36630,357370,0.9070304568527919,-1
1625,1626,Jalahalli,25250,9830,15420,0.6106930693069307,0
1626,1627,Mahadevapura,86400,62780,23620,0.27337962962962964,1
1627,1628,CV Raman Nagar,187400,140760,46640,0.2488794023479189,1
1628,1629,Varthur,420550,17610,402940,0.9581262632267269,-1
1629,1630,Banaswadi,65850,67830,-1980,-0.030068337129840545,1
1630,1631,Krishnarajapuram,408900,59920,348980,0.8534605037906579,-1
1631,1632,Varthur,343050,45330,297720,0.8678618277219065,-1
1632,1633,Rajajinagar,340100,51810,288290,0.8476624522199353,-1
1633,1634,Whitefield,83250,24230,59020,0.708948948948949,0
1634,1635,Mahadevapura,158850,59340,99510,0.6264400377714825,0
1635,1636,Malleswaram,247400,68090,179310,0.7247776879547292,0
1636,1637,Horamavu,153250,69060,84190,0.5493637846655791,0
1637,1638,Vasanth Nagar,217650,33060,184590,0.848104755341144,-1
1638,1639,HBR Layout,158200,61340,96860,0.6122629582806574,0
1639,1640,Whitefield,54600,29430,25170,0.460989010989011,1
1640,1641,CV Raman Nagar,55950,48960,6990,0.12493297587131368,1
1641,1642,Kalyan Nagar,210600,46570,164030,0.7788698955365622,0
1642,1643,Banaswadi,196850,87730,109120,0.5543307086614173,0
1643,1644,Indiranagar,418300,84650,333650,0.7976332775519962,0
1644,1645,Hebbal,257300,84650,172650,0.6710066070734552,0
1645,1646,CV Raman Nagar,136400,48810,87590,0.6421554252199414,0
1646,1647,Vasanth Nagar,169650,22100,147550,0.8697318007662835,-1
1647,1648,Vasanth Nagar,155350,101760,53590,0.344962986803991,1
1648,1649,Shivajinagar,35350,86510,-51160,-1.4472418670438472,1
1649,1650,Varthur,412550,37900,374650,0.908132347594231,-1
1650,1651,Mahadevapura,404950,51220,353730,0.8735152487961477,-1
1651,1652,Jalahalli,208800,78480,130320,0.6241379310344828,0
1652,1653,Marathahalli,302400,116660,185740,0.6142195767195767,0
1653,1654,Hoodi,87200,93590,-6390,-0.07327981651376146,1
1654,1655,Shivajinagar,191350,55140,136210,0.7118369480010452,0
1655,1656,HBR Layout,413000,62400,350600,0.848910411622276,-1
1656,1657,Kammanahalli,343800,65550,278250,0.8093368237347295,-1
1657,1658,Rajajinagar,128350,22370,105980,0.8257109466303078,-1
1658,1659,Kalyan Nagar,218600,72300,146300,0.6692589204025617,0
1659,1660,Krishnarajapuram,187700,50650,137050,0.7301545018646777,0
1660,1661,Horamavu,322250,47500,274750,0.8525989138867339,-1
1661,1662,Vasanth Nagar,448150,82080,366070,0.8168470378221577,-1
1662,1663,Kalyan Nagar,96500,55450,41050,0.4253886010362694,1
1663,1664,Krishnarajapuram,129650,49320,80330,0.6195912070960278,0
1664,1665,Vasanth Nagar,146200,70450,75750,0.5181258549931601,0
1665,1666,Rajajinagar,301950,51340,250610,0.8299718496439807,-1
1666,1667,Marathahalli,65900,72250,-6350,-0.09635811836115327,1
1667,1668,Indiranagar,414850,73920,340930,0.8218151138965891,-1
1668,1669,Horamavu,108600,113280,-4680,-0.0430939226519337,1
1669,1670,Mahadevapura,34200,24710,9490,0.27748538011695906,1
1670,1671,Varthur,292000,107710,184290,0.6311301369863014,0
1671,1672,CV Raman Nagar,351150,49690,301460,0.8584935212871992,-1
1672,1673,Rajajinagar,105100,95390,9710,0.09238820171265462,1
1673,1674,Banaswadi,347300,40160,307140,0.8843651022171034,-1
1674,1675,HBR Layout,61400,91870,-30470,-0.4962540716612378,1
1675,1676,Indiranagar,70200,61850,8350,0.11894586894586895,1
1676,1677,Banaswadi,224850,75320,149530,0.6650211251945741,0
1677,1678,Shivajinagar,409100,64640,344460,0.8419946223417257,-1
1678,1679,Whitefield,447650,60590,387060,0.864648721099073,-1
1679,1680,CV Raman Nagar,243900,27920,215980,0.8855268552685527,-1
1680,1681,Hebbal,232800,48860,183940,0.7901202749140893,0
1681,1682,Shivajinagar,253700,46650,207050,0.816121403232164,-1
1682,1683,Horamavu,139000,74080,64920,0.4670503597122302,1
1683,1684,Kammanahalli,443150,27810,415340,0.9372447252623265,-1
1684,1685,Krishnarajapuram,421500,34310,387190,0.9186002372479241,-1
1685,1686,Malleswaram,357900,142930,214970,0.6006426376082704,0
1686,1687,Krishnarajapuram,184750,37250,147500,0.7983761840324763,0
1687,1688,Shivajinagar,178950,128830,50120,0.28007823414361555,1
1688,1689,Hoodi,303450,41180,262270,0.8642939528752678,-1
1689,1690,Hoodi,126650,41170,85480,0.6749309119621003,0
1690,1691,Kammanahalli,128950,122900,6050,0.046917409848778596,1
1691,1692,Vasanth Nagar,435300,108540,326760,0.7506547208821502,0
1692,1693,Indiranagar,245700,50050,195650,0.7962962962962963,0
1693,1694,Vasanth Nagar,366700,36400,330300,0.9007362967003,-1
1694,1695,Shivajinagar,273850,30550,243300,0.888442578053679,-1
1695,1696,HBR Layout,187100,119370,67730,0.36199893105291286,1
1696,1697,Malleswaram,185600,57350,128250,0.6910021551724138,0
1697,1698,Krishnarajapuram,200150,134500,65650,0.3280039970022483,1
1698,1699,HBR Layout,355400,120840,234560,0.6599887450759707,0
1699,1700,Kammanahalli,288350,48080,240270,0.833258193168025,-1
1700,1701,Mahadevapura,204350,25720,178630,0.8741375091754343,-1
1701,1702,Indiranagar,244250,56940,187310,0.766878198567042,0
1702,1703,Hebbal,60000,66930,-6930,-0.1155,1
1703,1704,Marathahalli,335100,116250,218850,0.653088630259624,0
1704,1705,Kalyan Nagar,221150,100770,120380,0.5443364232421434,0
1705,1706,Hoodi,65100,19880,45220,0.6946236559139785,0
1706,1707,Hoodi,236600,50150,186450,0.7880388841927304,0
1707,1708,Indiranagar,239150,37460,201690,0.8433619067530839,-1
1708,1709,CV Raman Nagar,172550,46760,125790,0.7290060851926977,0
1709,1710,Kammanahalli,359750,31180,328570,0.9133287004864489,-1
1710,1711,Hoodi,210350,35630,174720,0.8306156405990016,-1
1711,1712,Mahadevapura,45100,43440,1660,0.03680709534368071,1
1712,1713,CV Raman Nagar,166350,34250,132100,0.7941088067327923,0
1713,1714,Rajajinagar,152100,59800,92300,0.6068376068376068,0
1714,1715,Whitefield,248800,53830,194970,0.7836414790996784,0
1715,1716,Varthur,175450,112260,63190,0.36015958962667427,1
1716,1717,Hebbal,236300,98460,137840,0.5833262801523487,0
1717,1718,Shivajinagar,252300,45680,206620,0.8189456995640111,-1
1718,1719,Hebbal,187000,41820,145180,0.7763636363636364,0
1719,1720,CV Raman Nagar,287500,44730,242770,0.8444173913043478,-1
1720,1721,Marathahalli,233850,48210,185640,0.7938422065426556,0
1721,1722,Mahadevapura,199700,73970,125730,0.6295943915873811,0
1722,1723,Horamavu,199650,73970,125680,0.6295016278487353,0
1723,1724,Indiranagar,80250,39790,40460,0.5041744548286604,0
1724,1725,Kalyan Nagar,424150,69470,354680,0.8362136036779442,-1
1725,1726,CV Raman Nagar,400050,11640,388410,0.9709036370453693,-1
1726,1727,Malleswaram,147450,46830,100620,0.6824008138351983,0
1727,1728,Kammanahalli,146900,82530,64370,0.43818924438393464,1
1728,1729,Shivajinagar,394750,58850,335900,0.8509183027232425,-1
1729,1730,Indiranagar,80350,74000,6350,0.07902924704418171,1
1730,1731,CV Raman Nagar,158100,27610,130490,0.8253636938646426,-1
1731,1732,Jalahalli,425250,52830,372420,0.8757671957671957,-1
1732,1733,HBR Layout,400450,62630,337820,0.843600948932451,-1
1733,1734,Hoodi,245300,138300,107000,0.4362005707297187,1
1734,1735,CV Raman Nagar,426500,79300,347200,0.8140679953106682,-1
1735,1736,CV Raman Nagar,32150,88990,-56840,-1.7679626749611197,1
1736,1737,Horamavu,226550,55100,171450,0.756786581328625,0
1737,1738,Mahadevapura,234800,63760,171040,0.7284497444633731,0
1738,1739,Kammanahalli,415350,69840,345510,0.8318526543878657,-1
1739,1740,Banaswadi,411150,30120,381030,0.926742064939803,-1
1740,1741,HBR Layout,409800,114090,295710,0.7215959004392386,0
1741,1742,Marathahalli,152000,42930,109070,0.7175657894736842,0
1742,1743,Rajajinagar,343650,55640,288010,0.8380910810417576,-1
1743,1744,Hoodi,362300,1540,360760,0.9957493789677063,-1
1744,1745,CV Raman Nagar,257050,117650,139400,0.5423069441742852,0
1745,1746,Hebbal,166450,48130,118320,0.7108440973265244,0
1746,1747,Mahadevapura,77150,22460,54690,0.7088788075178224,0
1747,1748,Marathahalli,206850,81920,124930,0.6039642252840223,0
1748,1749,HBR Layout,320150,38660,281490,0.8792441043260971,-1
1749,1750,Kammanahalli,200600,92170,108430,0.5405284147557328,0
1750,1751,Vasanth Nagar,262350,88520,173830,0.6625881456070135,0
1751,1752,Hebbal,370600,44210,326390,0.8807069616837561,-1
1752,1753,Whitefield,255800,29470,226330,0.8847928068803753,-1
1753,1754,Hebbal,346550,60160,286390,0.8264031164334151,-1
1754,1755,Whitefield,208400,34650,173750,0.8337332053742802,-1
1755,1756,Malleswaram,312600,28110,284490,0.9100767754318618,-1
1756,1757,Hebbal,158050,82710,75340,0.47668459348307496,1
1757,1758,Marathahalli,352800,49470,303330,0.8597789115646258,-1
1758,1759,CV Raman Nagar,33950,59300,-25350,-0.7466863033873343,1
1759,1760,HBR Layout,71800,50410,21390,0.2979108635097493,1
1760,1761,Krishnarajapuram,173800,46910,126890,0.7300920598388952,0
1761,1762,Rajajinagar,301650,35740,265910,0.8815183159290568,-1
1762,1763,Whitefield,172550,55390,117160,0.6789915966386555,0
1763,1764,Horamavu,380250,92750,287500,0.7560815253122946,0
1764,1765,HBR Layout,284300,90410,193890,0.681990854730918,0
1765,1766,Varthur,387600,63110,324490,0.8371775025799794,-1
1766,1767,Marathahalli,270300,26650,243650,0.9014058453570107,-1
1767,1768,Banaswadi,152900,67680,85220,0.5573577501635055,0
1768,1769,Kalyan Nagar,371950,80260,291690,0.7842183089124882,0
1769,1770,Marathahalli,322650,18120,304530,0.9438400743840074,-1
1770,1771,CV Raman Nagar,210050,24080,185970,0.8853606284218043,-1
1771,1772,Whitefield,70600,80470,-9870,-0.13980169971671388,1
1772,1773,Whitefield,145850,12520,133330,0.9141583818992115,-1
1773,1774,Rajajinagar,92050,61380,30670,0.333188484519283,1
1774,1775,Jalahalli,144850,55700,89150,0.6154642733862616,0
1775,1776,CV Raman Nagar,187950,82380,105570,0.5616919393455706,0
1776,1777,Kalyan Nagar,75300,50240,25060,0.33280212483399735,1
1777,1778,Kalyan Nagar,275850,109440,166410,0.6032626427406199,0
1778,1779,Malleswaram,283000,39760,243240,0.8595053003533569,-1
1779,1780,HBR Layout,449750,67030,382720,0.8509616453585325,-1
1780,1781,Jalahalli,219200,14390,204810,0.9343521897810219,-1
1781,1782,Hoodi,204150,68370,135780,0.6650991917707568,0
1782,1783,Jalahalli,367050,64450,302600,0.824410843209372,-1
1783,1784,Hoodi,291850,59380,232470,0.7965393181428816,0
1784,1785,Hoodi,394400,99320,295080,0.7481744421906694,0
1785,1786,Banaswadi,262850,41560,221290,0.841887007799125,-1
1786,1787,Banaswadi,192350,113950,78400,0.407590330127372,1
1787,1788,Varthur,149650,63330,86320,0.5768125626461744,0
1788,1789,Whitefield,89550,40840,48710,0.5439419318816304,0
1789,1790,Hoodi,338750,110950,227800,0.6724723247232473,0
1790,1791,Krishnarajapuram,144750,56270,88480,0.6112607944732297,0
1791,1792,Hebbal,447400,56050,391350,0.8747206079570854,-1
1792,1793,CV Raman Nagar,301550,34540,267010,0.8854584645995689,-1
1793,1794,Banaswadi,190050,82270,107780,0.5671139173901605,0
1794,1795,Whitefield,148200,97840,50360,0.3398110661268556,1
1795,1796,HBR Layout,73050,111870,-38820,-0.5314168377823408,1
1796,1797,Banaswadi,38000,78510,-40510,-1.0660526315789474,1
1797,1798,Mahadevapura,83300,41870,41430,0.497358943577431,1
1798,1799,Jalahalli,402350,66460,335890,0.8348204299739033,-1
1799,1800,Shivajinagar,214600,81780,132820,0.6189189189189189,0
1800,1801,Vasanth Nagar,364850,73900,290950,0.7974510072632589,0
1801,1802,Indiranagar,109600,52720,56880,0.518978102189781,0
1802,1803,Kammanahalli,235050,27410,207640,0.8833865135077643,-1
1803,1804,Kalyan Nagar,387400,118690,268710,0.6936241610738255,0
1804,1805,Banaswadi,335550,51210,284340,0.8473848904783192,-1
1805,1806,Hebbal,87900,57960,29940,0.34061433447098977,1
1806,1807,Marathahalli,75100,53860,21240,0.28282290279627165,1
1807,1808,Malleswaram,54700,39030,15670,0.2864716636197441,1
1808,1809,CV Raman Nagar,445300,1210,444090,0.9972827307433191,-1
1809,1810,CV Raman Nagar,114650,167760,-53110,-0.4632359354557348,1
1810,1811,Krishnarajapuram,74900,32000,42900,0.5727636849132176,0
1811,1812,Kalyan Nagar,26950,81150,-54200,-2.0111317254174397,1
1812,1813,Shivajinagar,340050,20230,319820,0.9405087487134245,-1
1813,1814,CV Raman Nagar,441300,7230,434070,0.9836165873555405,-1
1814,1815,Vasanth Nagar,247600,49070,198530,0.8018174474959612,-1
1815,1816,Hebbal,105600,60890,44710,0.4233901515151515,1
1816,1817,Rajajinagar,226200,80510,145690,0.6440760389036251,0
1817,1818,Vasanth Nagar,98950,94380,4570,0.04618494188984335,1
1818,1819,Vasanth Nagar,220400,63740,156660,0.7107985480943738,0
1819,1820,CV Raman Nagar,251050,103520,147530,0.5876518621788488,0
1820,1821,Horamavu,350150,34160,315990,0.9024418106525774,-1
1821,1822,Banaswadi,201300,58990,142310,0.7069547938400398,0
1822,1823,HBR Layout,204450,34640,169810,0.8305698214722426,-1
1823,1824,Hebbal,88000,41090,46910,0.5330681818181818,0
1824,1825,Banaswadi,429750,67790,361960,0.8422571262361839,-1
1825,1826,Horamavu,145200,65640,79560,0.5479338842975207,0
1826,1827,Kammanahalli,209100,112240,96860,0.4632233381157341,1
1827,1828,Marathahalli,88850,96400,-7550,-0.08497467642093416,1
1828,1829,Whitefield,441350,57580,383770,0.8695366489180922,-1
1829,1830,Shivajinagar,91750,43790,47960,0.5227247956403269,0
1830,1831,Hebbal,185350,48270,137080,0.7395737793363906,0
1831,1832,Vasanth Nagar,362600,133310,229290,0.632349696635411,0
1832,1833,Vasanth Nagar,331650,33020,298630,0.9004372078998945,-1
1833,1834,Whitefield,53350,22320,31030,0.5816307403936269,0
1834,1835,CV Raman Nagar,227450,73200,154250,0.6781710265992525,0
1835,1836,Hoodi,162400,45870,116530,0.7175492610837438,0
1836,1837,Indiranagar,132950,67600,65350,0.49153817224520496,1
1837,1838,Rajajinagar,206050,7120,198930,0.9654452802717787,-1
1838,1839,Hebbal,438350,20010,418340,0.9543515455686096,-1
1839,1840,Vasanth Nagar,368850,31200,337650,0.9154127694184628,-1
1840,1841,CV Raman Nagar,329150,0,329150,1.0,-1
1841,1842,Hebbal,272350,35540,236810,0.8695061501744079,-1
1842,1843,Indiranagar,208000,52430,155570,0.7479326923076923,0
1843,1844,Jalahalli,222400,90810,131590,0.591681654676259,0
1844,1845,HBR Layout,416850,40120,376730,0.9037543480868417,-1
1845,1846,Whitefield,331000,56550,274450,0.8291540785498489,-1
1846,1847,Hebbal,187650,83070,104580,0.5573141486810551,0
1847,1848,Rajajinagar,261200,26900,234300,0.8970137825421133,-1
1848,1849,Whitefield,214850,67970,146880,0.6836397486618571,0
1849,1850,Horamavu,54850,37760,17090,0.3115770282588879,1
1850,1851,Krishnarajapuram,257250,101220,156030,0.6065306122448979,0
1851,1852,Kalyan Nagar,62350,65040,-2690,-0.04314354450681636,1
1852,1853,HBR Layout,191050,28240,162810,0.8521852918084271,-1
1853,1854,Jalahalli,370900,52730,318170,0.8578322998112698,-1
1854,1855,Krishnarajapuram,185100,80810,104290,0.5634251755807671,0
1855,1856,Shivajinagar,163100,128510,34590,0.21207847946045372,1
1856,1857,HBR Layout,365450,69370,296080,0.8101792310849637,-1
1857,1858,Hoodi,167800,72630,95170,0.5671632896305125,0
1858,1859,Marathahalli,107850,66680,41170,0.381733889661567,1
1859,1860,Malleswaram,86900,99000,-12100,-0.13924050632911392,1
1860,1861,Horamavu,169000,44750,124250,0.735207100591716,0
1861,1862,HBR Layout,143000,15620,127380,0.8907692307692308,-1
1862,1863,Marathahalli,265000,30020,234980,0.8867169811320754,-1
1863,1864,Kammanahalli,373250,46470,326780,0.8754989953114535,-1
1864,1865,Horamavu,306300,55870,250430,0.8175971269996736,-1
1865,1866,HBR Layout,282600,11350,271250,0.9598372257607927,-1
1866,1867,Varthur,177300,17840,159460,0.8993795826283136,-1
1867,1868,Indiranagar,206750,6670,200080,0.9677388149939541,-1
1868,1869,Rajajinagar,338750,34770,303980,0.8973579335793358,-1
1869,1870,Vasanth Nagar,28600,83840,-55240,-1.9314685314685314,1
1870,1871,CV Raman Nagar,253850,124880,128970,0.5080559385463856,0
1871,1872,Kammanahalli,181650,3040,178610,0.9832645196807046,-1
1872,1873,Malleswaram,251550,24940,226610,0.9008547008547009,-1
1873,1874,Horamavu,297650,58560,239090,0.8032588610784478,-1
1874,1875,Shivajinagar,58100,67020,-8920,-0.15352839931153184,1
1875,1876,Marathahalli,169850,20380,149470,0.8800117750956726,-1
1876,1877,Kalyan Nagar,142350,91400,50950,0.3579206181945908,1
1877,1878,HBR Layout,189050,73280,115770,0.6123776778629992,0
1878,1879,Rajajinagar,312950,35610,277340,0.8862118549289024,-1
1879,1880,Krishnarajapuram,93450,38930,54520,0.5834135901551631,0
1880,1881,CV Raman Nagar,98500,59180,39320,0.39918781725888325,1
1881,1882,Horamavu,265850,84870,180980,0.680759826970096,0
1882,1883,HBR Layout,78900,68030,10870,0.13776932826362484,1
1883,1884,CV Raman Nagar,297000,102380,194620,0.6552861952861952,0
1884,1885,Marathahalli,87300,73410,13890,0.15910652920962198,1
1885,1886,Whitefield,237100,67710,169390,0.7144242935470265,0
1886,1887,Whitefield,94000,127610,-33610,-0.3575531914893617,1
1887,1888,Krishnarajapuram,81950,77450,4500,0.05491153142159853,1
1888,1889,Varthur,443000,18470,424530,0.9583069977426637,-1
1889,1890,Banaswadi,327550,59310,268240,0.8189284078766601,-1
1890,1891,Kammanahalli,313150,89300,223850,0.7148331470541274,0
1891,1892,Indiranagar,277550,104680,172870,0.6228427310394523,0
1892,1893,Horamavu,398550,41470,357080,0.8959478108142015,-1
1893,1894,Hebbal,219450,53220,166230,0.7574846206425154,0
1894,1895,Marathahalli,449250,68010,381240,0.8486143572621035,-1
1895,1896,Banaswadi,404900,33390,371510,0.9175351938750309,-1
1896,1897,Malleswaram,50400,40940,9460,0.1876984126984127,1
1897,1898,Shivajinagar,279550,106500,173050,0.6190305848685387,0
1898,1899,Whitefield,165550,75310,90240,0.5450921171851404,0
1899,1900,CV Raman Nagar,114550,79370,35180,0.30711479703186384,1
1900,1901,Hoodi,59850,54720,5130,0.08571428571428572,1
1901,1902,Mahadevapura,100200,95580,4620,0.04610778443113772,1
1902,1903,Jalahalli,225150,88160,136990,0.6084388185654008,0
1903,1904,Whitefield,255300,41810,213490,0.836231884057971,-1
1904,1905,Banaswadi,81400,79960,1440,0.01769041769041769,1
1905,1906,Vasanth Nagar,42700,78290,-35590,-0.8334894613583138,1
1906,1907,Shivajinagar,151800,46000,105800,0.696969696969697,0
1907,1908,Jalahalli,38700,124080,-85380,-2.206201550387597,1
1908,1909,Varthur,397400,77080,320320,0.8060392551585305,-1
1909,1910,Whitefield,132850,76330,56520,0.42544222807677834,1
1910,1911,Jalahalli,316900,103000,213900,0.6749763332281477,0
1911,1912,Hebbal,135100,59860,75240,0.556920799407846,0
1912,1913,Kalyan Nagar,230250,106190,124060,0.5388056460369164,0
1913,1914,Kalyan Nagar,272600,74590,198010,0.7263756419662509,0
1914,1915,CV Raman Nagar,415200,75480,339720,0.8182080924855492,-1
1915,1916,Indiranagar,139900,21130,118770,0.848963545389564,-1
1916,1917,Banaswadi,264750,42960,221790,0.8377337110481586,-1
1917,1918,Shivajinagar,83700,12030,71670,0.8562724014336918,-1
1918,1919,Marathahalli,33100,69620,-36520,-1.1033232628398792,1
1919,1920,Kammanahalli,43900,65150,-21250,-0.48405466970387245,1
1920,1921,CV Raman Nagar,337300,34800,302500,0.896827749777646,-1
1921,1922,Shivajinagar,304550,39250,265300,0.871121326547365,-1
1922,1923,Banaswadi,168400,62370,106030,0.6296318289786224,0
1923,1924,Horamavu,298550,77740,220810,0.7396081058449171,0
1924,1925,Jalahalli,103650,34620,69030,0.6659913169319827,0
1925,1926,HBR Layout,364800,69400,295400,0.8097587719298246,-1
1926,1927,Whitefield,299550,153880,145670,0.486296110832916,1
1927,1928,Shivajinagar,374000,18760,355240,0.9498395721925134,-1
1928,1929,Malleswaram,132950,117550,15400,0.11583301993230538,1
1929,1930,Banaswadi,145450,22100,123350,0.8480577518047439,-1
1930,1931,Vasanth Nagar,175050,26650,148400,0.8477577834904313,-1
1931,1932,Hoodi,406100,79920,326180,0.803201181974883,-1
1932,1933,Kalyan Nagar,200100,100380,99720,0.49835082458770613,1
1933,1934,Hoodi,318700,33190,285510,0.8958581738311892,-1
1934,1935,Mahadevapura,40350,60380,-20030,-0.4964064436183395,1
1935,1936,CV Raman Nagar,368600,68800,299800,0.8133478024959305,-1
1936,1937,Indiranagar,382000,128890,253110,0.6625916230366492,0
1937,1938,Indiranagar,120150,48160,71990,0.5991677070328756,0
1938,1939,Shivajinagar,376950,70120,306830,0.8139806340363444,-1
1939,1940,Mahadevapura,356500,61880,294620,0.8264235624123422,-1
1940,1941,Kammanahalli,235550,76390,159160,0.6756951814901295,0
1941,1942,Hebbal,231650,7870,223780,0.9660263328297,-1
1942,1943,Marathahalli,287100,79070,208030,0.7245907349355625,0
1943,1944,Marathahalli,219600,27520,192080,0.8746812386156648,-1
1944,1945,Varthur,310800,127170,183630,0.5908301158301158,0
1945,1946,Whitefield,417450,80570,336880,0.8069948496825967,-1
1946,1947,Marathahalli,141900,43160,98740,0.6958421423537703,0
1947,1948,Shivajinagar,283850,44920,238930,0.8417474017967236,-1
1948,1949,Shivajinagar,168950,69910,99040,0.5862089375554898,0
1949,1950,Shivajinagar,83700,70590,13110,0.15663082437275985,1
1950,1951,Varthur,47000,19010,27990,0.595531914893617,0
1951,1952,Hoodi,308650,70100,238550,0.7728819050704682,0
1952,1953,Horamavu,118300,19170,99130,0.8379543533389687,-1
1953,1954,CV Raman Nagar,258350,152060,106290,0.4114186181536675,1
1954,1955,Kammanahalli,181250,54910,126340,0.697048275862069,0
1955,1956,Hoodi,33450,58040,-24590,-0.7351270553064275,1
1956,1957,Malleswaram,448000,111810,336190,0.7504241071428571,0
1957,1958,Kammanahalli,62400,115040,-52640,-0.8435897435897436,1
1958,1959,HBR Layout,433700,205560,228140,0.5260318192298824,0
1959,1960,Varthur,39150,8740,30410,0.7767560664112388,0
1960,1961,Kalyan Nagar,151250,50350,100900,0.6671074380165289,0
1961,1962,Malleswaram,294300,980,293320,0.9966700645599729,-1
1962,1963,Whitefield,132600,99950,32650,0.2462292609351433,1
1963,1964,Krishnarajapuram,356150,106320,249830,0.7014740979924189,0
1964,1965,Marathahalli,309750,81660,228090,0.73636803874092,0
1965,1966,Indiranagar,172700,122510,50190,0.29061957151129125,1
1966,1967,Kalyan Nagar,291550,44110,247440,0.84870519636426,-1
1967,1968,Kammanahalli,349100,6150,342950,0.9823832712689774,-1
1968,1969,Hoodi,378250,101890,276360,0.7306278916060807,0
1969,1970,Malleswaram,106550,102650,3900,0.03660253402158611,1
1970,1971,Kalyan Nagar,380100,84480,295620,0.7777426992896607,0
1971,1972,CV Raman Nagar,71500,83190,-11690,-0.1634965034965035,1
1972,1973,Shivajinagar,55100,118000,-62900,-1.1415607985480944,1
1973,1974,Whitefield,127550,92670,34880,0.2734613876911015,1
1974,1975,Rajajinagar,235100,65840,169260,0.7199489578902595,0
1975,1976,Hoodi,438450,80680,357770,0.815988140038773,-1
1976,1977,Krishnarajapuram,164300,59800,104500,0.6360316494217894,0
1977,1978,Hoodi,33950,29650,4300,0.12665684830633284,1
1978,1979,Whitefield,35050,52520,-17470,-0.4984308131241084,1
1979,1980,Malleswaram,324500,18550,305950,0.9428351309707242,-1
1980,1981,Shivajinagar,417150,120370,296780,0.7114467218027088,0
1981,1982,Indiranagar,289650,26480,263170,0.9085793198688071,-1
1982,1983,Jalahalli,203200,98230,104970,0.5165846456692913,0
1983,1984,Hebbal,392900,85490,307410,0.7824128276915245,0
1984,1985,Kalyan Nagar,184000,38830,145170,0.7889673913043478,0
1985,1986,Vasanth Nagar,39850,104180,-64330,-1.6143036386449185,1
1986,1987,Banaswadi,381150,63010,318140,0.8346845074117801,-1
1987,1988,Indiranagar,143150,68930,74220,0.5184771219001048,0
1988,1989,Rajajinagar,80150,22650,57500,0.7174048658764816,0
1989,1990,Kalyan Nagar,89450,27260,62190,0.695248742314142,0
1990,1991,Kalyan Nagar,290000,65930,224070,0.7726551724137931,0
1991,1992,Rajajinagar,445000,41600,403400,0.9065168539325843,-1
1992,1993,Mahadevapura,395800,136700,259100,0.6546235472460838,0
1993,1994,Banaswadi,163350,25940,137410,0.8411998775635139,-1
1994,1995,Banaswadi,44850,71770,-26920,-0.6002229654403567,1
1995,1996,Jalahalli,339650,52360,287290,0.8458413072280289,-1
1996,1997,Krishnarajapuram,333000,47650,285350,0.856906906906907,-1
1997,1998,Kalyan Nagar,347550,99630,247920,0.7133362106171773,0
1998,1999,Horamavu,91900,33780,58120,0.6324265505984766,0
1999,2000,Shivajinagar,149300,44960,104340,0.6988613529805761,0
2000,2001,Kalyan Nagar,51650,11800,39850,0.771539206195547,0
2001,2002,Malleswaram,339600,56000,283600,0.8351001177856302,-1
2002,2003,Shivajinagar,79900,43870,36030,0.4509386733416771,1
2003,2004,Varthur,371000,92430,278570,0.7508625336927224,0
2004,2005,Malleswaram,430500,87620,342880,0.7964692218350755,0
2005,2006,Vasanth Nagar,285900,55890,230010,0.8045120671563484,-1
2006,2007,Whitefield,306950,117360,189590,0.617657598957485,0
2007,2008,Krishnarajapuram,119600,10030,109570,0.9161371237458193,-1
2008,2009,Whitefield,301900,73940,227960,0.7550844650546539,0
2009,2010,Rajajinagar,443850,95960,347890,0.78380083361496,0
2010,2011,Hoodi,370150,32810,337340,0.9113602593543159,-1
2011,2012,Hoodi,101850,45790,56060,0.5504172803141876,0
2012,2013,Hebbal,382250,39040,343210,0.8978678875081753,-1
2013,2014,Kammanahalli,397950,90430,307520,0.7727603970348034,0
2014,2015,Banaswadi,264400,68720,195680,0.7400907715582451,0
2015,2016,Whitefield,159750,41420,118330,0.7407198748043818,0
2016,2017,Mahadevapura,135600,26740,108860,0.8028023598820059,-1
2017,2018,Malleswaram,155850,34560,121290,0.7782483156881617,0
2018,2019,Horamavu,306550,46080,260470,0.849681944217909,-1
2019,2020,Mahadevapura,341950,58310,283640,0.8294779938587513,-1
2020,2021,Kammanahalli,429550,76010,353540,0.8230473751600512,-1
2021,2022,Varthur,370050,90350,279700,0.7558438048912309,0
2022,2023,Rajajinagar,200300,18470,181830,0.9077883175237145,-1
2023,2024,Malleswaram,167450,105760,61690,0.3684084801433264,1
2024,2025,Malleswaram,68200,62910,5290,0.07756598240469208,1
2025,2026,Shivajinagar,360850,16880,343970,0.9532215602050713,-1
2026,2027,Malleswaram,105000,127780,-22780,-0.21695238095238095,1
2027,2028,Malleswaram,90850,58840,32010,0.3523390203632361,1
2028,2029,HBR Layout,300050,120810,179240,0.5973671054824196,0
2029,2030,Vasanth Nagar,347450,117960,229490,0.66049791336883,0
2030,2031,Varthur,256350,109710,146640,0.5720304271503803,0
2031,2032,Rajajinagar,401500,20090,381410,0.9499626400996264,-1
2032,2033,Whitefield,311200,43770,267430,0.8593508997429306,-1
2033,2034,Horamavu,303000,55120,247880,0.8180858085808581,-1
2034,2035,CV Raman Nagar,110350,24020,86330,0.7823289533303126,0
2035,2036,Horamavu,436000,41880,394120,0.9039449541284403,-1
2036,2037,Kammanahalli,28850,129800,-100950,-3.4991334488734833,1
2037,2038,Hoodi,242950,77810,165140,0.6797283391644371,0
2038,2039,Vasanth Nagar,296800,13350,283450,0.9550202156334232,-1
2039,2040,Mahadevapura,67000,112850,-45850,-0.6843283582089552,1
2040,2041,Shivajinagar,138500,13220,125280,0.9045487364620939,-1
2041,2042,Kammanahalli,192100,111600,80500,0.41905257678292557,1
2042,2043,HBR Layout,212300,64080,148220,0.6981629769194536,0
2043,2044,Shivajinagar,281400,60420,220980,0.7852878464818763,0
2044,2045,Whitefield,399100,57950,341150,0.8547982961663744,-1
2045,2046,Varthur,204350,117050,87300,0.42720822118913626,1
2046,2047,Mahadevapura,229250,101400,127850,0.5576881134133043,0
2047,2048,Hoodi,130500,110980,19520,0.1495785440613027,1
2048,2049,Hebbal,131500,85160,46340,0.3523954372623574,1
2049,2050,Varthur,376850,108010,268840,0.7133872893724293,0
2050,2051,Whitefield,128550,65930,62620,0.4871256320497861,1
2051,2052,Hoodi,82500,57180,25320,0.3069090909090909,1
2052,2053,Horamavu,438100,3780,434320,0.9913718329148596,-1
2053,2054,Kalyan Nagar,87900,102100,-14200,-0.161547212741752,1
2054,2055,Rajajinagar,404500,27340,377160,0.9324103831891224,-1
2055,2056,Banaswadi,444500,84910,359590,0.8089763779527559,-1
2056,2057,Mahadevapura,142550,68600,73950,0.5187653454928095,0
2057,2058,Hebbal,233550,83620,149930,0.6419610361806893,0
2058,2059,Hebbal,38000,73320,-35320,-0.9294736842105263,1
2059,2060,Krishnarajapuram,432000,78910,353090,0.817337962962963,-1
2060,2061,Krishnarajapuram,141900,31410,110490,0.778646934460888,0
2061,2062,Vasanth Nagar,353600,84550,269050,0.7608880090497737,0
2062,2063,Shivajinagar,284700,53330,231370,0.8126800140498771,-1
2063,2064,Vasanth Nagar,130750,128360,2390,0.018279158699808794,1
2064,2065,Banaswadi,297550,59160,238390,0.8011762728953117,-1
2065,2066,Malleswaram,304800,26750,278050,0.9122375328083989,-1
2066,2067,Mahadevapura,231950,78320,153630,0.6623410217719337,0
2067,2068,Whitefield,336600,46730,289870,0.8611705288175876,-1
2068,2069,Mahadevapura,376200,102880,273320,0.726528442317916,0
2069,2070,Indiranagar,57600,47460,10140,0.17604166666666668,1
2070,2071,Varthur,373400,84600,288800,0.7734333154793787,0
2071,2072,CV Raman Nagar,277700,89120,188580,0.6790781418797264,0
2072,2073,Mahadevapura,327300,46880,280420,0.8567674915979224,-1
2073,2074,Kammanahalli,184500,44420,140080,0.7592411924119241,0
2074,2075,Vasanth Nagar,158300,42970,115330,0.7285533796588756,0
2075,2076,Banaswadi,35500,62330,-26830,-0.755774647887324,1
2076,2077,Horamavu,37800,84100,-46300,-1.2248677248677249,1
2077,2078,Kalyan Nagar,319500,21430,298070,0.9329264475743348,-1
2078,2079,Vasanth Nagar,120200,93590,26610,0.2213810316139767,1
2079,2080,Rajajinagar,211950,117860,94090,0.44392545411653694,1
2080,2081,Mahadevapura,239300,34850,204450,0.8543669034684497,-1
2081,2082,Indiranagar,174450,75170,99280,0.5691028948122672,0
2082,2083,Horamavu,364600,23990,340610,0.9342018650575974,-1
2083,2084,Vasanth Nagar,211450,72050,139400,0.6592575076850319,0
2084,2085,Horamavu,259250,56950,202300,0.780327868852459,0
2085,2086,Varthur,134750,47160,87590,0.6500185528756958,0
2086,2087,Indiranagar,299250,47140,252110,0.8424728487886383,-1
2087,2088,Shivajinagar,60100,77470,-17370,-0.28901830282861896,1
2088,2089,Kammanahalli,128500,55020,73480,0.571828793774319,0
2089,2090,Kammanahalli,384200,79350,304850,0.7934669442998439,0
2090,2091,Hebbal,230450,97770,132680,0.5757431113039705,0
2091,2092,Indiranagar,376000,66000,310000,0.824468085106383,-1
2092,2093,Kalyan Nagar,390500,34520,355980,0.9116005121638925,-1
2093,2094,Whitefield,29250,38000,-8750,-0.29914529914529914,1
2094,2095,Kammanahalli,155350,61910,93440,0.6014805278403604,0
2095,2096,Varthur,67950,74520,-6570,-0.09668874172185431,1
2096,2097,Shivajinagar,119800,78230,41570,0.3469949916527546,1
2097,2098,Whitefield,375550,104560,270990,0.7215816802023699,0
2098,2099,Kalyan Nagar,177600,125760,51840,0.2918918918918919,1
2099,2100,Vasanth Nagar,27450,70130,-42680,-1.5548269581056466,1
2100,2101,Jalahalli,324200,85360,238840,0.7367057371992597,0
2101,2102,Hebbal,316100,83880,232220,0.7346409364125277,0
2102,2103,Marathahalli,65300,59640,5660,0.08667687595712098,1
2103,2104,Malleswaram,381900,50180,331720,0.8686043466876145,-1
2104,2105,Hebbal,183100,47060,136040,0.7429819770617149,0
2105,2106,Marathahalli,286250,5500,280750,0.9807860262008734,-1
2106,2107,Banaswadi,116200,21440,94760,0.8154905335628228,-1
2107,2108,Kammanahalli,422400,48930,373470,0.8841619318181818,-1
2108,2109,Shivajinagar,418150,37550,380600,0.9101996891067798,-1
2109,2110,Mahadevapura,192450,34280,158170,0.8218758118991946,-1
2110,2111,Varthur,106050,23590,82460,0.7775577557755775,0
2111,2112,Jalahalli,312200,87450,224750,0.7198910954516335,0
2112,2113,Shivajinagar,404300,53310,350990,0.8681424684640119,-1
2113,2114,Horamavu,358750,15280,343470,0.9574076655052265,-1
2114,2115,Kammanahalli,117600,59630,57970,0.4929421768707483,1
2115,2116,Whitefield,118750,48600,70150,0.5907368421052631,0
2116,2117,Malleswaram,433200,83560,349640,0.8071098799630656,-1
2117,2118,Vasanth Nagar,341300,119400,221900,0.650161148549663,0
2118,2119,Shivajinagar,400950,24650,376300,0.9385210125950867,-1
2119,2120,Krishnarajapuram,293550,32250,261300,0.8901379662749106,-1
2120,2121,Shivajinagar,68150,35660,32490,0.4767424798239178,1
2121,2122,Malleswaram,373650,83290,290360,0.7770908604308845,0
2122,2123,Varthur,142350,96530,45820,0.32188268352651916,1
2123,2124,Horamavu,146400,34850,111550,0.7619535519125683,0
2124,2125,Banaswadi,401700,24990,376710,0.9377893950709485,-1
2125,2126,HBR Layout,367550,75740,291810,0.7939327982587403,0
2126,2127,Malleswaram,378700,34450,344250,0.9090308951676789,-1
2127,2128,Hoodi,316250,92590,223660,0.7072252964426877,0
2128,2129,Shivajinagar,302000,103440,198560,0.6574834437086092,0
2129,2130,Hoodi,244900,28550,216350,0.8834218048182931,-1
2130,2131,Marathahalli,89300,33930,55370,0.6200447928331467,0
2131,2132,Banaswadi,67100,60150,6950,0.10357675111773472,1
2132,2133,Vasanth Nagar,342400,67910,274490,0.8016647196261683,-1
2133,2134,Indiranagar,218000,58100,159900,0.7334862385321101,0
2134,2135,Jalahalli,323000,101860,221140,0.6846439628482972,0
2135,2136,Hebbal,383600,37700,345900,0.9017205422314911,-1
2136,2137,Varthur,168150,129510,38640,0.22979482604817128,1
2137,2138,Mahadevapura,184200,128500,55700,0.30238870792616723,1
2138,2139,Malleswaram,295650,80190,215460,0.7287671232876712,0
2139,2140,Varthur,170200,48940,121260,0.7124559341950646,0
2140,2141,Whitefield,192700,45620,147080,0.7632589517384536,0
2141,2142,Hoodi,407150,23060,384090,0.9433623971509272,-1
2142,2143,Whitefield,365850,111220,254630,0.6959956266229329,0
2143,2144,Varthur,253650,65500,188150,0.7417701557263946,0
2144,2145,Kalyan Nagar,215250,77920,137330,0.6380023228803716,0
2145,2146,Varthur,335050,82190,252860,0.7546933293538278,0
2146,2147,Shivajinagar,403500,53480,350020,0.8674597273853779,-1
2147,2148,Malleswaram,45000,66220,-21220,-0.47155555555555556,1
2148,2149,Hoodi,331550,54040,277510,0.8370079927612728,-1
2149,2150,Hebbal,255200,58140,197060,0.7721786833855799,0
2150,2151,Marathahalli,207200,49160,158040,0.7627413127413127,0
2151,2152,Krishnarajapuram,261050,36360,224690,0.8607163378663092,-1
2152,2153,Horamavu,162900,92080,70820,0.4347452424800491,1
2153,2154,Horamavu,141600,97160,44440,0.31384180790960453,1
2154,2155,Horamavu,300800,38110,262690,0.8733045212765957,-1
2155,2156,Shivajinagar,300300,60940,239360,0.7970695970695971,0
2156,2157,Vasanth Nagar,212950,46690,166260,0.7807466541441653,0
2157,2158,Indiranagar,365950,2310,363640,0.9936876622489411,-1
2158,2159,Kammanahalli,123650,40820,82830,0.6698746461787303,0
2159,2160,Horamavu,88350,46960,41390,0.4684776457272213,1
2160,2161,Banaswadi,211200,56430,154770,0.7328125,0
2161,2162,Hoodi,170450,140020,30430,0.17852742739806396,1
2162,2163,Shivajinagar,446850,64260,382590,0.8561933534743202,-1
2163,2164,Malleswaram,220500,61020,159480,0.723265306122449,0
2164,2165,Kammanahalli,105100,80560,24540,0.2334919124643197,1
2165,2166,Mahadevapura,120050,35790,84260,0.7018742190753853,0
2166,2167,Jalahalli,289900,92890,197010,0.6795791652293894,0
2167,2168,Horamavu,333600,47990,285610,0.8561450839328537,-1
2168,2169,Horamavu,284350,50390,233960,0.8227888165992615,-1
2169,2170,Kammanahalli,175550,144160,31390,0.1788094559954429,1
2170,2171,Malleswaram,419000,16580,402420,0.9604295942720764,-1
2171,2172,Krishnarajapuram,30050,79800,-49750,-1.6555740432612314,1
2172,2173,Banaswadi,415000,45630,369370,0.8900481927710844,-1
2173,2174,Vasanth Nagar,360900,35590,325310,0.901385425325575,-1
2174,2175,Krishnarajapuram,116350,31220,85130,0.7316716802750323,0
2175,2176,Jalahalli,102550,173720,-71170,-0.6940029254022428,1
2176,2177,Hoodi,137050,85800,51250,0.37395111273257936,1
2177,2178,CV Raman Nagar,130600,27850,102750,0.7867534456355283,0
2178,2179,Hebbal,392450,44170,348280,0.8874506306535864,-1
2179,2180,Vasanth Nagar,277850,12450,265400,0.9551916501709555,-1
2180,2181,Malleswaram,442800,96620,346180,0.7817976513098465,0
2181,2182,Hoodi,420650,47470,373180,0.8871508379888268,-1
2182,2183,Kammanahalli,180800,30670,150130,0.8303650442477876,-1
2183,2184,Jalahalli,361800,26230,335570,0.9275013819789939,-1
2184,2185,Whitefield,63150,19790,43360,0.6866191607284244,0
2185,2186,Indiranagar,407700,52140,355560,0.8721118469462841,-1
2186,2187,Horamavu,231100,33760,197340,0.8539160536564258,-1
2187,2188,Shivajinagar,379550,83010,296540,0.7812936372019497,0
2188,2189,Mahadevapura,175050,93450,81600,0.4661525278491859,1
2189,2190,Malleswaram,257050,106980,150070,0.5838163781365493,0
2190,2191,HBR Layout,254700,103960,150740,0.591833529642717,0
2191,2192,Banaswadi,32500,73380,-40880,-1.2578461538461538,1
2192,2193,Hebbal,302900,60520,242380,0.8001980851766259,-1
2193,2194,Kammanahalli,225150,136690,88460,0.3928936264712414,1
2194,2195,Whitefield,422000,79820,342180,0.8108530805687204,-1
2195,2196,Hoodi,174950,100940,74010,0.4230351529008288,1
2196,2197,Hoodi,368250,9760,358490,0.9734962661235573,-1
2197,2198,Hoodi,362150,89160,272990,0.7538036725113904,0
2198,2199,Mahadevapura,233900,82030,151870,0.6492945703292005,0
2199,2200,Krishnarajapuram,381950,136130,245820,0.643592093205917,0
2200,2201,Malleswaram,191350,22470,168880,0.8825712045989025,-1
2201,2202,Marathahalli,402700,76500,326200,0.810032282095853,-1
2202,2203,Rajajinagar,207750,67700,140050,0.6741275571600481,0
2203,2204,HBR Layout,195700,102890,92810,0.47424629535002555,1
2204,2205,Shivajinagar,53250,74470,-21220,-0.39849765258215963,1
2205,2206,Rajajinagar,161000,53600,107400,0.6670807453416149,0
2206,2207,Hoodi,226400,3890,222510,0.9828180212014134,-1
2207,2208,Horamavu,447000,106300,340700,0.7621923937360179,0
2208,2209,Shivajinagar,43200,56610,-13410,-0.3104166666666667,1
2209,2210,Varthur,433000,72530,360470,0.8324942263279446,-1
2210,2211,Shivajinagar,179750,67990,111760,0.6217524339360223,0
2211,2212,Varthur,315200,68700,246500,0.7820431472081218,0
2212,2213,Varthur,25950,55840,-29890,-1.151830443159923,1
2213,2214,Banaswadi,342150,56980,285170,0.8334648545959374,-1
2214,2215,Whitefield,224950,113510,111440,0.4953989775505668,1
2215,2216,Kalyan Nagar,207650,18190,189460,0.9124006742114135,-1
2216,2217,Hebbal,439350,184310,255040,0.5804939114601115,0
2217,2218,Whitefield,314050,80470,233580,0.7437669160961631,0
2218,2219,Mahadevapura,339300,56130,283170,0.8345711759504862,-1
2219,2220,Indiranagar,147050,63840,83210,0.5658619517171031,0
2220,2221,Kammanahalli,414300,62960,351340,0.8480328264542601,-1
2221,2222,Krishnarajapuram,50150,50830,-680,-0.013559322033898305,1
2222,2223,Horamavu,351550,112850,238700,0.6789930308633196,0
2223,2224,Shivajinagar,292550,37180,255370,0.8729106135703298,-1
2224,2225,Marathahalli,93050,53780,39270,0.4220311660397636,1
2225,2226,Rajajinagar,369950,30920,339030,0.9164211379916205,-1
2226,2227,Kammanahalli,228500,67470,161030,0.70472647702407,0
2227,2228,Kalyan Nagar,165200,58570,106630,0.6454600484261501,0
2228,2229,Indiranagar,342800,120020,222780,0.6498833138856476,0
2229,2230,Jalahalli,224800,39970,184830,0.8221975088967971,-1
2230,2231,Marathahalli,26200,64530,-38330,-1.4629770992366413,1
2231,2232,Banaswadi,119100,66620,52480,0.44063811922753987,1
2232,2233,Whitefield,335550,125780,209770,0.6251527343167933,0
2233,2234,CV Raman Nagar,438750,106900,331850,0.7563532763532763,0
2234,2235,Malleswaram,84100,42230,41870,0.49785969084423304,1
2235,2236,Mahadevapura,267300,64840,202460,0.7574261129816685,0
2236,2237,Kalyan Nagar,242250,60150,182100,0.7517027863777089,0
2237,2238,Malleswaram,199550,72940,126610,0.6344775745427211,0
2238,2239,Hebbal,237250,36800,200450,0.8448893572181243,-1
2239,2240,Jalahalli,145300,85180,60120,0.4137646249139711,1
2240,2241,Rajajinagar,118600,77100,41500,0.34991568296795955,1
2241,2242,Malleswaram,349750,25820,323930,0.9261758398856326,-1
2242,2243,Indiranagar,85250,126790,-41540,-0.48727272727272725,1
2243,2244,Whitefield,188550,48100,140450,0.7448952532484752,0
2244,2245,Hoodi,180000,57100,122900,0.6827777777777778,0
2245,2246,Horamavu,429350,105730,323620,0.753744031675789,0
2246,2247,Horamavu,120400,67310,53090,0.4409468438538206,1
2247,2248,Hoodi,107400,58380,49020,0.4564245810055866,1
2248,2249,Horamavu,46500,69100,-22600,-0.4860215053763441,1
2249,2250,Krishnarajapuram,295350,103390,191960,0.6499407482647707,0
2250,2251,Banaswadi,183000,132270,50730,0.2772131147540984,1
2251,2252,Indiranagar,53300,88210,-34910,-0.6549718574108818,1
2252,2253,Rajajinagar,397350,56790,340560,0.8570781426953568,-1
2253,2254,Jalahalli,371900,34270,337630,0.9078515730034956,-1
2254,2255,Hebbal,106650,78510,28140,0.2638537271448664,1
2255,2256,Marathahalli,368100,45180,322920,0.8772616136919316,-1
2256,2257,Varthur,360050,72970,287080,0.7973337036522705,0
2257,2258,Kammanahalli,404950,59570,345380,0.8528954191875541,-1
2258,2259,CV Raman Nagar,50400,28920,21480,0.4261904761904762,1
2259,2260,Hoodi,56250,57600,-1350,-0.024,1
2260,2261,Rajajinagar,97800,33390,64410,0.6585889570552147,0
2261,2262,CV Raman Nagar,271850,29860,241990,0.8901600147139966,-1
2262,2263,Marathahalli,222750,56590,166160,0.7459483726150393,0
2263,2264,Whitefield,193750,74830,118920,0.6137806451612903,0
2264,2265,Vasanth Nagar,385700,145760,239940,0.6220897070261862,0
2265,2266,Kammanahalli,356850,86980,269870,0.7562561300266218,0
2266,2267,Rajajinagar,133200,83810,49390,0.3707957957957958,1
2267,2268,Horamavu,344450,77570,266880,0.7748004064450573,0
2268,2269,Whitefield,163850,79210,84640,0.5165700335672871,0
2269,2270,CV Raman Nagar,196800,45360,151440,0.7695121951219512,0
2270,2271,Hoodi,44100,91480,-47380,-1.0743764172335601,1
2271,2272,Kammanahalli,385450,12910,372540,0.9665066805033078,-1
2272,2273,Whitefield,228500,49770,178730,0.7821881838074398,0
2273,2274,Hoodi,394800,58040,336760,0.8529888551165147,-1
2274,2275,Kammanahalli,43750,127960,-84210,-1.9248,1
2275,2276,Vasanth Nagar,269450,104980,164470,0.6103915383187976,0
2276,2277,Banaswadi,271900,45160,226740,0.833909525560868,-1
2277,2278,Hoodi,182900,39950,142950,0.7815746309458721,0
2278,2279,Kammanahalli,105350,57910,47440,0.45030849549121976,1
2279,2280,Malleswaram,113750,60510,53240,0.46804395604395604,1
2280,2281,Hoodi,359650,20220,339430,0.9437786737105519,-1
2281,2282,Hoodi,436700,95630,341070,0.7810167162812,0
2282,2283,Hebbal,257200,58800,198400,0.7713841368584758,0
2283,2284,Banaswadi,341450,111130,230320,0.6745350710206472,0
2284,2285,Hebbal,248250,47650,200600,0.8080563947633435,-1
2285,2286,Whitefield,383200,98060,285140,0.7441022964509395,0
2286,2287,Varthur,262900,38720,224180,0.8527196652719665,-1
2287,2288,Marathahalli,424000,45250,378750,0.8932783018867925,-1
2288,2289,Indiranagar,285350,112910,172440,0.6043104958822498,0
2289,2290,Shivajinagar,289850,13870,275980,0.9521476625840952,-1
2290,2291,CV Raman Nagar,83500,12280,71220,0.852934131736527,-1
2291,2292,CV Raman Nagar,109850,83630,26220,0.23868912152935823,1
2292,2293,Marathahalli,436950,49660,387290,0.8863485524659572,-1
2293,2294,Malleswaram,172300,114140,58160,0.3375507835171213,1
2294,2295,Whitefield,43050,16720,26330,0.6116144018583043,0
2295,2296,CV Raman Nagar,94950,61060,33890,0.3569246972090574,1
2296,2297,Banaswadi,374950,60400,314550,0.8389118549139886,-1
2297,2298,HBR Layout,217350,85580,131770,0.6062571888658845,0
2298,2299,Hoodi,36050,50390,-14340,-0.39778085991678225,1
2299,2300,Varthur,150300,66160,84140,0.5598137059214904,0
2300,2301,CV Raman Nagar,442550,38080,404470,0.9139532256242232,-1
2301,2302,HBR Layout,70800,88830,-18030,-0.25466101694915255,1
2302,2303,Kammanahalli,402200,44120,358080,0.8903033316757832,-1
2303,2304,Marathahalli,349150,30230,318920,0.9134183015895747,-1
2304,2305,Kalyan Nagar,160050,114780,45270,0.28284910965323334,1
2305,2306,Kalyan Nagar,101350,58010,43340,0.4276270350271337,1
2306,2307,Kalyan Nagar,338450,34740,303710,0.8973555916678978,-1
2307,2308,Varthur,355050,127260,227790,0.6415716096324461,0
2308,2309,Varthur,118850,56480,62370,0.5247791333613799,0
2309,2310,Banaswadi,87350,28010,59340,0.6793360045792788,0
2310,2311,Kalyan Nagar,441950,27120,414830,0.938635592261568,-1
2311,2312,Varthur,101500,99450,2050,0.02019704433497537,1
2312,2313,Indiranagar,234250,22240,212010,0.9050586979722519,-1
2313,2314,Shivajinagar,301100,61840,239260,0.7946197276652275,0
2314,2315,Hebbal,185450,48690,136760,0.7374494472903748,0
2315,2316,Kammanahalli,44250,35830,8420,0.1902824858757062,1
2316,2317,Varthur,287800,19070,268730,0.9337387074357193,-1
2317,2318,Varthur,176750,15830,160920,0.9104384724186705,-1
2318,2319,Vasanth Nagar,256700,82640,174060,0.6780677834047526,0
2319,2320,Horamavu,354000,53960,300040,0.8475706214689266,-1
2320,2321,HBR Layout,82700,87400,-4700,-0.056831922611850064,1
2321,2322,Rajajinagar,309200,40970,268230,0.867496765847348,-1
2322,2323,Jalahalli,440900,29750,411150,0.9325243819460195,-1
2323,2324,CV Raman Nagar,340700,45910,294790,0.8652480187848547,-1
2324,2325,Indiranagar,142700,47350,95350,0.6681850035038542,0
2325,2326,Jalahalli,341500,111910,229590,0.672298682284041,0
2326,2327,Vasanth Nagar,241850,58430,183420,0.7584039694025222,0
2327,2328,Shivajinagar,429500,117550,311950,0.7263096623981373,0
2328,2329,Marathahalli,315750,42150,273600,0.8665083135391924,-1
2329,2330,Whitefield,351250,81810,269440,0.7670889679715303,0
2330,2331,Vasanth Nagar,83700,89620,-5920,-0.07072879330943847,1
2331,2332,Banaswadi,404350,63980,340370,0.8417707431680475,-1
2332,2333,Krishnarajapuram,35850,25980,9870,0.27531380753138074,1
2333,2334,Whitefield,386550,33540,353010,0.913232440822662,-1
2334,2335,Malleswaram,405900,6840,399060,0.9831485587583149,-1
2335,2336,Horamavu,390450,12670,377780,0.9675502625176079,-1
2336,2337,Hebbal,365050,59310,305740,0.8375291056019724,-1
2337,2338,Whitefield,261100,64430,196670,0.7532363079279969,0
2338,2339,Hoodi,59600,41070,18530,0.31090604026845636,1
2339,2340,Varthur,135850,38880,96970,0.713801987486198,0
2340,2341,Whitefield,437400,3960,433440,0.9909465020576131,-1
2341,2342,HBR Layout,105750,81760,23990,0.22685579196217495,1
2342,2343,HBR Layout,119650,121460,-1810,-0.015127455077308817,1
2343,2344,Indiranagar,32800,123170,-90370,-2.7551829268292685,1
2344,2345,Indiranagar,152000,52390,99610,0.6553289473684211,0
2345,2346,CV Raman Nagar,170100,69300,100800,0.5925925925925926,0
2346,2347,Varthur,363700,38300,325400,0.8946934286499862,-1
2347,2348,CV Raman Nagar,65150,67180,-2030,-0.03115886415963162,1
2348,2349,Malleswaram,168700,137880,30820,0.1826911677534084,1
2349,2350,Rajajinagar,415750,35030,380720,0.9157426337943476,-1
2350,2351,Indiranagar,255950,55080,200870,0.7848017190857589,0
2351,2352,Mahadevapura,275350,54310,221040,0.8027601234792083,-1
2352,2353,Krishnarajapuram,191000,33870,157130,0.8226701570680628,-1
2353,2354,Hoodi,395300,45410,349890,0.8851252213508728,-1
2354,2355,Kammanahalli,287700,45400,242300,0.8421967327076816,-1
2355,2356,Jalahalli,27150,89810,-62660,-2.3079189686924493,1
2356,2357,Jalahalli,50850,30290,20560,0.40432645034414944,1
2357,2358,Malleswaram,46500,45570,930,0.02,1
2358,2359,Kalyan Nagar,275250,39900,235350,0.8550408719346049,-1
2359,2360,Krishnarajapuram,158600,20360,138240,0.8716267339218159,-1
2360,2361,Indiranagar,176850,46170,130680,0.7389312977099237,0
2361,2362,Kammanahalli,340550,56140,284410,0.8351490236382323,-1
2362,2363,Mahadevapura,331650,48220,283430,0.854605759083371,-1
2363,2364,Hebbal,223600,91070,132530,0.5927101967799642,0
2364,2365,Hoodi,395400,50280,345120,0.8728376327769347,-1
2365,2366,Jalahalli,149150,8890,140260,0.9403955749245726,-1
2366,2367,Varthur,132900,35690,97210,0.7314522197140707,0
2367,2368,Hebbal,313850,59100,254750,0.8116934841484785,-1
2368,2369,Marathahalli,301500,65460,236040,0.7828855721393034,0
2369,2370,Kammanahalli,239300,19120,220180,0.9201002925198496,-1
2370,2371,Vasanth Nagar,171350,35930,135420,0.790312226437117,0
2371,2372,Krishnarajapuram,284550,72640,211910,0.7447197329116149,0
2372,2373,Rajajinagar,342550,45110,297440,0.8683111954459203,-1
2373,2374,Kalyan Nagar,79950,0,79950,1.0,-1
2374,2375,Indiranagar,228000,78800,149200,0.6543859649122807,0
2375,2376,Malleswaram,395150,26910,368240,0.9318992787549032,-1
2376,2377,Hebbal,379300,30910,348390,0.9185077774848405,-1
2377,2378,Hoodi,364600,120540,244060,0.6693911135490949,0
2378,2379,Banaswadi,118500,60310,58190,0.4910548523206751,1
2379,2380,Vasanth Nagar,105400,51930,53470,0.5073055028462998,0
2380,2381,Rajajinagar,77600,32700,44900,0.5786082474226805,0
2381,2382,HBR Layout,372150,46210,325940,0.8758296385865915,-1
2382,2383,Banaswadi,195400,127330,68070,0.3483623336745138,1
2383,2384,Marathahalli,155350,51200,104150,0.6704216285806244,0
2384,2385,Mahadevapura,251350,52950,198400,0.7893375770837477,0
2385,2386,Kammanahalli,66750,47090,19660,0.2945318352059925,1
2386,2387,Kammanahalli,318100,54240,263860,0.8294875825212198,-1
2387,2388,Whitefield,109100,35480,73620,0.6747937671860679,0
2388,2389,Banaswadi,158050,48520,109530,0.6930085416007592,0
2389,2390,Jalahalli,194950,94450,100500,0.5155167991792767,0
2390,2391,Whitefield,111100,24360,86740,0.7807380738073807,0
2391,2392,Banaswadi,106050,66770,39280,0.3703913248467704,1
2392,2393,Krishnarajapuram,359750,66990,292760,0.8137873523280056,-1
2393,2394,Varthur,433300,61950,371350,0.8570274636510501,-1
2394,2395,Hoodi,372550,51830,320720,0.8608777345322776,-1
2395,2396,Shivajinagar,448100,34540,413560,0.9229189912965856,-1
2396,2397,Kammanahalli,263450,44040,219410,0.8328335547542228,-1
2397,2398,Whitefield,374750,51620,323130,0.8622548365577052,-1
2398,2399,Malleswaram,33150,25100,8050,0.24283559577677225,1
2399,2400,Indiranagar,62600,56050,6550,0.10463258785942492,1
2400,2401,HBR Layout,265250,33970,231280,0.8719321394910462,-1
2401,2402,Horamavu,268750,110880,157870,0.5874232558139535,0
2402,2403,Varthur,195750,52680,143070,0.7308812260536398,0
2403,2404,Marathahalli,258900,56620,202280,0.7813055233680958,0
2404,2405,Banaswadi,240100,82880,157220,0.6548104956268221,0
2405,2406,Kammanahalli,50350,55190,-4840,-0.09612711022840119,1
2406,2407,Whitefield,323650,58900,264750,0.8180132859570524,-1
2407,2408,Banaswadi,400100,57210,342890,0.8570107473131717,-1
2408,2409,Rajajinagar,58550,61690,-3140,-0.05362937660119556,1
2409,2410,CV Raman Nagar,291300,77200,214100,0.7349811191211809,0
2410,2411,Jalahalli,230650,125150,105500,0.4574029915456319,1
2411,2412,Varthur,34200,107370,-73170,-2.139473684210526,1
2412,2413,Hebbal,201250,3990,197260,0.9801739130434782,-1
2413,2414,Banaswadi,50850,35840,15010,0.2951819075712881,1
2414,2415,Krishnarajapuram,101200,84480,16720,0.16521739130434782,1
2415,2416,Vasanth Nagar,164600,84670,79930,0.4856014580801944,1
2416,2417,Hebbal,214450,128430,86020,0.4011191419911401,1
2417,2418,Indiranagar,218800,63690,155110,0.7089122486288848,0
2418,2419,Kammanahalli,433100,52240,380860,0.8793812052643731,-1
2419,2420,Hoodi,440700,12150,428550,0.972430224642614,-1
2420,2421,Malleswaram,203900,73440,130460,0.639823442864149,0
2421,2422,CV Raman Nagar,59300,104180,-44880,-0.7568296795952782,1
2422,2423,Krishnarajapuram,285300,20840,264460,0.9269540834209604,-1
2423,2424,Shivajinagar,369100,141200,227900,0.6174478461121647,0
2424,2425,Marathahalli,422650,23190,399460,0.9451319058322489,-1
2425,2426,Kammanahalli,204250,94440,109810,0.5376254589963281,0
2426,2427,Rajajinagar,155250,82100,73150,0.4711755233494364,1
2427,2428,Jalahalli,288300,20990,267310,0.9271938952480056,-1
2428,2429,HBR Layout,65550,23320,42230,0.6442410373760488,0
2429,2430,HBR Layout,177150,66890,110260,0.6224103866779566,0
2430,2431,Whitefield,49750,133700,-83950,-1.6874371859296482,1
2431,2432,HBR Layout,47000,92150,-45150,-0.9606382978723405,1
2432,2433,Marathahalli,88600,33620,54980,0.6205417607223477,0
2433,2434,Banaswadi,404050,52680,351370,0.8696200965227076,-1
2434,2435,Kalyan Nagar,347000,41640,305360,0.88,-1
2435,2436,Malleswaram,86000,114820,-28820,-0.33511627906976743,1
2436,2437,CV Raman Nagar,285450,113790,171660,0.6013662637940095,0
2437,2438,Hoodi,370200,49470,320730,0.8663695299837926,-1
2438,2439,Varthur,237050,12390,224660,0.9477325458763974,-1
2439,2440,Whitefield,325250,64120,261130,0.802859338970023,-1
2440,2441,Banaswadi,446150,64600,381550,0.8552056483245545,-1
2441,2442,Kammanahalli,446400,27920,418480,0.9374551971326165,-1
2442,2443,Marathahalli,352200,47260,304940,0.8658148779102782,-1
2443,2444,Malleswaram,177500,72810,104690,0.5898028169014085,0
2444,2445,Rajajinagar,114800,77520,37280,0.32473867595818817,1
2445,2446,Hebbal,78950,64400,14550,0.18429385687143762,1
2446,2447,Rajajinagar,225200,26580,198620,0.8819715808170515,-1
2447,2448,CV Raman Nagar,130500,29760,100740,0.7719540229885058,0
2448,2449,Banaswadi,259850,104160,155690,0.599153357706369,0
2449,2450,Malleswaram,328600,24740,303860,0.9247108947048083,-1
2450,2451,Banaswadi,321900,13170,308730,0.9590866728797763,-1
2451,2452,Varthur,355400,75010,280390,0.7889420371412493,0
2452,2453,Hebbal,213650,19450,194200,0.9089632576644044,-1
2453,2454,Vasanth Nagar,274750,125640,149110,0.5427115559599636,0
2454,2455,Kammanahalli,286750,71650,215100,0.7501307759372275,0
2455,2456,Marathahalli,92800,111140,-18340,-0.19762931034482759,1
2456,2457,Varthur,174550,100140,74410,0.4262961902033801,1
2457,2458,Banaswadi,169300,189290,-19990,-0.11807442409923213,1
2458,2459,Vasanth Nagar,146100,18320,127780,0.8746064339493498,-1
2459,2460,Krishnarajapuram,169300,44440,124860,0.7375073833431778,0
2460,2461,Kammanahalli,165300,118920,46380,0.2805807622504537,1
2461,2462,Marathahalli,284900,98140,186760,0.6555282555282556,0
2462,2463,Jalahalli,322900,8860,314040,0.9725611644471973,-1
2463,2464,Rajajinagar,92300,49190,43110,0.46706392199349944,1
2464,2465,Indiranagar,38700,26880,11820,0.3054263565891473,1
2465,2466,Kalyan Nagar,129950,32970,96980,0.7462870334744133,0
2466,2467,Kammanahalli,56250,65860,-9610,-0.17084444444444444,1
2467,2468,Banaswadi,38650,68070,-29420,-0.7611901681759379,1
2468,2469,Hoodi,33650,77660,-44010,-1.3078751857355126,1
2469,2470,Kalyan Nagar,64600,85000,-20400,-0.3157894736842105,1
2470,2471,HBR Layout,245600,107890,137710,0.5607084690553746,0
2471,2472,HBR Layout,167200,27090,140110,0.8379784688995215,-1
2472,2473,CV Raman Nagar,301750,44350,257400,0.8530240265120133,-1
2473,2474,Shivajinagar,132850,80870,51980,0.3912683477606323,1
2474,2475,Hoodi,304600,62570,242030,0.7945830597504925,0
2475,2476,Kalyan Nagar,442000,44650,397350,0.8989819004524887,-1
2476,2477,CV Raman Nagar,72450,46500,25950,0.3581780538302277,1
2477,2478,Malleswaram,146650,56140,90510,0.6171837708830549,0
2478,2479,Hoodi,39550,77640,-38090,-0.9630847029077118,1
2479,2480,Shivajinagar,39850,19030,20820,0.5224592220828106,0
2480,2481,Indiranagar,38600,74680,-36080,-0.9347150259067357,1
2481,2482,Mahadevapura,272600,90820,181780,0.6668378576669112,0
2482,2483,CV Raman Nagar,406700,77980,328720,0.8082616179001721,-1
2483,2484,Whitefield,418950,89960,328990,0.7852727055734574,0
2484,2485,Hebbal,26050,104260,-78210,-3.002303262955854,1
2485,2486,Vasanth Nagar,167450,53480,113970,0.6806210809196775,0
2486,2487,Indiranagar,410100,67140,342960,0.8362838332114119,-1
2487,2488,Kammanahalli,115300,14290,101010,0.876062445793582,-1
2488,2489,Shivajinagar,340200,30580,309620,0.9101116990005879,-1
2489,2490,Krishnarajapuram,342900,34770,308130,0.8986001749781277,-1
2490,2491,Varthur,357000,67480,289520,0.8109803921568628,-1
2491,2492,Varthur,85450,71290,14160,0.16571094207138679,1
2492,2493,Hoodi,412900,54940,357960,0.8669411479777186,-1
2493,2494,Mahadevapura,222400,53660,168740,0.7587230215827339,0
2494,2495,Hoodi,143200,110260,32940,0.23002793296089385,1
2495,2496,Malleswaram,62850,94030,-31180,-0.4961018297533811,1
2496,2497,Indiranagar,356250,72970,283280,0.7951719298245614,0
2497,2498,Horamavu,85050,85820,-770,-0.00905349794238683,1
2498,2499,CV Raman Nagar,434600,111400,323200,0.7436723423838012,0
2499,2500,Malleswaram,46900,126550,-79650,-1.6982942430703625,1
2500,2501,Varthur,216600,57520,159080,0.7344413665743306,0
2501,2502,Malleswaram,352900,89720,263180,0.74576367242845,0
2502,2503,Varthur,80600,66240,14360,0.1781637717121588,1
2503,2504,Horamavu,274350,73810,200540,0.7309640969564425,0
2504,2505,Krishnarajapuram,132150,75500,56650,0.428679530836171,1
2505,2506,Varthur,397850,60240,337610,0.848586150559256,-1
2506,2507,Kalyan Nagar,336300,15660,320640,0.9534344335414808,-1
2507,2508,Kammanahalli,44050,71760,-27710,-0.6290578887627696,1
2508,2509,Whitefield,357500,93890,263610,0.7373706293706294,0
2509,2510,Horamavu,222050,57460,164590,0.7412294528259401,0
2510,2511,Jalahalli,122900,24590,98310,0.7999186330349878,0
2511,2512,Hoodi,131750,73680,58070,0.4407590132827324,1
2512,2513,Malleswaram,77900,35250,42650,0.5474967907573812,0
2513,2514,Kammanahalli,444250,58900,385350,0.8674169949352842,-1
2514,2515,Banaswadi,227800,19080,208720,0.9162423178226514,-1
2515,2516,Malleswaram,411000,84260,326740,0.7949878345498783,0
2516,2517,Krishnarajapuram,233000,32990,200010,0.858412017167382,-1
2517,2518,Krishnarajapuram,310150,104330,205820,0.6636143801386426,0
2518,2519,Banaswadi,317350,101510,215840,0.6801323459902316,0
2519,2520,Whitefield,160900,7430,153470,0.9538222498446239,-1
2520,2521,Varthur,65050,69970,-4920,-0.07563412759415834,1
2521,2522,Malleswaram,434050,43700,390350,0.8993203547978343,-1
2522,2523,Rajajinagar,173300,32400,140900,0.8130409694171956,-1
2523,2524,Vasanth Nagar,329850,56170,273680,0.829710474458087,-1
2524,2525,Mahadevapura,418750,16720,402030,0.9600716417910448,-1
2525,2526,Kammanahalli,177300,72550,104750,0.5908065425831923,0
2526,2527,Krishnarajapuram,267300,22270,245030,0.9166853722409278,-1
2527,2528,HBR Layout,272850,73390,199460,0.7310243723657688,0
2528,2529,Kalyan Nagar,129650,22600,107050,0.825684535287312,-1
2529,2530,Horamavu,438300,94280,344020,0.7848961898243212,0
2530,2531,Kalyan Nagar,195700,34120,161580,0.8256515074092999,-1
2531,2532,HBR Layout,399200,25750,373450,0.9354959919839679,-1
2532,2533,Vasanth Nagar,180900,58640,122260,0.6758430071862908,0
2533,2534,Kalyan Nagar,353850,50750,303100,0.8565776458951533,-1
2534,2535,Krishnarajapuram,282000,58460,223540,0.792695035460993,0
2535,2536,Jalahalli,395650,58400,337250,0.8523947933779856,-1
2536,2537,Horamavu,192350,49310,143040,0.7436443982323889,0
2537,2538,Whitefield,249850,106470,143380,0.5738643185911547,0
2538,2539,Malleswaram,342550,60030,282520,0.8247555101445044,-1
2539,2540,Indiranagar,190450,52310,138140,0.7253347335258598,0
2540,2541,Shivajinagar,73800,90690,-16890,-0.22886178861788617,1
2541,2542,Shivajinagar,400500,32330,368170,0.9192759051186018,-1
2542,2543,Banaswadi,148750,76050,72700,0.4887394957983193,1
2543,2544,Malleswaram,125650,29450,96200,0.7656187823318743,0
2544,2545,Kammanahalli,152150,59930,92220,0.6061123890897141,0
2545,2546,HBR Layout,393300,76310,316990,0.8059750826341215,-1
2546,2547,Kalyan Nagar,52650,24040,28610,0.5433998100664768,0
2547,2548,Jalahalli,152550,172650,-20100,-0.13176007866273354,1
2548,2549,Mahadevapura,429200,59270,369930,0.8619058713886301,-1
2549,2550,Krishnarajapuram,412250,58190,354060,0.8588477865372953,-1
2550,2551,Kammanahalli,429250,26930,402320,0.937262667443215,-1
2551,2552,Banaswadi,48500,54140,-5640,-0.11628865979381443,1
2552,2553,Shivajinagar,407600,46430,361170,0.8860893032384691,-1
2553,2554,Kalyan Nagar,445850,41540,404310,0.9068296512279915,-1
2554,2555,CV Raman Nagar,146650,33460,113190,0.7718377088305489,0
2555,2556,Rajajinagar,237350,134680,102670,0.4325679376448283,1
2556,2557,Horamavu,47400,55770,-8370,-0.17658227848101266,1
2557,2558,Kammanahalli,137350,86570,50780,0.36971241354204587,1
2558,2559,Hebbal,262900,16970,245930,0.9354507417268924,-1
2559,2560,Horamavu,409900,78940,330960,0.8074164430348866,-1
2560,2561,Mahadevapura,297150,20840,276310,0.9298670705031129,-1
2561,2562,Rajajinagar,113700,55020,58680,0.5160949868073879,0
2562,2563,Varthur,27550,24570,2980,0.10816696914700545,1
2563,2564,Shivajinagar,389600,88170,301430,0.7736909650924024,0
2564,2565,Varthur,187150,37610,149540,0.7990382046486776,0
2565,2566,Vasanth Nagar,419000,58250,360750,0.8609785202863962,-1
2566,2567,Indiranagar,418350,3270,415080,0.9921835783434922,-1
2567,2568,Whitefield,217100,69090,148010,0.681759557807462,0
2568,2569,Shivajinagar,426450,74560,351890,0.8251612146793293,-1
2569,2570,Banaswadi,379000,82920,296080,0.7812137203166227,0
2570,2571,Kalyan Nagar,225250,55380,169870,0.7541398446170922,0
2571,2572,Krishnarajapuram,52900,81800,-28900,-0.5463137996219282,1
2572,2573,Vasanth Nagar,340550,48280,292270,0.8582293348994274,-1
2573,2574,Marathahalli,217950,31150,186800,0.8570773113099335,-1
2574,2575,Vasanth Nagar,107050,76170,30880,0.28846333489023823,1
2575,2576,Hoodi,225950,156450,69500,0.3075901748174375,1
2576,2577,HBR Layout,356550,37750,318800,0.894124246248773,-1
2577,2578,HBR Layout,187750,84490,103260,0.5499866844207723,0
2578,2579,Varthur,157550,71740,85810,0.5446524912726118,0
2579,2580,Kammanahalli,160600,85520,75080,0.46749688667496886,1
2580,2581,Horamavu,58600,125210,-66610,-1.1366894197952218,1
2581,2582,Banaswadi,337300,35950,301350,0.893418321968574,-1
2582,2583,Vasanth Nagar,87600,62210,25390,0.28984018264840183,1
2583,2584,Shivajinagar,393350,100360,292990,0.7448582687174272,0
2584,2585,Kalyan Nagar,142900,93120,49780,0.3483554933519944,1
2585,2586,HBR Layout,202950,55810,147140,0.7250061591525007,0
2586,2587,Marathahalli,423100,39540,383560,0.9065469156227842,-1
2587,2588,Malleswaram,320900,27690,293210,0.9137114365846059,-1
2588,2589,Shivajinagar,256700,40650,216050,0.8416439423451499,-1
2589,2590,Whitefield,250050,84690,165360,0.6613077384523095,0
2590,2591,Malleswaram,131300,88510,42790,0.3258948971820259,1
2591,2592,Krishnarajapuram,105650,57630,48020,0.4545196403218173,1
2592,2593,Mahadevapura,80450,55910,24540,0.3050341827221877,1
2593,2594,Shivajinagar,147350,58620,88730,0.6021717000339328,0
2594,2595,Mahadevapura,35000,23300,11700,0.3342857142857143,1
2595,2596,Horamavu,441750,32020,409730,0.9275155631013017,-1
2596,2597,Malleswaram,51350,91750,-40400,-0.7867575462512172,1
2597,2598,Kalyan Nagar,25550,44280,-18730,-0.7330724070450098,1
2598,2599,CV Raman Nagar,59400,23270,36130,0.6082491582491583,0
2599,2600,Kalyan Nagar,173800,68130,105670,0.6079976985040276,0
2600,2601,Shivajinagar,29750,96260,-66510,-2.23563025210084,1
2601,2602,Indiranagar,62100,49170,12930,0.20821256038647343,1
2602,2603,Rajajinagar,99150,110730,-11580,-0.1167927382753404,1
2603,2604,Kalyan Nagar,261800,104140,157660,0.6022154316271964,0
2604,2605,Marathahalli,409150,37350,371800,0.9087131858731516,-1
2605,2606,HBR Layout,304150,12490,291660,0.958934736149926,-1
2606,2607,Vasanth Nagar,93600,17780,75820,0.810042735042735,-1
2607,2608,Vasanth Nagar,275200,33380,241820,0.8787063953488372,-1
2608,2609,Hebbal,387900,0,387900,1.0,-1
2609,2610,Kammanahalli,278000,31510,246490,0.8866546762589929,-1
2610,2611,Krishnarajapuram,311400,35460,275940,0.8861271676300578,-1
2611,2612,Malleswaram,122900,55800,67100,0.5459723352318958,0
2612,2613,Jalahalli,65150,83680,-18530,-0.28442056792018416,1
2613,2614,HBR Layout,417200,67360,349840,0.838542665388303,-1
2614,2615,Rajajinagar,54900,92450,-37550,-0.6839708561020036,1
2615,2616,Kammanahalli,108300,26250,82050,0.7576177285318559,0
2616,2617,Hebbal,144900,50360,94540,0.6524499654934438,0
2617,2618,Whitefield,36650,36490,160,0.0043656207366985,1
2618,2619,Rajajinagar,376750,130530,246220,0.6535368281353683,0
2619,2620,Jalahalli,398850,60300,338550,0.8488153441143287,-1
2620,2621,Malleswaram,66000,64450,1550,0.023484848484848483,1
2621,2622,Indiranagar,338300,60630,277670,0.8207803724504877,-1
2622,2623,Banaswadi,41000,81850,-40850,-0.9963414634146341,1
2623,2624,Jalahalli,352550,28250,324300,0.9198695220536094,-1
2624,2625,Kammanahalli,107400,31910,75490,0.7028864059590316,0
2625,2626,HBR Layout,303500,64670,238830,0.7869192751235585,0
2626,2627,HBR Layout,399000,78630,320370,0.8029323308270677,-1
2627,2628,Hoodi,114850,84800,30050,0.261645624727906,1
2628,2629,Rajajinagar,194650,27160,167490,0.8604675057796044,-1
2629,2630,Malleswaram,381350,33790,347560,0.911393732791399,-1
2630,2631,Hoodi,87800,30620,57180,0.65125284738041,0
2631,2632,Kalyan Nagar,289350,67470,221880,0.766822187662001,0
2632,2633,Varthur,89850,101120,-11270,-0.12543127434613244,1
2633,2634,Kalyan Nagar,143000,63550,79450,0.5555944055944056,0
2634,2635,Varthur,258150,118890,139260,0.5394538059267867,0
2635,2636,Banaswadi,89700,49270,40430,0.45072463768115945,1
2636,2637,Shivajinagar,108250,58460,49790,0.45995381062355656,1
2637,2638,Indiranagar,376500,78340,298160,0.7919256308100929,0
2638,2639,Hebbal,446000,101000,345000,0.773542600896861,0
2639,2640,Krishnarajapuram,59750,64480,-4730,-0.079163179916318,1
2640,2641,Hoodi,80350,28210,52140,0.6489110143123833,0
2641,2642,Horamavu,353450,24650,328800,0.9302588767859669,-1
2642,2643,Marathahalli,64100,30590,33510,0.5227769110764431,0
2643,2644,Hoodi,308600,51830,256770,0.832047958522359,-1
2644,2645,Banaswadi,217450,70830,146620,0.6742699471142791,0
2645,2646,Krishnarajapuram,251600,38510,213090,0.846939586645469,-1
2646,2647,Kammanahalli,230400,77140,153260,0.6651909722222222,0
2647,2648,Vasanth Nagar,400800,53650,347150,0.8661427145708582,-1
2648,2649,Banaswadi,435250,51310,383940,0.8821137277426766,-1
2649,2650,Rajajinagar,190300,35900,154400,0.8113504992117709,-1
2650,2651,Jalahalli,333800,26310,307490,0.9211803475134811,-1
2651,2652,Indiranagar,92750,59570,33180,0.35773584905660377,1
2652,2653,Horamavu,354600,88720,265880,0.7498025944726452,0
2653,2654,Kammanahalli,104850,75280,29570,0.2820219360991893,1
2654,2655,Jalahalli,160350,47990,112360,0.700717181166199,0
2655,2656,Kalyan Nagar,112450,35220,77230,0.6867941307247666,0
2656,2657,HBR Layout,126100,42960,83140,0.6593180015860428,0
2657,2658,Indiranagar,313300,31970,281330,0.8979572294924992,-1
2658,2659,Marathahalli,188450,58650,129800,0.6887768638896259,0
2659,2660,CV Raman Nagar,125850,61520,64330,0.5111640842272547,0
2660,2661,Mahadevapura,360500,94340,266160,0.7383079056865465,0
2661,2662,Rajajinagar,239300,52210,187090,0.7818219807772671,0
2662,2663,Rajajinagar,122150,58600,63550,0.520261972984036,0
2663,2664,Hebbal,137250,51000,86250,0.6284153005464481,0
2664,2665,Varthur,339700,86740,252960,0.744657050338534,0
2665,2666,Hebbal,106100,20800,85300,0.8039585296889726,-1
2666,2667,Krishnarajapuram,197300,30220,167080,0.8468322351748606,-1
2667,2668,Mahadevapura,229350,45440,183910,0.8018748637453673,-1
2668,2669,Hoodi,449600,40310,409290,0.9103425266903915,-1
2669,2670,CV Raman Nagar,370650,31640,339010,0.9146364494806422,-1
2670,2671,Banaswadi,95050,116100,-21050,-0.22146238821672803,1
2671,2672,Hoodi,344450,80910,263540,0.7651037886485702,0
2672,2673,Indiranagar,386850,16740,370110,0.9567274137262505,-1
2673,2674,Mahadevapura,431150,88270,342880,0.7952684680505624,0
2674,2675,Banaswadi,336250,43570,292680,0.8704237918215614,-1
2675,2676,Vasanth Nagar,242900,56250,186650,0.768423219431865,0
2676,2677,HBR Layout,406250,76420,329830,0.8118892307692308,-1
2677,2678,Krishnarajapuram,359450,39050,320400,0.8913618027542078,-1
2678,2679,Horamavu,434900,106730,328170,0.7545872614394113,0
2679,2680,Banaswadi,182250,23890,158360,0.8689163237311386,-1
2680,2681,Krishnarajapuram,354750,23020,331730,0.9351092318534179,-1
2681,2682,Horamavu,151100,32370,118730,0.785771012574454,0
2682,2683,Jalahalli,80350,40800,39550,0.492221530802738,1
2683,2684,Marathahalli,415050,25270,389780,0.9391157691844356,-1
2684,2685,Banaswadi,239850,42510,197340,0.8227642276422764,-1
2685,2686,Krishnarajapuram,303000,40310,262690,0.866963696369637,-1
2686,2687,Whitefield,422400,62690,359710,0.8515861742424242,-1
2687,2688,Whitefield,347650,25950,321700,0.9253559614554868,-1
2688,2689,Marathahalli,405700,96280,309420,0.7626817845698792,0
2689,2690,Malleswaram,163950,79170,84780,0.5171088746569076,0
2690,2691,Indiranagar,230700,0,230700,1.0,-1
2691,2692,Krishnarajapuram,353900,65830,288070,0.8139870019779599,-1
2692,2693,Rajajinagar,299150,85450,213700,0.7143573458131373,0
2693,2694,Krishnarajapuram,392350,123990,268360,0.6839811392889003,0
2694,2695,Indiranagar,352250,137470,214780,0.609737402413059,0
2695,2696,Hoodi,196700,87380,109320,0.5557702084392476,0
2696,2697,Krishnarajapuram,270200,58130,212070,0.7848630643967431,0
2697,2698,Indiranagar,125700,56330,69370,0.5518695306284805,0
2698,2699,Krishnarajapuram,62300,133020,-70720,-1.1351524879614767,1
2699,2700,Kalyan Nagar,114100,25770,88330,0.774145486415425,0
2700,2701,Kammanahalli,379550,28170,351380,0.9257805295744961,-1
2701,2702,Varthur,175850,54720,121130,0.6888257037247654,0
2702,2703,Jalahalli,408500,7750,400750,0.9810281517747858,-1
2703,2704,Whitefield,117450,65400,52050,0.44316730523627074,1
2704,2705,Kammanahalli,265550,41190,224360,0.8448879683675391,-1
2705,2706,Vasanth Nagar,203000,93470,109530,0.5395566502463054,0
2706,2707,Shivajinagar,366050,44240,321810,0.8791421936893867,-1
2707,2708,HBR Layout,185400,102500,82900,0.4471413160733549,1
2708,2709,Marathahalli,324600,110330,214270,0.6601047443006778,0
2709,2710,Kalyan Nagar,436950,97420,339530,0.7770454285387344,0
2710,2711,HBR Layout,254600,50610,203990,0.8012175962293794,-1
2711,2712,Hebbal,366950,46870,320080,0.8722714266248808,-1
2712,2713,Jalahalli,115300,0,115300,1.0,-1
2713,2714,Shivajinagar,153600,0,153600,1.0,-1
2714,2715,Krishnarajapuram,273200,43730,229470,0.8399341142020498,-1
2715,2716,Jalahalli,391250,1890,389360,0.9951693290734824,-1
2716,2717,Krishnarajapuram,177400,57370,120030,0.6766065388951522,0
2717,2718,HBR Layout,50150,35790,14360,0.28634097706879363,1
2718,2719,Kammanahalli,447600,64480,383120,0.8559428060768544,-1
2719,2720,Rajajinagar,190850,59110,131740,0.6902803248624574,0
2720,2721,CV Raman Nagar,146350,33410,112940,0.771711650153741,0
2721,2722,Malleswaram,39900,205750,-165850,-4.156641604010025,1
2722,2723,Varthur,125150,50940,74210,0.5929684378745506,0
2723,2724,Varthur,204550,69550,135000,0.659985333659252,0
2724,2725,Kammanahalli,233100,52950,180150,0.7728442728442728,0
2725,2726,Mahadevapura,367600,58900,308700,0.8397714907508161,-1
2726,2727,Krishnarajapuram,82800,89150,-6350,-0.07669082125603864,1
2727,2728,Vasanth Nagar,147050,67040,80010,0.5441006460387623,0
2728,2729,Vasanth Nagar,393600,77740,315860,0.802489837398374,-1
2729,2730,Horamavu,361750,50530,311220,0.8603178991015895,-1
2730,2731,Marathahalli,444000,65090,378910,0.8534009009009009,-1
2731,2732,Rajajinagar,48250,80310,-32060,-0.6644559585492228,1
2732,2733,Marathahalli,89550,123550,-34000,-0.3796761585706309,1
2733,2734,CV Raman Nagar,103300,58350,44950,0.4351403678606002,1
2734,2735,Krishnarajapuram,431700,36340,395360,0.9158211721102617,-1
2735,2736,Hoodi,115050,129710,-14660,-0.12742285962624947,1
2736,2737,Banaswadi,191300,7300,184000,0.9618400418191323,-1
2737,2738,Varthur,430700,28710,401990,0.9333410726723937,-1
2738,2739,Hebbal,350550,16810,333740,0.952046783625731,-1
2739,2740,Kammanahalli,426550,107680,318870,0.7475559723361856,0
2740,2741,Kalyan Nagar,306750,0,306750,1.0,-1
2741,2742,Hebbal,365000,55970,309030,0.8466575342465753,-1
2742,2743,Shivajinagar,304400,58030,246370,0.8093626806833114,-1
2743,2744,Krishnarajapuram,34900,34360,540,0.015472779369627506,1
2744,2745,Hoodi,50300,146000,-95700,-1.9025844930417495,1
2745,2746,Shivajinagar,124700,74850,49850,0.3997594226142743,1
2746,2747,Vasanth Nagar,287050,24320,262730,0.91527608430587,-1
2747,2748,Kalyan Nagar,327500,58870,268630,0.8202442748091603,-1
2748,2749,Malleswaram,120000,31090,88910,0.7409166666666667,0
2749,2750,Banaswadi,259650,45460,214190,0.8249181590602734,-1
2750,2751,Varthur,138400,94830,43570,0.3148121387283237,1
2751,2752,Banaswadi,401150,41680,359470,0.896098716190951,-1
2752,2753,Mahadevapura,388950,24750,364200,0.936367142306209,-1
2753,2754,Kalyan Nagar,414300,43840,370460,0.8941829592083032,-1
2754,2755,Rajajinagar,51450,69020,-17570,-0.3414965986394558,1
2755,2756,Jalahalli,306850,46530,260320,0.848362392048232,-1
2756,2757,Marathahalli,118400,49170,69230,0.5847128378378378,0
2757,2758,HBR Layout,283200,59530,223670,0.789795197740113,0
2758,2759,Varthur,39600,61030,-21430,-0.5411616161616162,1
2759,2760,Krishnarajapuram,185000,24690,160310,0.8665405405405405,-1
2760,2761,Whitefield,321000,29890,291110,0.9068847352024922,-1
2761,2762,Banaswadi,160700,77950,82750,0.514934660858743,0
2762,2763,Hoodi,109150,69970,39180,0.35895556573522674,1
2763,2764,Mahadevapura,162700,54320,108380,0.6661339889366933,0
2764,2765,Shivajinagar,155500,86850,68650,0.4414790996784566,1
2765,2766,Mahadevapura,222900,76900,146000,0.655002243158367,0
2766,2767,Mahadevapura,361750,100940,260810,0.7209675190048376,0
2767,2768,Jalahalli,212100,67370,144730,0.6823668081093823,0
2768,2769,Varthur,353200,83940,269260,0.7623442808607022,0
2769,2770,Horamavu,202000,39800,162200,0.802970297029703,-1
2770,2771,Hebbal,283200,78620,204580,0.7223870056497175,0
2771,2772,HBR Layout,328900,0,328900,1.0,-1
2772,2773,HBR Layout,247150,106680,140470,0.5683592959741048,0
2773,2774,Jalahalli,40200,86380,-46180,-1.1487562189054725,1
2774,2775,Shivajinagar,275050,38520,236530,0.8599527358662061,-1
2775,2776,Hoodi,307950,45810,262140,0.8512420847540185,-1
2776,2777,Mahadevapura,281250,133300,147950,0.5260444444444444,0
2777,2778,Vasanth Nagar,226250,52180,174070,0.7693701657458564,0
2778,2779,Horamavu,357950,33730,324220,0.905768962145551,-1
2779,2780,Varthur,329900,95970,233930,0.709093664746893,0
2780,2781,CV Raman Nagar,164700,70340,94360,0.5729204614450516,0
2781,2782,Marathahalli,449500,35250,414250,0.921579532814238,-1
2782,2783,Hoodi,419850,85590,334260,0.7961414790996785,0
2783,2784,Hebbal,178250,81780,96470,0.5412061711079944,0
2784,2785,Indiranagar,103300,65640,37660,0.36456921587608904,1
2785,2786,CV Raman Nagar,254450,114150,140300,0.5513853409314207,0
2786,2787,Whitefield,256200,68040,188160,0.7344262295081967,0
2787,2788,Kammanahalli,62550,73240,-10690,-0.17090327737809752,1
2788,2789,Indiranagar,408600,46350,362250,0.8865638766519823,-1
2789,2790,Kalyan Nagar,217250,75630,141620,0.6518757192174913,0
2790,2791,Horamavu,68650,130850,-62200,-0.9060451565914057,1
2791,2792,Malleswaram,290950,30660,260290,0.8946210689121842,-1
2792,2793,Marathahalli,194500,96080,98420,0.5060154241645244,0
2793,2794,HBR Layout,251450,129440,122010,0.485225690992245,1
2794,2795,Marathahalli,434950,86590,348360,0.8009196459363145,-1
2795,2796,Varthur,242100,96100,146000,0.6030565881866997,0
2796,2797,Rajajinagar,240400,32230,208170,0.8659317803660566,-1
2797,2798,Horamavu,167350,74490,92860,0.5548849716163728,0
2798,2799,Malleswaram,149100,26610,122490,0.8215291750503018,-1
2799,2800,Jalahalli,34000,42700,-8700,-0.25588235294117645,1
2800,2801,Marathahalli,133850,44210,89640,0.669704893537542,0
2801,2802,Hebbal,231450,107500,123950,0.5355368330092892,0
2802,2803,Horamavu,419400,43420,375980,0.8964711492608488,-1
2803,2804,HBR Layout,110500,54070,56430,0.5106787330316742,0
2804,2805,CV Raman Nagar,447200,61130,386070,0.8633050089445439,-1
2805,2806,Mahadevapura,124650,80630,44020,0.3531488166867228,1
2806,2807,Mahadevapura,215100,106240,108860,0.506090190609019,0
2807,2808,Hoodi,51650,113400,-61750,-1.1955469506292353,1
2808,2809,Kalyan Nagar,340050,14540,325510,0.9572415821202764,-1
2809,2810,Shivajinagar,404450,71360,333090,0.8235628631474843,-1
2810,2811,Krishnarajapuram,239250,98540,140710,0.5881295715778474,0
2811,2812,Horamavu,167300,88290,79010,0.47226539151225344,1
2812,2813,Jalahalli,64000,15600,48400,0.75625,0
2813,2814,HBR Layout,177300,39400,137900,0.7777777777777778,0
2814,2815,Krishnarajapuram,384150,40620,343530,0.894260054666146,-1
2815,2816,Whitefield,46850,79090,-32240,-0.688153681963714,1
2816,2817,HBR Layout,372300,58230,314070,0.843593875906527,-1
2817,2818,Rajajinagar,69250,21420,47830,0.6906859205776174,0
2818,2819,Vasanth Nagar,279700,61590,218110,0.7797997854844476,0
2819,2820,Hoodi,339850,6120,333730,0.9819920553185228,-1
2820,2821,Hebbal,81750,92800,-11050,-0.13516819571865443,1
2821,2822,Kalyan Nagar,432500,24740,407760,0.9427976878612717,-1
2822,2823,Indiranagar,70150,55200,14950,0.21311475409836064,1
2823,2824,Mahadevapura,144050,110020,34030,0.23623741756334607,1
2824,2825,Hebbal,356350,33010,323340,0.9073663533043356,-1
2825,2826,Rajajinagar,159350,64890,94460,0.592783181675557,0
2826,2827,Krishnarajapuram,99800,48850,50950,0.5105210420841684,0
2827,2828,Mahadevapura,231200,17090,214110,0.9260813148788928,-1
2828,2829,Varthur,71750,54280,17470,0.24348432055749128,1
2829,2830,Hebbal,375250,16320,358930,0.9565089940039974,-1
2830,2831,Marathahalli,443500,31510,411990,0.9289515219842165,-1
2831,2832,Banaswadi,162250,60470,101780,0.6273035439137135,0
2832,2833,Marathahalli,274750,83260,191490,0.696960873521383,0
2833,2834,CV Raman Nagar,253000,57600,195400,0.7723320158102767,0
2834,2835,Kammanahalli,211150,98380,112770,0.5340753019180677,0
2835,2836,Hebbal,192150,76530,115620,0.6017174082747854,0
2836,2837,Shivajinagar,63200,82500,-19300,-0.30537974683544306,1
2837,2838,CV Raman Nagar,377200,93790,283410,0.7513520678685047,0
2838,2839,Banaswadi,284950,90500,194450,0.6824004211265134,0
2839,2840,Whitefield,174650,43670,130980,0.7499570569710851,0
2840,2841,Rajajinagar,385400,43330,342070,0.8875713544369487,-1
2841,2842,Jalahalli,182300,139060,43240,0.2371914426769062,1
2842,2843,Mahadevapura,123550,86280,37270,0.30165924726831245,1
2843,2844,Krishnarajapuram,104350,15150,89200,0.8548155246765692,-1
2844,2845,Kalyan Nagar,53550,76440,-22890,-0.42745098039215684,1
2845,2846,CV Raman Nagar,259000,71610,187390,0.7235135135135136,0
2846,2847,Rajajinagar,181350,72020,109330,0.6028673835125448,0
2847,2848,Kalyan Nagar,199950,107000,92950,0.4648662165541385,1
2848,2849,Hoodi,240300,79550,160750,0.6689554723262588,0
2849,2850,Kalyan Nagar,342300,53350,288950,0.8441425650014607,-1
2850,2851,Indiranagar,196800,41680,155120,0.7882113821138211,0
2851,2852,Krishnarajapuram,281050,43450,237600,0.8454011741682974,-1
2852,2853,Krishnarajapuram,444600,74450,370150,0.8325461088618983,-1
2853,2854,Indiranagar,121650,87990,33660,0.27669543773119604,1
2854,2855,Hebbal,201750,127840,73910,0.3663444857496902,1
2855,2856,Vasanth Nagar,187800,70420,117380,0.6250266240681576,0
2856,2857,Hoodi,403150,84230,318920,0.7910703212203894,0
2857,2858,HBR Layout,357150,58060,299090,0.8374352512949741,-1
2858,2859,Mahadevapura,193150,87310,105840,0.5479679005953921,0
2859,2860,CV Raman Nagar,377200,52610,324590,0.860524920466596,-1
2860,2861,Hebbal,399700,80010,319690,0.7998248686514886,0
2861,2862,Malleswaram,384850,46910,337940,0.8781083539041185,-1
2862,2863,Kalyan Nagar,445150,86810,358340,0.8049870830057284,-1
2863,2864,Krishnarajapuram,352950,7090,345860,0.9799121688624451,-1
2864,2865,Banaswadi,66550,44200,22350,0.33583771600300527,1
2865,2866,CV Raman Nagar,103800,33780,70020,0.6745664739884393,0
2866,2867,Horamavu,123550,124960,-1410,-0.01141238365034399,1
2867,2868,Marathahalli,122150,78080,44070,0.36078591895210804,1
2868,2869,Marathahalli,356800,52220,304580,0.8536434977578475,-1
2869,2870,Vasanth Nagar,160000,139780,20220,0.126375,1
2870,2871,CV Raman Nagar,433750,79760,353990,0.8161152737752161,-1
2871,2872,Rajajinagar,103550,76350,27200,0.2626750362143892,1
2872,2873,Kalyan Nagar,63250,36560,26690,0.4219762845849802,1
2873,2874,HBR Layout,309000,29750,279250,0.9037216828478964,-1
2874,2875,Malleswaram,333400,138430,194970,0.5847930413917216,0
2875,2876,Krishnarajapuram,87650,33370,54280,0.619281232173417,0
2876,2877,Shivajinagar,391600,46630,344970,0.8809244126659856,-1
2877,2878,Whitefield,248300,22680,225620,0.9086588803866291,-1
2878,2879,Malleswaram,114250,94400,19850,0.1737417943107221,1
2879,2880,Kalyan Nagar,275400,111640,163760,0.5946259985475671,0
2880,2881,Jalahalli,297400,71900,225500,0.7582380632145259,0
2881,2882,Kalyan Nagar,405250,100900,304350,0.75101789019124,0
2882,2883,HBR Layout,330000,98770,231230,0.7006969696969697,0
2883,2884,Krishnarajapuram,332300,95250,237050,0.7133614204032501,0
2884,2885,HBR Layout,179250,45380,133870,0.746834030683403,0
2885,2886,Malleswaram,87150,48340,38810,0.4453241537578887,1
2886,2887,HBR Layout,232650,115780,116870,0.5023425746830003,0
2887,2888,Kalyan Nagar,432250,16660,415590,0.9614574898785425,-1
2888,2889,HBR Layout,83150,70560,12590,0.15141310883944678,1
2889,2890,Vasanth Nagar,92750,40720,52030,0.5609703504043126,0
2890,2891,Indiranagar,186550,63150,123400,0.6614848566068078,0
2891,2892,CV Raman Nagar,25350,35620,-10270,-0.40512820512820513,1
2892,2893,Banaswadi,114850,54150,60700,0.5285154549412276,0
2893,2894,Rajajinagar,237500,54020,183480,0.7725473684210526,0
2894,2895,Hoodi,237200,63390,173810,0.7327571669477234,0
2895,2896,HBR Layout,334950,89620,245330,0.7324376772652634,0
2896,2897,Jalahalli,64200,16390,47810,0.7447040498442368,0
2897,2898,Rajajinagar,213550,115030,98520,0.4613439475532662,1
2898,2899,Hoodi,328150,85040,243110,0.7408502209355478,0
2899,2900,Whitefield,388850,47540,341310,0.8777420599202778,-1
2900,2901,Malleswaram,224750,123450,101300,0.4507230255839822,1
2901,2902,Marathahalli,63000,52360,10640,0.1688888888888889,1
2902,2903,Varthur,322350,71840,250510,0.7771366527066853,0
2903,2904,Indiranagar,310600,115840,194760,0.6270444301352222,0
2904,2905,Marathahalli,184000,100970,83030,0.45125,1
2905,2906,Kalyan Nagar,335450,122430,213020,0.6350275748993889,0
2906,2907,Hebbal,128000,101730,26270,0.205234375,1
2907,2908,Varthur,442650,92970,349680,0.789969501863775,0
2908,2909,Malleswaram,134600,115790,18810,0.13974739970282318,1
2909,2910,Hoodi,123250,57910,65340,0.5301419878296146,0
2910,2911,Malleswaram,389750,80980,308770,0.7922257857601026,0
2911,2912,Kalyan Nagar,61700,52160,9540,0.1546191247974068,1
2912,2913,Hoodi,443800,19200,424600,0.9567372690401081,-1
2913,2914,Krishnarajapuram,426650,60770,365880,0.857564748622993,-1
2914,2915,Kalyan Nagar,229500,15530,213970,0.9323311546840959,-1
2915,2916,Jalahalli,232050,80310,151740,0.6539107950872657,0
2916,2917,Hebbal,204350,6480,197870,0.9682896990457548,-1
2917,2918,HBR Layout,223650,67030,156620,0.7002906326849989,0
2918,2919,CV Raman Nagar,41650,74200,-32550,-0.7815126050420168,1
2919,2920,Kammanahalli,48900,61470,-12570,-0.2570552147239264,1
2920,2921,Malleswaram,247950,85520,162430,0.6550917523694293,0
2921,2922,CV Raman Nagar,364350,65530,298820,0.820145464525868,-1
2922,2923,CV Raman Nagar,390400,43820,346580,0.8877561475409836,-1
2923,2924,Kalyan Nagar,92900,9670,83230,0.8959095801937568,-1
2924,2925,Banaswadi,385600,54090,331510,0.8597251037344399,-1
2925,2926,Hoodi,416600,36980,379620,0.9112337974075853,-1
2926,2927,Jalahalli,196250,114340,81910,0.41737579617834397,1
2927,2928,Marathahalli,72350,90920,-18570,-0.25666897028334484,1
2928,2929,Banaswadi,192200,8650,183550,0.9549947970863684,-1
2929,2930,Shivajinagar,101300,61220,40080,0.39565646594274434,1
2930,2931,Mahadevapura,423700,84610,339090,0.8003068208638188,-1
2931,2932,Malleswaram,331000,56890,274110,0.8281268882175227,-1
2932,2933,Malleswaram,108250,86770,21480,0.19842956120092378,1
2933,2934,CV Raman Nagar,32700,30620,2080,0.06360856269113149,1
2934,2935,Hoodi,274050,48070,225980,0.824594052180259,-1
2935,2936,Mahadevapura,416250,54800,361450,0.8683483483483484,-1
2936,2937,Banaswadi,54200,33730,20470,0.3776752767527675,1
2937,2938,Jalahalli,87100,24630,62470,0.7172215843857634,0
2938,2939,Vasanth Nagar,105200,35490,69710,0.6626425855513308,0
2939,2940,Rajajinagar,143300,76260,67040,0.4678297278436846,1
2940,2941,Hebbal,170500,44300,126200,0.7401759530791789,0
2941,2942,Whitefield,368300,68610,299690,0.8137116481129514,-1
2942,2943,Kammanahalli,370650,84940,285710,0.770835019560232,0
2943,2944,Hoodi,221100,80370,140730,0.6364993215739484,0
2944,2945,Vasanth Nagar,370850,84810,286040,0.771309154644735,0
2945,2946,Mahadevapura,138200,84740,53460,0.38683068017366135,1
2946,2947,Varthur,309600,34300,275300,0.8892118863049095,-1
2947,2948,Horamavu,382650,44040,338610,0.8849078792630342,-1
2948,2949,Hebbal,268350,21900,246450,0.9183901621017329,-1
2949,2950,Jalahalli,117800,64090,53710,0.45594227504244483,1
2950,2951,Mahadevapura,283350,61060,222290,0.7845067937180166,0
2951,2952,Kalyan Nagar,25950,112320,-86370,-3.3283236994219654,1
2952,2953,Varthur,188600,58840,129760,0.688016967126193,0
2953,2954,Horamavu,254650,66170,188480,0.7401531513842529,0
2954,2955,Marathahalli,87350,86100,1250,0.014310246136233544,1
2955,2956,Marathahalli,200150,97040,103110,0.5151636272795403,0
2956,2957,Jalahalli,35450,86900,-51450,-1.4513399153737658,1
2957,2958,Jalahalli,374450,57260,317190,0.8470823875016691,-1
2958,2959,Hoodi,426000,162560,263440,0.6184037558685446,0
2959,2960,Mahadevapura,392600,62680,329920,0.8403464085583291,-1
2960,2961,Varthur,81250,126260,-45010,-0.5539692307692308,1
2961,2962,Horamavu,381200,70210,310990,0.8158184679958027,-1
2962,2963,Hebbal,167200,48290,118910,0.7111842105263158,0
2963,2964,Vasanth Nagar,443150,63020,380130,0.8577908157508745,-1
2964,2965,Whitefield,315000,48580,266420,0.8457777777777777,-1
2965,2966,CV Raman Nagar,277050,52730,224320,0.8096733441617037,-1
2966,2967,Rajajinagar,343350,4710,338640,0.9862822193097422,-1
2967,2968,Mahadevapura,285800,12380,273420,0.9566829951014696,-1
2968,2969,Shivajinagar,197700,60950,136750,0.691704602933738,0
2969,2970,Kammanahalli,114500,7850,106650,0.9314410480349345,-1
2970,2971,Hoodi,376700,116640,260060,0.6903636846296788,0
2971,2972,Marathahalli,394250,49190,345060,0.8752314521242867,-1
2972,2973,Hoodi,414100,55330,358770,0.8663849311760444,-1
2973,2974,Mahadevapura,76700,55590,21110,0.2752281616688396,1
2974,2975,Krishnarajapuram,358950,35960,322990,0.899818916283605,-1
2975,2976,Malleswaram,140200,27250,112950,0.8056348074179743,-1
2976,2977,Shivajinagar,439650,108750,330900,0.7526441487546912,0
2977,2978,Varthur,98300,71290,27010,0.2747711088504578,1
2978,2979,Hoodi,115400,50570,64830,0.5617850953206239,0
2979,2980,Shivajinagar,159250,10700,148550,0.9328100470957614,-1
2980,2981,Marathahalli,219950,26580,193370,0.879154353262105,-1
2981,2982,Hebbal,179050,113180,65870,0.3678860653448757,1
2982,2983,Hebbal,194800,121450,73350,0.3765400410677618,1
2983,2984,HBR Layout,173100,36950,136150,0.7865395725014442,0
2984,2985,HBR Layout,398800,101270,297530,0.7460631895687061,0
2985,2986,Shivajinagar,145300,57810,87490,0.6021335168616655,0
2986,2987,Jalahalli,382200,63280,318920,0.8344322344322345,-1
2987,2988,Hebbal,445100,41990,403110,0.9056616490676253,-1
2988,2989,Malleswaram,294900,82420,212480,0.7205154289589691,0
2989,2990,Malleswaram,320600,68950,251650,0.7849344978165939,0
2990,2991,Mahadevapura,285350,67660,217690,0.7628876817942877,0
2991,2992,Mahadevapura,63550,84350,-20800,-0.32730133752950435,1
2992,2993,HBR Layout,90400,35930,54470,0.6025442477876106,0
2993,2994,CV Raman Nagar,254000,60640,193360,0.761259842519685,0
2994,2995,Malleswaram,439950,63380,376570,0.85593817479259,-1
2995,2996,Vasanth Nagar,419250,35540,383710,0.9152295766249254,-1
2996,2997,Jalahalli,78750,33930,44820,0.5691428571428572,0
2997,2998,Varthur,328900,45850,283050,0.8605959258133171,-1
2998,2999,Malleswaram,154900,104290,50610,0.32672692059393155,1
2999,3000,Varthur,64850,87800,-22950,-0.353893600616808,1
3000,3001,Mahadevapura,284200,101150,183050,0.6440886699507389,0
3001,3002,CV Raman Nagar,94350,36590,57760,0.6121886592474828,0
3002,3003,HBR Layout,321600,98820,222780,0.692723880597015,0
3003,3004,Hoodi,262150,97620,164530,0.6276177760823956,0
3004,3005,CV Raman Nagar,25600,74320,-48720,-1.903125,1
3005,3006,Shivajinagar,368250,4090,364160,0.9888934147997285,-1
3006,3007,Horamavu,311250,156270,154980,0.4979277108433735,1
3007,3008,Kalyan Nagar,432050,84470,347580,0.8044902210392316,-1
3008,3009,Banaswadi,192750,38890,153860,0.7982360570687419,0
3009,3010,Rajajinagar,30100,22230,7870,0.2614617940199336,1
3010,3011,Mahadevapura,299900,55270,244630,0.8157052350783595,-1
3011,3012,Mahadevapura,371700,41970,329730,0.8870863599677159,-1
3012,3013,HBR Layout,355200,38550,316650,0.8914695945945946,-1
3013,3014,Hebbal,122850,92980,29870,0.24314204314204313,1
3014,3015,Marathahalli,165800,44240,121560,0.7331724969843184,0
3015,3016,Shivajinagar,288100,48800,239300,0.830614370010413,-1
3016,3017,Kalyan Nagar,317650,87060,230590,0.7259247599559263,0
3017,3018,Kalyan Nagar,68300,77080,-8780,-0.12855051244509516,1
3018,3019,Hebbal,291800,45810,245990,0.8430089102124743,-1
3019,3020,CV Raman Nagar,293500,120750,172750,0.5885860306643952,0
3020,3021,Banaswadi,283600,26600,257000,0.9062059238363893,-1
3021,3022,HBR Layout,241900,95560,146340,0.6049607275733774,0
3022,3023,Horamavu,266550,85970,180580,0.677471393734759,0
3023,3024,Kalyan Nagar,305450,82270,223180,0.7306596824357505,0
3024,3025,Hebbal,36700,76850,-40150,-1.0940054495912805,1
3025,3026,Malleswaram,57400,101040,-43640,-0.7602787456445993,1
3026,3027,Mahadevapura,282100,54640,227460,0.806309819213045,-1
3027,3028,Hoodi,195900,83570,112330,0.5734047983665135,0
3028,3029,Kalyan Nagar,358250,102760,255490,0.7131612002791347,0
3029,3030,Kalyan Nagar,324850,98730,226120,0.6960751115899646,0
3030,3031,HBR Layout,435850,68960,366890,0.8417804290466904,-1
3031,3032,Malleswaram,56300,69780,-13480,-0.2394316163410302,1
3032,3033,Varthur,147400,62060,85340,0.5789687924016282,0
3033,3034,CV Raman Nagar,91050,27270,63780,0.7004942339373971,0
3034,3035,Malleswaram,207100,66170,140930,0.680492515692902,0
3035,3036,Jalahalli,28600,42350,-13750,-0.4807692307692308,1
3036,3037,Jalahalli,365150,26120,339030,0.9284677529782281,-1
3037,3038,Kalyan Nagar,364550,101900,262650,0.7204773007817857,0
3038,3039,CV Raman Nagar,70300,38540,31760,0.45177809388335705,1
3039,3040,CV Raman Nagar,348450,87970,260480,0.7475391017362606,0
3040,3041,Krishnarajapuram,258450,58050,200400,0.77539175856065,0
3041,3042,HBR Layout,245900,89790,156110,0.6348515656771045,0
3042,3043,Jalahalli,126900,60530,66370,0.5230102442868401,0
3043,3044,Rajajinagar,127750,70420,57330,0.4487671232876712,1
3044,3045,Hoodi,229350,79430,149920,0.6536734248964465,0
3045,3046,Banaswadi,173900,62380,111520,0.6412880966072455,0
3046,3047,Kammanahalli,330700,19380,311320,0.9413970365890535,-1
3047,3048,Vasanth Nagar,129150,29700,99450,0.7700348432055749,0
3048,3049,Varthur,319450,126570,192880,0.6037877602128658,0
3049,3050,Kalyan Nagar,266550,41450,225100,0.8444944663290189,-1
3050,3051,Krishnarajapuram,343150,23440,319710,0.9316916800233134,-1
3051,3052,Hebbal,83550,78280,5270,0.06307600239377618,1
3052,3053,HBR Layout,138100,18250,119850,0.8678493845039826,-1
3053,3054,CV Raman Nagar,86400,106210,-19810,-0.2292824074074074,1
3054,3055,Kammanahalli,80850,109980,-29130,-0.3602968460111317,1
3055,3056,Jalahalli,243400,54660,188740,0.7754313886606409,0
3056,3057,Jalahalli,334600,25290,309310,0.9244172145845786,-1
3057,3058,Shivajinagar,368000,31720,336280,0.913804347826087,-1
3058,3059,Indiranagar,165100,68770,96330,0.5834645669291338,0
3059,3060,Horamavu,103950,29330,74620,0.7178451178451178,0
3060,3061,Rajajinagar,38350,87700,-49350,-1.286831812255541,1
3061,3062,Marathahalli,135400,94740,40660,0.3002954209748892,1
3062,3063,Malleswaram,241600,112200,129400,0.5355960264900662,0
3063,3064,Whitefield,389800,77660,312140,0.8007696254489481,-1
3064,3065,HBR Layout,279100,0,279100,1.0,-1
3065,3066,Shivajinagar,139250,49250,90000,0.6463195691202872,0
3066,3067,Marathahalli,155750,39190,116560,0.7483788121990369,0
3067,3068,HBR Layout,443200,107690,335510,0.7570171480144404,0
3068,3069,Whitefield,278250,50450,227800,0.8186882300089847,-1
3069,3070,Malleswaram,100100,14520,85580,0.8549450549450549,-1
3070,3071,Banaswadi,407500,61170,346330,0.8498895705521472,-1
3071,3072,Mahadevapura,410500,106360,304140,0.7409013398294763,0
3072,3073,Shivajinagar,123650,39080,84570,0.683946623534169,0
3073,3074,Malleswaram,267400,78470,188930,0.706544502617801,0
3074,3075,Marathahalli,389100,41890,347210,0.8923413004369056,-1
3075,3076,Whitefield,406950,55480,351470,0.8636687553753533,-1
3076,3077,Marathahalli,338350,52960,285390,0.8434756908526674,-1
3077,3078,Jalahalli,106400,93240,13160,0.12368421052631579,1
3078,3079,Kalyan Nagar,276600,125730,150870,0.5454446854663775,0
3079,3080,HBR Layout,76000,70370,5630,0.07407894736842105,1
3080,3081,CV Raman Nagar,322750,58410,264340,0.8190240123934934,-1
3081,3082,Kammanahalli,185800,35860,149940,0.8069967707212056,-1
3082,3083,Krishnarajapuram,112000,130460,-18460,-0.16482142857142856,1
3083,3084,Marathahalli,131850,18150,113700,0.8623435722411832,-1
3084,3085,Krishnarajapuram,31500,17900,13600,0.43174603174603177,1
3085,3086,Hoodi,294300,80880,213420,0.7251783893985729,0
3086,3087,Vasanth Nagar,115450,74490,40960,0.35478562148116066,1
3087,3088,HBR Layout,277450,43400,234050,0.8435754189944135,-1
3088,3089,Marathahalli,437900,99110,338790,0.773669787622745,0
3089,3090,Marathahalli,31700,70910,-39210,-1.2369085173501577,1
3090,3091,Shivajinagar,28750,68930,-40180,-1.3975652173913042,1
3091,3092,Rajajinagar,441750,36100,405650,0.9182795698924732,-1
3092,3093,Jalahalli,322550,49510,273040,0.8465044179197023,-1
3093,3094,Whitefield,428150,31090,397060,0.9273852621744716,-1
3094,3095,Malleswaram,53100,47350,5750,0.10828625235404897,1
3095,3096,Kalyan Nagar,102150,63820,38330,0.3752325012236907,1
3096,3097,HBR Layout,259600,32090,227510,0.876386748844376,-1
3097,3098,Indiranagar,108500,68180,40320,0.3716129032258065,1
3098,3099,Rajajinagar,440200,55170,385030,0.874670604270786,-1
3099,3100,Vasanth Nagar,78600,59150,19450,0.2474554707379135,1
3100,3101,Marathahalli,158700,51700,107000,0.6742281033396346,0
3101,3102,Kammanahalli,118400,66890,51510,0.4350506756756757,1
3102,3103,Vasanth Nagar,270250,63560,206690,0.7648103607770583,0
3103,3104,HBR Layout,174050,60850,113200,0.6503878195920713,0
3104,3105,Jalahalli,122800,28540,94260,0.7675895765472313,0
3105,3106,Marathahalli,203900,59600,144300,0.7076998528690535,0
3106,3107,Banaswadi,86150,78730,7420,0.0861288450377249,1
3107,3108,Shivajinagar,114350,50140,64210,0.5615216440752077,0
3108,3109,Banaswadi,168400,21990,146410,0.869418052256532,-1
3109,3110,Varthur,84050,60850,23200,0.2760261748958953,1
3110,3111,Jalahalli,114900,32140,82760,0.7202785030461271,0
3111,3112,Kalyan Nagar,170800,66780,104020,0.6090163934426229,0
3112,3113,Banaswadi,174800,14770,160030,0.9155034324942791,-1
3113,3114,Rajajinagar,105700,84430,21270,0.20122989593188267,1
3114,3115,Rajajinagar,76350,28610,47740,0.6252783235101507,0
3115,3116,Varthur,246450,92320,154130,0.6254006897950903,0
3116,3117,Vasanth Nagar,386600,108720,277880,0.7187790998448008,0
3117,3118,Kammanahalli,231250,38350,192900,0.8341621621621622,-1
3118,3119,Malleswaram,136100,61860,74240,0.5454812637766349,0
3119,3120,Hoodi,42700,73210,-30510,-0.714519906323185,1
3120,3121,Shivajinagar,303700,50000,253700,0.8353638459005598,-1
3121,3122,Krishnarajapuram,293250,67780,225470,0.7688661551577153,0
3122,3123,Krishnarajapuram,321000,60060,260940,0.8128971962616822,-1
3123,3124,Shivajinagar,408750,82320,326430,0.798605504587156,0
3124,3125,Krishnarajapuram,231250,62500,168750,0.7297297297297297,0
3125,3126,Banaswadi,152150,29470,122680,0.8063095629313177,-1
3126,3127,Mahadevapura,414800,57480,357320,0.861427193828351,-1
3127,3128,Jalahalli,85350,26880,58470,0.6850615114235501,0
3128,3129,HBR Layout,241800,27090,214710,0.8879652605459057,-1
3129,3130,Malleswaram,425950,144050,281900,0.6618147669914309,0
3130,3131,Rajajinagar,153300,108890,44410,0.2896934116112198,1
3131,3132,Hebbal,322000,118570,203430,0.6317701863354037,0
3132,3133,Malleswaram,85150,17630,67520,0.7929536112742219,0
3133,3134,Kalyan Nagar,176500,0,176500,1.0,-1
3134,3135,Jalahalli,366300,93130,273170,0.7457548457548457,0
3135,3136,Shivajinagar,347550,63610,283940,0.8169759746799021,-1
3136,3137,Horamavu,53300,49310,3990,0.074859287054409,1
3137,3138,Kammanahalli,139200,53540,85660,0.6153735632183908,0
3138,3139,Hebbal,312450,68720,243730,0.7800608097295567,0
3139,3140,Vasanth Nagar,26100,29670,-3570,-0.1367816091954023,1
3140,3141,Varthur,413600,28780,384820,0.9304158607350097,-1
3141,3142,Kalyan Nagar,176100,49560,126540,0.7185689948892675,0
3142,3143,HBR Layout,392900,28320,364580,0.9279205904810385,-1
3143,3144,Varthur,348500,79000,269500,0.7733142037302726,0
3144,3145,Kammanahalli,323300,15950,307350,0.9506650170120631,-1
3145,3146,Whitefield,83050,54680,28370,0.34160144491270317,1
3146,3147,Horamavu,162050,74630,87420,0.5394631286639926,0
3147,3148,Varthur,225200,95870,129330,0.5742895204262878,0
3148,3149,HBR Layout,234500,39760,194740,0.8304477611940299,-1
3149,3150,CV Raman Nagar,304250,13260,290990,0.956417419884963,-1
3150,3151,HBR Layout,102450,92240,10210,0.09965836993655441,1
3151,3152,Varthur,250150,23080,227070,0.9077353587847291,-1
3152,3153,Whitefield,347150,49770,297380,0.8566325795765519,-1
3153,3154,Hebbal,376250,68430,307820,0.8181262458471761,-1
3154,3155,Mahadevapura,366500,55330,311170,0.849031377899045,-1
3155,3156,Hoodi,398450,132840,265610,0.6666081064123478,0
3156,3157,Rajajinagar,396800,62390,334410,0.8427671370967742,-1
3157,3158,Hoodi,368800,75270,293530,0.7959056399132322,0
3158,3159,Jalahalli,439200,58480,380720,0.8668488160291439,-1
3159,3160,CV Raman Nagar,197050,96040,101010,0.5126110124333926,0
3160,3161,Hoodi,317550,63150,254400,0.8011336797354748,-1
3161,3162,Mahadevapura,27850,21950,5900,0.2118491921005386,1
3162,3163,Rajajinagar,395300,55770,339530,0.8589172780166962,-1
3163,3164,CV Raman Nagar,84450,56410,28040,0.3320307874481942,1
3164,3165,Indiranagar,401750,71490,330260,0.8220535158680772,-1
3165,3166,Horamavu,335450,36010,299440,0.8926516619466388,-1
3166,3167,CV Raman Nagar,180350,0,180350,1.0,-1
3167,3168,Krishnarajapuram,430000,41890,388110,0.9025813953488372,-1
3168,3169,Kalyan Nagar,113700,74440,39260,0.34529463500439755,1
3169,3170,Malleswaram,259400,71320,188080,0.7250578257517347,0
3170,3171,Hebbal,372550,127130,245420,0.6587572137968059,0
3171,3172,Jalahalli,135200,52220,82980,0.6137573964497042,0
3172,3173,Hebbal,187150,3460,183690,0.9815121560245792,-1
3173,3174,Hoodi,85350,68680,16670,0.19531341534856472,1
3174,3175,CV Raman Nagar,83900,134400,-50500,-0.601907032181168,1
3175,3176,Hoodi,53950,45840,8110,0.15032437442075997,1
3176,3177,Hebbal,254550,106270,148280,0.582518169318405,0
3177,3178,Hebbal,136850,28120,108730,0.7945195469492145,0
3178,3179,Hebbal,90750,74420,16330,0.17994490358126722,1
3179,3180,Krishnarajapuram,372750,15970,356780,0.9571562709590878,-1
3180,3181,Rajajinagar,383600,620,382980,0.998383733055266,-1
3181,3182,Kalyan Nagar,174550,16230,158320,0.9070180464050416,-1
3182,3183,Kalyan Nagar,348550,59100,289450,0.8304403959259791,-1
3183,3184,Hoodi,140000,90800,49200,0.3514285714285714,1
3184,3185,Krishnarajapuram,360700,32600,328100,0.9096201829775437,-1
3185,3186,HBR Layout,165750,41700,124050,0.7484162895927602,0
3186,3187,Malleswaram,404750,71770,332980,0.8226806670784435,-1
3187,3188,HBR Layout,397600,29060,368540,0.9269114688128772,-1
3188,3189,Kalyan Nagar,154700,51110,103590,0.6696186166774402,0
3189,3190,Malleswaram,365350,54400,310950,0.8511016833173669,-1
3190,3191,HBR Layout,204950,65740,139210,0.6792388387411564,0
3191,3192,Malleswaram,237100,12620,224480,0.9467735132855335,-1
3192,3193,Varthur,39750,3230,36520,0.9187421383647799,-1
3193,3194,Kammanahalli,398800,104680,294120,0.7375125376128385,0
3194,3195,Kalyan Nagar,133800,127080,6720,0.05022421524663677,1
3195,3196,Banaswadi,171900,110300,61600,0.358347876672484,1
3196,3197,Hebbal,261100,43020,218080,0.8352355419379548,-1
3197,3198,Kalyan Nagar,185400,61460,123940,0.6685005393743257,0
3198,3199,Banaswadi,90500,34570,55930,0.6180110497237569,0
3199,3200,Hoodi,323600,49930,273670,0.8457045735475897,-1
3200,3201,Banaswadi,346800,59710,287090,0.8278258362168397,-1
3201,3202,Banaswadi,331250,102620,228630,0.6902037735849057,0
3202,3203,Vasanth Nagar,372550,57570,314980,0.8454704066568246,-1
3203,3204,Hoodi,303000,52950,250050,0.8252475247524752,-1
3204,3205,Vasanth Nagar,248200,86190,162010,0.6527397260273973,0
3205,3206,Mahadevapura,176400,35880,140520,0.7965986394557824,0
3206,3207,Hebbal,344800,25580,319220,0.9258120649651972,-1
3207,3208,Hoodi,152350,55300,97050,0.6370200196914998,0
3208,3209,Mahadevapura,102850,96640,6210,0.06037919299951385,1
3209,3210,Mahadevapura,415500,41160,374340,0.9009386281588447,-1
3210,3211,Mahadevapura,28000,55140,-27140,-0.9692857142857143,1
3211,3212,Kammanahalli,350100,24310,325790,0.930562696372465,-1
3212,3213,Malleswaram,69450,66810,2640,0.03801295896328294,1
3213,3214,Malleswaram,58850,84950,-26100,-0.443500424808836,1
3214,3215,Rajajinagar,158600,81280,77320,0.487515762925599,1
3215,3216,Shivajinagar,156900,56630,100270,0.6390694710006374,0
3216,3217,Jalahalli,298450,83500,214950,0.7202211425699447,0
3217,3218,Krishnarajapuram,192250,37810,154440,0.8033289986996098,-1
3218,3219,Krishnarajapuram,117850,93770,24080,0.20432753500212134,1
3219,3220,Hoodi,357550,33360,324190,0.9066983638651936,-1
3220,3221,Malleswaram,411200,30500,380700,0.9258268482490273,-1
3221,3222,CV Raman Nagar,201700,59250,142450,0.7062469013386217,0
3222,3223,Malleswaram,201700,15590,186110,0.9227069905800694,-1
3223,3224,Malleswaram,35900,49610,-13710,-0.3818941504178273,1
3224,3225,CV Raman Nagar,290950,10010,280940,0.9655954631379963,-1
3225,3226,Vasanth Nagar,63500,25260,38240,0.6022047244094488,0
3226,3227,Hebbal,322150,67420,254730,0.7907186093434735,0
3227,3228,Malleswaram,51250,45330,5920,0.11551219512195122,1
3228,3229,Rajajinagar,383250,72120,311130,0.8118199608610568,-1
3229,3230,Hebbal,239550,25970,213580,0.8915883949071175,-1
3230,3231,Whitefield,425550,92680,332870,0.7822112560216191,0
3231,3232,Jalahalli,250650,78460,172190,0.6869738679433472,0
3232,3233,Banaswadi,385050,106610,278440,0.723126866640696,0
3233,3234,Krishnarajapuram,80250,141950,-61700,-0.7688473520249222,1
3234,3235,Kalyan Nagar,314500,71280,243220,0.7733545310015898,0
3235,3236,CV Raman Nagar,395100,64140,330960,0.837661351556568,-1
3236,3237,Banaswadi,179950,22760,157190,0.8735204223395387,-1
3237,3238,Shivajinagar,254500,90900,163600,0.6428290766208251,0
3238,3239,CV Raman Nagar,171600,53180,118420,0.6900932400932401,0
3239,3240,Whitefield,126750,38890,87860,0.6931755424063116,0
3240,3241,Indiranagar,310900,54830,256070,0.823641042135735,-1
3241,3242,Banaswadi,361000,77850,283150,0.7843490304709141,0
3242,3243,Hebbal,107050,11170,95880,0.8956562354040168,-1
3243,3244,Varthur,289300,43240,246060,0.8505357760110612,-1
3244,3245,CV Raman Nagar,393850,52020,341830,0.8679192586009902,-1
3245,3246,Indiranagar,192000,92470,99530,0.5183854166666667,0
3246,3247,Kammanahalli,96900,53870,43030,0.4440660474716202,1
3247,3248,Krishnarajapuram,237800,52730,185070,0.7782590412111018,0
3248,3249,Shivajinagar,129450,72840,56610,0.4373117033603708,1
3249,3250,Marathahalli,70400,83560,-13160,-0.18693181818181817,1
3250,3251,Marathahalli,192500,129090,63410,0.3294025974025974,1
3251,3252,Malleswaram,226600,98710,127890,0.564386584289497,0
3252,3253,Varthur,150950,70400,80550,0.5336204041073203,0
3253,3254,Rajajinagar,101600,97160,4440,0.043700787401574806,1
3254,3255,Krishnarajapuram,155150,57870,97280,0.6270061231066709,0
3255,3256,Varthur,391150,59650,331500,0.8475009587114918,-1
3256,3257,Whitefield,248350,106430,141920,0.5714515804308435,0
3257,3258,CV Raman Nagar,208200,43840,164360,0.789433237271854,0
3258,3259,HBR Layout,73950,11680,62270,0.8420554428668019,-1
3259,3260,Rajajinagar,281800,38040,243760,0.8650106458481193,-1
3260,3261,Krishnarajapuram,341800,41760,300040,0.8778232884727911,-1
3261,3262,Hebbal,68650,29150,39500,0.5753823743627094,0
3262,3263,Whitefield,335500,13870,321630,0.9586587183308495,-1
3263,3264,Hebbal,28600,40070,-11470,-0.40104895104895105,1
3264,3265,Mahadevapura,263900,47890,216010,0.818529746115953,-1
3265,3266,Horamavu,127550,19660,107890,0.8458643669149353,-1
3266,3267,Hebbal,101900,58250,43650,0.4283611383709519,1
3267,3268,Hoodi,101850,77020,24830,0.24378988708885616,1
3268,3269,Whitefield,336250,74510,261740,0.7784089219330855,0
3269,3270,Shivajinagar,152200,90010,62190,0.4086070959264126,1
3270,3271,Malleswaram,427600,53350,374250,0.8752338634237605,-1
3271,3272,Indiranagar,408550,84830,323720,0.7923632358340472,0
3272,3273,Rajajinagar,426600,121170,305430,0.7159634317862166,0
3273,3274,Vasanth Nagar,279150,30780,248370,0.8897367006985492,-1
3274,3275,Vasanth Nagar,37300,52590,-15290,-0.4099195710455764,1
3275,3276,Shivajinagar,54300,60020,-5720,-0.10534069981583793,1
3276,3277,Horamavu,171050,87010,84040,0.49131832797427655,1
3277,3278,Rajajinagar,69000,55030,13970,0.20246376811594202,1
3278,3279,Varthur,336100,143080,193020,0.5742933650699197,0
3279,3280,Indiranagar,247200,75030,172170,0.6964805825242718,0
3280,3281,HBR Layout,133750,39470,94280,0.7048971962616822,0
3281,3282,Horamavu,112400,43620,68780,0.6119217081850534,0
3282,3283,Vasanth Nagar,147150,106730,40420,0.2746856948691811,1
3283,3284,Kammanahalli,190750,55110,135640,0.7110878112712975,0
3284,3285,Hebbal,157750,65520,92230,0.5846592709984152,0
3285,3286,Krishnarajapuram,135250,8010,127240,0.9407763401109057,-1
3286,3287,Indiranagar,366650,61510,305140,0.8322378289922269,-1
3287,3288,Whitefield,286250,57500,228750,0.7991266375545851,0
3288,3289,Krishnarajapuram,351850,42800,309050,0.8783572545118659,-1
3289,3290,Marathahalli,325500,47850,277650,0.8529953917050691,-1
3290,3291,Rajajinagar,131450,89760,41690,0.31715481171548116,1
3291,3292,Hebbal,62150,53750,8400,0.13515687851971037,1
3292,3293,Horamavu,179350,122980,56370,0.31430164482854756,1
3293,3294,CV Raman Nagar,232150,41870,190280,0.8196424725393064,-1
3294,3295,Hebbal,345400,90870,254530,0.7369137232194557,0
3295,3296,Jalahalli,334200,32000,302200,0.9042489527229204,-1
3296,3297,HBR Layout,164300,70940,93360,0.5682288496652464,0
3297,3298,Varthur,167900,18810,149090,0.8879690291840381,-1
3298,3299,Malleswaram,59500,63840,-4340,-0.07294117647058823,1
3299,3300,Vasanth Nagar,155300,60000,95300,0.613650998068255,0
3300,3301,Banaswadi,357300,22050,335250,0.9382871536523929,-1
3301,3302,Vasanth Nagar,254400,43680,210720,0.8283018867924529,-1
3302,3303,Shivajinagar,300350,39610,260740,0.8681205260529382,-1
3303,3304,Horamavu,345300,107090,238210,0.6898638864755285,0
3304,3305,Varthur,144750,111680,33070,0.22846286701208982,1
3305,3306,HBR Layout,123200,39700,83500,0.6777597402597403,0
3306,3307,Hebbal,337350,36220,301130,0.8926337631539943,-1
3307,3308,Varthur,417300,82170,335130,0.8030913012221423,-1
3308,3309,Shivajinagar,226300,150800,75500,0.3336279275298277,1
3309,3310,Hebbal,372350,46750,325600,0.8744460856720827,-1
3310,3311,Mahadevapura,402450,24620,377830,0.9388246987203379,-1
3311,3312,Malleswaram,426550,86410,340140,0.7974211698511312,0
3312,3313,Varthur,200200,59660,140540,0.701998001998002,0
3313,3314,Whitefield,94500,22750,71750,0.7592592592592593,0
3314,3315,Varthur,121900,10100,111800,0.9171452009844134,-1
3315,3316,Kammanahalli,421550,27610,393940,0.934503617601708,-1
3316,3317,Krishnarajapuram,359050,136120,222930,0.6208884556468458,0
3317,3318,Krishnarajapuram,323200,25550,297650,0.9209467821782178,-1
3318,3319,Banaswadi,41850,71520,-29670,-0.7089605734767025,1
3319,3320,Whitefield,337400,23340,314060,0.930823947836396,-1
3320,3321,Kammanahalli,28550,48410,-19860,-0.6956217162872154,1
3321,3322,Rajajinagar,31650,94980,-63330,-2.0009478672985783,1
3322,3323,Horamavu,128350,67570,60780,0.4735488897545773,1
3323,3324,Banaswadi,347250,145550,201700,0.580849532037437,0
3324,3325,Kammanahalli,413300,48740,364560,0.882071134768933,-1
3325,3326,CV Raman Nagar,365100,50580,314520,0.8614626129827444,-1
3326,3327,Shivajinagar,440150,12310,427840,0.9720322617289561,-1
3327,3328,Varthur,297300,106650,190650,0.641271442986882,0
3328,3329,Rajajinagar,394800,103360,291440,0.7381965552178318,0
3329,3330,Kalyan Nagar,159700,20390,139310,0.8723231058234189,-1
3330,3331,Whitefield,150200,103290,46910,0.3123169107856192,1
3331,3332,Kammanahalli,338550,51780,286770,0.8470536109880372,-1
3332,3333,Banaswadi,425750,126570,299180,0.7027128596594245,0
3333,3334,HBR Layout,32700,31230,1470,0.044954128440366975,1
3334,3335,CV Raman Nagar,271400,94520,176880,0.651731761238025,0
3335,3336,Shivajinagar,387450,20670,366780,0.9466511807975223,-1
3336,3337,Indiranagar,68850,148290,-79440,-1.1538126361655774,1
3337,3338,Mahadevapura,28450,47520,-19070,-0.670298769771529,1
3338,3339,Hoodi,151800,90720,61080,0.4023715415019763,1
3339,3340,Marathahalli,239700,33540,206160,0.8600750938673342,-1
3340,3341,Krishnarajapuram,107650,71360,36290,0.3371110078959591,1
3341,3342,HBR Layout,94100,0,94100,1.0,-1
3342,3343,Horamavu,371500,93990,277510,0.7469986541049798,0
3343,3344,Banaswadi,394900,24480,370420,0.9380096226892884,-1
3344,3345,Horamavu,401200,43510,357690,0.8915503489531406,-1
3345,3346,Marathahalli,248500,77930,170570,0.6863983903420523,0
3346,3347,Hebbal,275100,100360,174740,0.6351872046528535,0
3347,3348,HBR Layout,293550,46320,247230,0.8422074603985692,-1
3348,3349,HBR Layout,286700,107560,179140,0.6248343215905128,0
3349,3350,Banaswadi,311100,14820,296280,0.9523625843780135,-1
3350,3351,Shivajinagar,420200,75270,344930,0.820871013802951,-1
3351,3352,Whitefield,71550,14840,56710,0.7925925925925926,0
3352,3353,Shivajinagar,163600,56060,107540,0.6573349633251834,0
3353,3354,Rajajinagar,207000,48550,158450,0.7654589371980677,0
3354,3355,Kammanahalli,232750,119530,113220,0.4864446831364125,1
3355,3356,Banaswadi,210750,175120,35630,0.16906287069988138,1
3356,3357,Indiranagar,395500,44470,351030,0.8875600505689001,-1
3357,3358,Whitefield,256500,72210,184290,0.7184795321637427,0
3358,3359,Shivajinagar,433700,70200,363500,0.8381369610329721,-1
3359,3360,CV Raman Nagar,55900,40120,15780,0.2822898032200358,1
3360,3361,Hebbal,65850,48910,16940,0.25725132877752466,1
3361,3362,Jalahalli,220050,92120,127930,0.5813678709384231,0
3362,3363,CV Raman Nagar,240850,40440,200410,0.8320946647290844,-1
3363,3364,Hebbal,377150,76850,300300,0.7962349197931857,0
3364,3365,Malleswaram,53450,20700,32750,0.6127221702525725,0
3365,3366,Shivajinagar,248200,53490,194710,0.7844883158742949,0
3366,3367,HBR Layout,227400,31480,195920,0.8615655233069481,-1
3367,3368,Vasanth Nagar,275800,76590,199210,0.7222987672226251,0
3368,3369,Mahadevapura,43600,57820,-14220,-0.32614678899082566,1
3369,3370,Hebbal,183200,79270,103930,0.5673034934497817,0
3370,3371,Shivajinagar,391150,48170,342980,0.8768503131790873,-1
3371,3372,Indiranagar,293700,19950,273750,0.932073544433095,-1
3372,3373,Whitefield,419050,23700,395350,0.9434435031619138,-1
3373,3374,Jalahalli,363600,59690,303910,0.8358360836083608,-1
3374,3375,Malleswaram,47050,29610,17440,0.3706695005313496,1
3375,3376,Jalahalli,449150,36930,412220,0.9177780251586329,-1
3376,3377,Krishnarajapuram,446750,94770,351980,0.7878679350867376,0
3377,3378,CV Raman Nagar,26850,73390,-46540,-1.7333333333333334,1
3378,3379,Hoodi,298150,83400,214750,0.7202750293476438,0
3379,3380,Indiranagar,75100,23310,51790,0.6896138482023968,0
3380,3381,Vasanth Nagar,64950,36250,28700,0.44187836797536567,1
3381,3382,Banaswadi,227650,29070,198580,0.8723039754008346,-1
3382,3383,Vasanth Nagar,213500,33440,180060,0.8433723653395785,-1
3383,3384,Vasanth Nagar,389150,101650,287500,0.7387896697931389,0
3384,3385,Banaswadi,183950,76770,107180,0.5826583310682251,0
3385,3386,Krishnarajapuram,401450,51110,350340,0.8726865113961888,-1
3386,3387,Hoodi,173350,79580,93770,0.5409287568503028,0
3387,3388,Hebbal,228600,59690,168910,0.7388888888888889,0
3388,3389,Whitefield,444400,79100,365300,0.822007200720072,-1
3389,3390,Malleswaram,131500,91770,39730,0.3021292775665399,1
3390,3391,CV Raman Nagar,229800,79750,150050,0.6529590948651001,0
3391,3392,Vasanth Nagar,153950,63880,90070,0.585060084443001,0
3392,3393,Banaswadi,226250,80710,145540,0.6432707182320442,0
3393,3394,Whitefield,224500,19930,204570,0.9112249443207127,-1
3394,3395,Banaswadi,58350,116250,-57900,-0.9922879177377892,1
3395,3396,Mahadevapura,89100,53460,35640,0.4,1
3396,3397,Horamavu,218500,111050,107450,0.49176201372997713,1
3397,3398,CV Raman Nagar,161100,48330,112770,0.7,0
3398,3399,Shivajinagar,391450,66490,324960,0.8301443351641333,-1
3399,3400,Jalahalli,139600,79080,60520,0.4335243553008596,1
3400,3401,Hoodi,225900,15120,210780,0.9330677290836653,-1
3401,3402,Vasanth Nagar,347500,74880,272620,0.7845179856115108,0
3402,3403,Shivajinagar,73350,78480,-5130,-0.06993865030674846,1
3403,3404,Vasanth Nagar,121250,66240,55010,0.45369072164948454,1
3404,3405,Shivajinagar,111700,63480,48220,0.43169203222918534,1
3405,3406,Shivajinagar,97350,53060,44290,0.45495634309193633,1
3406,3407,Hoodi,150350,85880,64470,0.42879946790821416,1
3407,3408,Vasanth Nagar,175600,17930,157670,0.8978929384965831,-1
3408,3409,Hebbal,356600,35090,321510,0.9015984296130117,-1
3409,3410,Krishnarajapuram,341900,112890,229010,0.6698157355952032,0
3410,3411,Krishnarajapuram,373950,100060,273890,0.7324241208717743,0
3411,3412,Malleswaram,419800,56750,363050,0.8648165793234873,-1
3412,3413,Kammanahalli,274850,54170,220680,0.8029106785519374,-1
3413,3414,Horamavu,385950,34930,351020,0.9094960487109729,-1
3414,3415,Marathahalli,93450,58040,35410,0.37891920813269125,1
3415,3416,Horamavu,29350,44500,-15150,-0.5161839863713799,1
3416,3417,Whitefield,318600,1650,316950,0.9948210922787194,-1
3417,3418,Malleswaram,288500,66630,221870,0.7690467937608318,0
3418,3419,HBR Layout,118800,66360,52440,0.4414141414141414,1
3419,3420,Krishnarajapuram,417000,86000,331000,0.7937649880095923,0
3420,3421,Kammanahalli,87300,16780,70520,0.8077892325315006,-1
3421,3422,Varthur,263000,47500,215500,0.8193916349809885,-1
3422,3423,CV Raman Nagar,138250,26200,112050,0.8104882459312839,-1
3423,3424,Jalahalli,26350,47580,-21230,-0.8056925996204933,1
3424,3425,CV Raman Nagar,421950,95600,326350,0.7734328711932693,0
3425,3426,Banaswadi,358250,45120,313130,0.8740544312630845,-1
3426,3427,Malleswaram,69150,18940,50210,0.7261026753434563,0
3427,3428,Hoodi,380750,57060,323690,0.8501378857518056,-1
3428,3429,Hebbal,200450,85950,114500,0.5712147667747568,0
3429,3430,Indiranagar,403450,61450,342000,0.8476886850910893,-1
3430,3431,Malleswaram,239650,32850,206800,0.8629250991028583,-1
3431,3432,Indiranagar,337300,85130,252170,0.7476134005336496,0
3432,3433,Whitefield,402350,70380,331970,0.8250776686964086,-1
3433,3434,Marathahalli,125950,39770,86180,0.6842397776895593,0
3434,3435,Rajajinagar,49700,37890,11810,0.23762575452716297,1
3435,3436,Indiranagar,307800,66970,240830,0.7824236517218973,0
3436,3437,Jalahalli,262950,57790,205160,0.7802243772580338,0
3437,3438,Varthur,48600,60540,-11940,-0.24567901234567902,1
3438,3439,Hebbal,334900,75780,259120,0.7737234995521051,0
3439,3440,Hoodi,222650,85660,136990,0.6152706040871323,0
3440,3441,Varthur,440600,89610,350990,0.7966182478438493,0
3441,3442,HBR Layout,393650,59160,334490,0.8497142131334943,-1
3442,3443,Horamavu,437100,37220,399880,0.9148478609013956,-1
3443,3444,Malleswaram,182800,63070,119730,0.6549781181619256,0
3444,3445,Hoodi,91850,81290,10560,0.11497005988023952,1
3445,3446,Indiranagar,76250,12950,63300,0.8301639344262295,-1
3446,3447,Vasanth Nagar,372450,75830,296620,0.7964022016378037,0
3447,3448,Hoodi,357700,71410,286290,0.8003634330444507,-1
3448,3449,Mahadevapura,418200,59760,358440,0.8571018651362984,-1
3449,3450,Mahadevapura,421950,0,421950,1.0,-1
3450,3451,Vasanth Nagar,386600,20970,365630,0.9457578892912571,-1
3451,3452,Marathahalli,416800,44950,371850,0.8921545105566219,-1
3452,3453,Varthur,80850,91180,-10330,-0.1277674706246135,1
3453,3454,Shivajinagar,365400,78340,287060,0.7856048166392994,0
3454,3455,Rajajinagar,260500,97280,163220,0.6265642994241842,0
3455,3456,Kammanahalli,27600,106300,-78700,-2.851449275362319,1
3456,3457,Whitefield,159300,18700,140600,0.8826114249843063,-1
3457,3458,Hebbal,273300,91580,181720,0.6649103549213319,0
3458,3459,Horamavu,437300,51210,386090,0.8828950377315344,-1
3459,3460,Krishnarajapuram,430200,49590,380610,0.8847280334728034,-1
3460,3461,Hebbal,82000,38790,43210,0.5269512195121951,0
3461,3462,Kalyan Nagar,102100,28550,73550,0.7203721841332027,0
3462,3463,Mahadevapura,358400,22990,335410,0.9358537946428571,-1
3463,3464,Kalyan Nagar,212450,35830,176620,0.8313485526006119,-1
3464,3465,Mahadevapura,291500,41250,250250,0.8584905660377359,-1
3465,3466,HBR Layout,391500,10750,380750,0.9725415070242657,-1
3466,3467,Krishnarajapuram,416600,70460,346140,0.8308689390302448,-1
3467,3468,HBR Layout,173350,124050,49300,0.28439573117969424,1
3468,3469,Banaswadi,326250,78090,248160,0.7606436781609195,0
3469,3470,Hoodi,52750,60510,-7760,-0.1471090047393365,1
3470,3471,Malleswaram,427000,96410,330590,0.7742154566744731,0
3471,3472,Mahadevapura,27150,31510,-4360,-0.16058931860036832,1
3472,3473,Malleswaram,151050,26760,124290,0.8228401191658391,-1
3473,3474,Vasanth Nagar,376000,43110,332890,0.885345744680851,-1
3474,3475,Kammanahalli,425300,80510,344790,0.8106983305901716,-1
3475,3476,Rajajinagar,186000,50310,135690,0.729516129032258,0
3476,3477,Marathahalli,406250,59800,346450,0.8528,-1
3477,3478,CV Raman Nagar,411350,40260,371090,0.90212714233621,-1
3478,3479,Rajajinagar,161850,33220,128630,0.7947482236638863,0
3479,3480,Banaswadi,90200,79020,11180,0.12394678492239468,1
3480,3481,Kalyan Nagar,25650,50280,-24630,-0.960233918128655,1
3481,3482,Malleswaram,200450,80590,119860,0.5979546021451734,0
3482,3483,Kalyan Nagar,33650,61400,-27750,-0.8246656760772659,1
3483,3484,CV Raman Nagar,284400,41070,243330,0.855590717299578,-1
3484,3485,Kammanahalli,185750,122550,63200,0.3402422611036339,1
3485,3486,Malleswaram,42800,89890,-47090,-1.1002336448598131,1
3486,3487,Whitefield,349950,57090,292860,0.8368624089155594,-1
3487,3488,Banaswadi,388050,31770,356280,0.9181291070738307,-1
3488,3489,Rajajinagar,445900,122300,323600,0.7257232563355013,0
3489,3490,Kalyan Nagar,274500,67640,206860,0.7535883424408014,0
3490,3491,Hebbal,52500,17970,34530,0.6577142857142857,0
3491,3492,Shivajinagar,181700,194180,-12480,-0.06868464501926252,1
3492,3493,Shivajinagar,412550,70130,342420,0.830008483820143,-1
3493,3494,Kammanahalli,328150,51780,276370,0.8422063080908121,-1
3494,3495,Krishnarajapuram,48500,45950,2550,0.05257731958762887,1
3495,3496,Whitefield,421850,64150,357700,0.8479317292876615,-1
3496,3497,Banaswadi,260100,42220,217880,0.8376778162245291,-1
3497,3498,Jalahalli,62250,100310,-38060,-0.6114056224899599,1
3498,3499,Rajajinagar,103600,69730,33870,0.32693050193050194,1
3499,3500,Malleswaram,388100,47610,340490,0.8773254315897965,-1
3500,3501,Hebbal,71150,96710,-25560,-0.35924104005621926,1
3501,3502,Kalyan Nagar,274600,44270,230330,0.8387836853605244,-1
3502,3503,Malleswaram,193650,65740,127910,0.6605215595145881,0
3503,3504,Indiranagar,297700,26140,271560,0.9121934833725227,-1
3504,3505,Whitefield,251200,14660,236540,0.9416401273885351,-1
3505,3506,Kammanahalli,83600,60780,22820,0.27296650717703347,1
3506,3507,Horamavu,212500,22130,190370,0.8958588235294118,-1
3507,3508,Kammanahalli,101000,46940,54060,0.5352475247524753,0
3508,3509,Hebbal,72400,44200,28200,0.38950276243093923,1
3509,3510,Vasanth Nagar,402400,23160,379240,0.9424453280318091,-1
3510,3511,HBR Layout,432950,105770,327180,0.7556992724333064,0
3511,3512,Marathahalli,143750,66690,77060,0.5360695652173914,0
3512,3513,Indiranagar,186050,54460,131590,0.7072829884439666,0
3513,3514,Jalahalli,63100,18800,44300,0.7020602218700476,0
3514,3515,Krishnarajapuram,352650,26300,326350,0.9254218063235503,-1
3515,3516,Rajajinagar,108950,53270,55680,0.5110601193207893,0
3516,3517,Banaswadi,342550,127030,215520,0.629163625748066,0
3517,3518,Horamavu,330050,46060,283990,0.8604453870625662,-1
3518,3519,Varthur,71200,40210,30990,0.43525280898876406,1
3519,3520,Rajajinagar,201550,126700,74850,0.3713718680228231,1
3520,3521,CV Raman Nagar,222200,12410,209790,0.9441494149414942,-1
3521,3522,Indiranagar,122950,38560,84390,0.6863765758438389,0
3522,3523,Vasanth Nagar,231300,44390,186910,0.808084738434933,-1
3523,3524,Indiranagar,311200,60210,250990,0.8065231362467866,-1
3524,3525,Banaswadi,84500,56200,28300,0.3349112426035503,1
3525,3526,Hoodi,30300,143910,-113610,-3.7495049504950497,1
3526,3527,Jalahalli,370900,74990,295910,0.7978161229441898,0
3527,3528,Rajajinagar,131850,116070,15780,0.11968145620022753,1
3528,3529,Horamavu,182350,115330,67020,0.36753496024129423,1
3529,3530,Kammanahalli,312500,70300,242200,0.77504,0
3530,3531,Jalahalli,162600,44430,118170,0.7267527675276753,0
3531,3532,Hoodi,106350,43590,62760,0.5901269393511989,0
3532,3533,Krishnarajapuram,276850,27840,249010,0.8994401300343146,-1
3533,3534,Vasanth Nagar,413750,37770,375980,0.9087129909365559,-1
3534,3535,Marathahalli,173800,16120,157680,0.9072497123130034,-1
3535,3536,Jalahalli,285100,65890,219210,0.7688881094352858,0
3536,3537,Vasanth Nagar,146250,79490,66760,0.45647863247863246,1
3537,3538,HBR Layout,324100,78850,245250,0.7567108917000925,0
3538,3539,Indiranagar,265550,21890,243660,0.9175673131237055,-1
3539,3540,Jalahalli,230200,45280,184920,0.8033014769765421,-1
3540,3541,Indiranagar,115200,87960,27240,0.23645833333333333,1
3541,3542,Hoodi,323150,45760,277390,0.8583939347052453,-1
3542,3543,Mahadevapura,55500,101800,-46300,-0.8342342342342343,1
3543,3544,Rajajinagar,44600,28470,16130,0.3616591928251121,1
3544,3545,CV Raman Nagar,59200,96610,-37410,-0.6319256756756757,1
3545,3546,Kammanahalli,175700,38540,137160,0.7806488332384747,0
3546,3547,Malleswaram,400050,62910,337140,0.8427446569178852,-1
3547,3548,HBR Layout,417500,11570,405930,0.9722874251497006,-1
3548,3549,Kammanahalli,179050,21000,158050,0.8827143256073723,-1
3549,3550,HBR Layout,278000,55400,222600,0.8007194244604317,-1
3550,3551,Kammanahalli,214350,36170,178180,0.8312572894798227,-1
3551,3552,Marathahalli,394950,99390,295560,0.7483478921382454,0
3552,3553,Kammanahalli,204150,70070,134080,0.6567719813862356,0
3553,3554,Kalyan Nagar,106650,157720,-51070,-0.47885607126113455,1
3554,3555,Rajajinagar,237150,16380,220770,0.9309297912713472,-1
3555,3556,Krishnarajapuram,141400,28410,112990,0.7990806223479491,0
3556,3557,Marathahalli,256050,13790,242260,0.9461433313805897,-1
3557,3558,Kammanahalli,78000,5800,72200,0.9256410256410257,-1
3558,3559,Jalahalli,225950,47000,178950,0.7919893781810134,0
3559,3560,Shivajinagar,201500,34460,167040,0.8289826302729528,-1
3560,3561,Marathahalli,182150,30830,151320,0.8307438923963766,-1
3561,3562,Krishnarajapuram,75500,80970,-5470,-0.07245033112582781,1
3562,3563,Indiranagar,331750,80940,250810,0.7560211002260738,0
3563,3564,Jalahalli,209200,32160,177040,0.8462715105162524,-1
3564,3565,Indiranagar,362100,120060,242040,0.6684341342170671,0
3565,3566,Banaswadi,375350,45650,329700,0.8783801785000666,-1
3566,3567,Kammanahalli,95350,92580,2770,0.029050865233350813,1
3567,3568,CV Raman Nagar,42600,46590,-3990,-0.09366197183098592,1
3568,3569,Malleswaram,418900,56130,362770,0.866006206731917,-1
3569,3570,Banaswadi,312200,22940,289260,0.9265214606021781,-1
3570,3571,Marathahalli,51900,87760,-35860,-0.6909441233140655,1
3571,3572,Kammanahalli,263300,121440,141860,0.5387770603873908,0
3572,3573,Indiranagar,431250,70940,360310,0.8355014492753623,-1
3573,3574,Hoodi,416100,98690,317410,0.7628214371545302,0
3574,3575,Mahadevapura,310750,35400,275350,0.8860820595333869,-1
3575,3576,Shivajinagar,235500,53830,181670,0.7714225053078556,0
3576,3577,Hebbal,419050,50080,368970,0.8804915881159766,-1
3577,3578,Hoodi,165050,22480,142570,0.8637988488336867,-1
3578,3579,Mahadevapura,119800,38830,80970,0.6758764607679466,0
3579,3580,Malleswaram,248200,84580,163620,0.6592264302981466,0
3580,3581,Jalahalli,76500,79590,-3090,-0.040392156862745096,1
3581,3582,Kalyan Nagar,55800,40050,15750,0.28225806451612906,1
3582,3583,Hoodi,35900,59280,-23380,-0.6512534818941504,1
3583,3584,Horamavu,70650,78300,-7650,-0.10828025477707007,1
3584,3585,HBR Layout,179800,70880,108920,0.6057842046718577,0
3585,3586,Kalyan Nagar,277200,75560,201640,0.7274170274170274,0
3586,3587,Varthur,378950,61880,317070,0.8367066895368782,-1
3587,3588,HBR Layout,337550,95850,241700,0.7160420678418012,0
3588,3589,Vasanth Nagar,185700,75630,110070,0.5927302100161551,0
3589,3590,Horamavu,113250,112200,1050,0.009271523178807948,1
3590,3591,CV Raman Nagar,158950,116210,42740,0.2688895879207298,1
3591,3592,Kammanahalli,219550,30100,189450,0.8629013892051924,-1
3592,3593,Malleswaram,360650,53320,307330,0.852155829751837,-1
3593,3594,Malleswaram,321500,116720,204780,0.6369517884914463,0
3594,3595,Vasanth Nagar,35000,64770,-29770,-0.8505714285714285,1
3595,3596,Krishnarajapuram,75750,118260,-42510,-0.5611881188118812,1
3596,3597,Malleswaram,338350,95670,242680,0.7172454558888725,0
3597,3598,HBR Layout,325350,89200,236150,0.7258337175349624,0
3598,3599,Kalyan Nagar,279800,104550,175250,0.6263402430307362,0
3599,3600,Vasanth Nagar,80850,79680,1170,0.014471243042671614,1
3600,3601,Hoodi,190800,51760,139040,0.7287211740041929,0
3601,3602,Krishnarajapuram,68700,56510,12190,0.1774381368267831,1
3602,3603,Krishnarajapuram,440750,30160,410590,0.9315711854792966,-1
3603,3604,CV Raman Nagar,109850,5670,104180,0.9483841602184797,-1
3604,3605,Indiranagar,103750,66280,37470,0.3611566265060241,1
3605,3606,CV Raman Nagar,45550,99950,-54400,-1.1942919868276618,1
3606,3607,Kalyan Nagar,440200,125570,314630,0.7147432985006815,0
3607,3608,Horamavu,137500,30060,107440,0.7813818181818182,0
3608,3609,Rajajinagar,44350,32080,12270,0.276662908680947,1
3609,3610,Malleswaram,134100,18020,116080,0.8656226696495153,-1
3610,3611,Krishnarajapuram,132300,58250,74050,0.5597127739984883,0
3611,3612,Hoodi,256250,33380,222870,0.8697365853658536,-1
3612,3613,Banaswadi,392650,86580,306070,0.7794982809117534,0
3613,3614,Vasanth Nagar,441350,64210,377140,0.8545145576073411,-1
3614,3615,Kammanahalli,389950,90160,299790,0.7687908706244391,0
3615,3616,Malleswaram,122000,66660,55340,0.4536065573770492,1
3616,3617,Krishnarajapuram,259400,27310,232090,0.8947185813415575,-1
3617,3618,Jalahalli,222600,71180,151420,0.6802336028751124,0
3618,3619,HBR Layout,392350,16750,375600,0.9573085255511661,-1
3619,3620,HBR Layout,87900,33600,54300,0.6177474402730375,0
3620,3621,Vasanth Nagar,66300,107140,-40840,-0.6159879336349925,1
3621,3622,Banaswadi,248300,40120,208180,0.838421264599275,-1
3622,3623,Hoodi,161200,85210,75990,0.47140198511166254,1
3623,3624,Kalyan Nagar,183700,28940,154760,0.8424605334784976,-1
3624,3625,Whitefield,85050,51960,33090,0.3890652557319224,1
3625,3626,HBR Layout,266250,112310,153940,0.5781784037558686,0
3626,3627,Whitefield,159100,60360,98740,0.6206159648020113,0
3627,3628,HBR Layout,304450,25220,279230,0.9171620955821974,-1
3628,3629,Marathahalli,29950,40450,-10500,-0.35058430717863104,1
3629,3630,Horamavu,110950,85730,25220,0.22730959891843172,1
3630,3631,Krishnarajapuram,325200,115730,209470,0.6441266912669127,0
3631,3632,Whitefield,29900,41100,-11200,-0.3745819397993311,1
3632,3633,Jalahalli,149100,76280,72820,0.48839704896042924,1
3633,3634,Marathahalli,219800,35190,184610,0.8398999090081892,-1
3634,3635,Malleswaram,36050,125090,-89040,-2.469902912621359,1
3635,3636,Whitefield,42300,111250,-68950,-1.6300236406619386,1
3636,3637,Whitefield,223100,79500,143600,0.6436575526669654,0
3637,3638,HBR Layout,444800,49360,395440,0.8890287769784173,-1
3638,3639,Vasanth Nagar,109500,83170,26330,0.24045662100456622,1
3639,3640,Horamavu,53300,71560,-18260,-0.3425891181988743,1
3640,3641,Banaswadi,177700,76610,101090,0.5688801350590883,0
3641,3642,HBR Layout,36650,77360,-40710,-1.1107776261937243,1
3642,3643,HBR Layout,256300,47280,209020,0.8155286773312524,-1
3643,3644,Horamavu,98400,58200,40200,0.40853658536585363,1
3644,3645,Whitefield,418000,58180,359820,0.8608133971291866,-1
3645,3646,Krishnarajapuram,442650,74650,368000,0.8313566022817124,-1
3646,3647,Hoodi,73950,34480,39470,0.5337390128465179,0
3647,3648,HBR Layout,179200,182650,-3450,-0.019252232142857144,1
3648,3649,Banaswadi,132200,96780,35420,0.26792738275340394,1
3649,3650,Varthur,404900,39620,365280,0.9021486786860954,-1
3650,3651,Banaswadi,376750,47050,329700,0.8751161247511613,-1
3651,3652,Kalyan Nagar,121500,19580,101920,0.8388477366255144,-1
3652,3653,Hoodi,99250,52470,46780,0.4713350125944584,1
3653,3654,Vasanth Nagar,377000,72340,304660,0.8081167108753315,-1
3654,3655,Vasanth Nagar,435200,59040,376160,0.8643382352941177,-1
3655,3656,Rajajinagar,33800,40700,-6900,-0.20414201183431951,1
3656,3657,Whitefield,87650,52280,35370,0.4035367940673132,1
3657,3658,Kalyan Nagar,293850,49620,244230,0.831138335885656,-1
3658,3659,CV Raman Nagar,287400,58810,228590,0.7953723034098817,0
3659,3660,HBR Layout,288500,26190,262310,0.9092201039861352,-1
3660,3661,Kalyan Nagar,334950,44040,290910,0.8685176892073444,-1
3661,3662,Shivajinagar,444550,64780,379770,0.8542796085929591,-1
3662,3663,Whitefield,94300,82290,12010,0.1273594909862142,1
3663,3664,Shivajinagar,358700,78450,280250,0.7812935600780596,0
3664,3665,Jalahalli,302000,37330,264670,0.8763907284768212,-1
3665,3666,Krishnarajapuram,424950,41240,383710,0.9029532886221908,-1
3666,3667,Malleswaram,335500,27570,307930,0.9178241430700447,-1
3667,3668,Hebbal,258550,50330,208220,0.8053374589054342,-1
3668,3669,Krishnarajapuram,411600,58280,353320,0.8584062196307094,-1
3669,3670,Banaswadi,395850,102670,293180,0.7406340785651131,0
3670,3671,Malleswaram,404350,15940,388410,0.9605787065660937,-1
3671,3672,CV Raman Nagar,101700,151610,-49910,-0.49075712881022615,1
3672,3673,Marathahalli,334300,66270,268030,0.8017648818426563,-1
3673,3674,Indiranagar,146950,65890,81060,0.5516161959850289,0
3674,3675,Kammanahalli,216550,53900,162650,0.7510967444008312,0
3675,3676,Vasanth Nagar,100250,32170,68080,0.6791022443890274,0
3676,3677,HBR Layout,390050,53240,336810,0.8635046788873222,-1
3677,3678,Indiranagar,36250,63470,-27220,-0.7508965517241379,1
3678,3679,Vasanth Nagar,331550,43620,287930,0.8684361333132258,-1
3679,3680,Kalyan Nagar,177950,55690,122260,0.6870469232930598,0
3680,3681,Vasanth Nagar,27400,110620,-83220,-3.037226277372263,1
3681,3682,Varthur,35600,25600,10000,0.2808988764044944,1
3682,3683,CV Raman Nagar,117650,50880,66770,0.5675308117297068,0
3683,3684,Kalyan Nagar,242050,38400,203650,0.8413550919231564,-1
3684,3685,Whitefield,219200,24350,194850,0.8889142335766423,-1
3685,3686,Varthur,322150,56600,265550,0.8243054477727767,-1
3686,3687,Rajajinagar,312700,37010,275690,0.8816437480012792,-1
3687,3688,Vasanth Nagar,120100,113070,7030,0.05853455453788509,1
3688,3689,Horamavu,43050,130830,-87780,-2.0390243902439025,1
3689,3690,Krishnarajapuram,57350,71090,-13740,-0.23958151700087185,1
3690,3691,Shivajinagar,41200,60220,-19020,-0.4616504854368932,1
3691,3692,CV Raman Nagar,378000,27760,350240,0.9265608465608466,-1
3692,3693,Vasanth Nagar,224500,73220,151280,0.6738530066815145,0
3693,3694,Whitefield,99700,31050,68650,0.6885656970912738,0
3694,3695,HBR Layout,405100,98970,306130,0.7556899530980005,0
3695,3696,Kalyan Nagar,237900,52600,185300,0.7788986969314838,0
3696,3697,Shivajinagar,424050,46350,377700,0.8906968517863459,-1
3697,3698,Kammanahalli,130200,48330,81870,0.6288018433179724,0
3698,3699,Hoodi,290000,45260,244740,0.8439310344827586,-1
3699,3700,CV Raman Nagar,144850,21330,123520,0.8527442181567139,-1
3700,3701,Mahadevapura,207450,64410,143040,0.6895155459146782,0
3701,3702,Hebbal,409400,36790,372610,0.9101367855398144,-1
3702,3703,Whitefield,364900,8400,356500,0.9769799945190463,-1
3703,3704,HBR Layout,373400,71220,302180,0.8092662024638457,-1
3704,3705,Banaswadi,273300,99980,173320,0.6341748993779729,0
3705,3706,Mahadevapura,261350,57820,203530,0.7787641094317964,0
3706,3707,Indiranagar,109600,0,109600,1.0,-1
3707,3708,Horamavu,181750,101730,80020,0.4402751031636864,1
3708,3709,Kammanahalli,60950,30860,30090,0.4936833470057424,1
3709,3710,Shivajinagar,72950,31630,41320,0.5664153529814941,0
3710,3711,Marathahalli,234100,61010,173090,0.739384878257155,0
3711,3712,Krishnarajapuram,447900,80550,367350,0.820160750167448,-1
3712,3713,Hebbal,283700,43590,240110,0.8463517800493479,-1
3713,3714,Kalyan Nagar,221300,80000,141300,0.6384997740623588,0
3714,3715,HBR Layout,211450,21940,189510,0.8962402459210215,-1
3715,3716,Horamavu,321950,121410,200540,0.6228917533778537,0
3716,3717,CV Raman Nagar,227550,44170,183380,0.8058888156449132,-1
3717,3718,Marathahalli,162400,15220,147180,0.9062807881773399,-1
3718,3719,Shivajinagar,101950,65120,36830,0.36125551741049533,1
3719,3720,Rajajinagar,342300,104220,238080,0.6955302366345311,0
3720,3721,Malleswaram,204750,23960,180790,0.882979242979243,-1
3721,3722,Mahadevapura,130400,94880,35520,0.2723926380368098,1
3722,3723,Marathahalli,245400,58920,186480,0.7599022004889976,0
3723,3724,Jalahalli,95550,89490,6060,0.06342229199372057,1
3724,3725,Kammanahalli,432350,51600,380750,0.8806522493350295,-1
3725,3726,Shivajinagar,282800,33160,249640,0.8827439886845827,-1
3726,3727,Indiranagar,175900,55230,120670,0.6860147811256395,0
3727,3728,Kammanahalli,431000,50240,380760,0.8834338747099768,-1
3728,3729,HBR Layout,426200,81600,344600,0.8085405912717034,-1
3729,3730,Kammanahalli,25150,69360,-44210,-1.7578528827037774,1
3730,3731,Varthur,118350,97650,20700,0.17490494296577946,1
3731,3732,Shivajinagar,125800,111600,14200,0.11287758346581876,1
3732,3733,Rajajinagar,381000,105500,275500,0.7230971128608924,0
3733,3734,Rajajinagar,311150,84440,226710,0.7286196368311104,0
3734,3735,Banaswadi,284000,70230,213770,0.7527112676056338,0
3735,3736,Mahadevapura,70500,84750,-14250,-0.20212765957446807,1
3736,3737,Malleswaram,304900,113930,190970,0.6263365037717284,0
3737,3738,Marathahalli,322150,67700,254450,0.7898494490144343,0
3738,3739,Hoodi,297950,83750,214200,0.718912569223024,0
3739,3740,Banaswadi,316750,61810,254940,0.8048618784530387,-1
3740,3741,Hebbal,364500,88890,275610,0.7561316872427983,0
3741,3742,CV Raman Nagar,360500,70910,289590,0.8033009708737864,-1
3742,3743,Banaswadi,157450,39320,118130,0.75026992696094,0
3743,3744,Banaswadi,176950,104110,72840,0.411641706696807,1
3744,3745,Malleswaram,134650,54850,79800,0.5926476049015967,0
3745,3746,Malleswaram,346150,94340,251810,0.7274591939910443,0
3746,3747,Vasanth Nagar,49650,63260,-13610,-0.2741188318227593,1
3747,3748,Indiranagar,433500,55080,378420,0.8729411764705882,-1
3748,3749,Shivajinagar,25650,14360,11290,0.4401559454191033,1
3749,3750,Mahadevapura,267650,42640,225010,0.8406874649729124,-1
3750,3751,Kammanahalli,164850,68100,96750,0.5868971792538672,0
3751,3752,Indiranagar,162750,67950,94800,0.5824884792626728,0
3752,3753,Marathahalli,281050,153300,127750,0.45454545454545453,1
3753,3754,HBR Layout,430350,59830,370520,0.8609736261182758,-1
3754,3755,Mahadevapura,442550,17190,425360,0.9611569314201786,-1
3755,3756,Jalahalli,247300,107890,139410,0.5637282652648605,0
3756,3757,CV Raman Nagar,409150,77900,331250,0.8096052792374435,-1
3757,3758,CV Raman Nagar,185700,53940,131760,0.7095315024232633,0
3758,3759,Kammanahalli,178650,48060,130590,0.7309823677581864,0
3759,3760,Vasanth Nagar,35350,12150,23200,0.6562942008486563,0
3760,3761,Varthur,391250,118570,272680,0.6969456869009585,0
3761,3762,Kammanahalli,81100,80780,320,0.003945745992601726,1
3762,3763,Shivajinagar,192750,4290,188460,0.9777431906614786,-1
3763,3764,Mahadevapura,210950,45200,165750,0.785731215927945,0
3764,3765,Jalahalli,263200,91560,171640,0.652127659574468,0
3765,3766,Horamavu,291800,78140,213660,0.7322138450993831,0
3766,3767,Varthur,357700,59260,298440,0.8343304445065698,-1
3767,3768,Banaswadi,208700,61380,147320,0.7058936272160997,0
3768,3769,Marathahalli,434650,55060,379590,0.8733233636259059,-1
3769,3770,Horamavu,47150,32600,14550,0.30858960763520676,1
3770,3771,Banaswadi,253250,32170,221080,0.8729713721618954,-1
3771,3772,HBR Layout,227100,42160,184940,0.8143549097313959,-1
3772,3773,Jalahalli,86750,89050,-2300,-0.026512968299711816,1
3773,3774,HBR Layout,161700,76560,85140,0.5265306122448979,0
3774,3775,Rajajinagar,208050,36100,171950,0.8264840182648402,-1
3775,3776,Jalahalli,319500,23540,295960,0.9263223787167449,-1
3776,3777,Hoodi,380950,56390,324560,0.8519753248457803,-1
3777,3778,Mahadevapura,176300,90220,86080,0.4882586500283608,1
3778,3779,Hoodi,155700,101160,54540,0.35028901734104045,1
3779,3780,Mahadevapura,62600,53050,9550,0.152555910543131,1
3780,3781,Mahadevapura,82550,9090,73460,0.8898849182313749,-1
3781,3782,Horamavu,183100,151460,31640,0.172801747678864,1
3782,3783,Malleswaram,327350,61850,265500,0.8110585000763708,-1
3783,3784,Marathahalli,434800,81520,353280,0.8125114995400184,-1
3784,3785,Shivajinagar,307700,100210,207490,0.6743256418589535,0
3785,3786,Jalahalli,175200,63170,112030,0.6394406392694064,0
3786,3787,Whitefield,412950,57890,355060,0.8598135367477903,-1
3787,3788,Banaswadi,285450,131380,154070,0.5397442634436854,0
3788,3789,Kalyan Nagar,187100,122910,64190,0.3430785676109033,1
3789,3790,Vasanth Nagar,267050,60670,206380,0.7728140797603446,0
3790,3791,Whitefield,297350,163650,133700,0.44963847317975447,1
3791,3792,Mahadevapura,199650,102360,97290,0.48730277986476334,1
3792,3793,Rajajinagar,438900,99740,339160,0.7727500569605833,0
3793,3794,CV Raman Nagar,396400,64320,332080,0.8377396569122099,-1
3794,3795,Whitefield,356850,83410,273440,0.7662603334734482,0
3795,3796,Rajajinagar,270400,62830,207570,0.7676405325443787,0
3796,3797,Shivajinagar,216850,97830,119020,0.5488586580585658,0
3797,3798,Mahadevapura,221400,61740,159660,0.7211382113821139,0
3798,3799,Vasanth Nagar,134650,117850,16800,0.12476791682138878,1
3799,3800,Vasanth Nagar,240000,39560,200440,0.8351666666666666,-1
3800,3801,Hebbal,121650,50320,71330,0.586354295108919,0
3801,3802,Kammanahalli,254000,43740,210260,0.8277952755905512,-1
3802,3803,Horamavu,336100,56950,279150,0.8305563820291579,-1
3803,3804,Shivajinagar,336400,82930,253470,0.7534780023781212,0
3804,3805,Malleswaram,171800,80690,91110,0.530325960419092,0
3805,3806,Rajajinagar,312300,91950,220350,0.7055715658021133,0
3806,3807,Hoodi,186550,61900,124650,0.6681854730635218,0
3807,3808,Krishnarajapuram,89150,34450,54700,0.6135726303982053,0
3808,3809,Jalahalli,325150,167120,158030,0.4860218360756574,1
3809,3810,Hoodi,398450,45800,352650,0.8850545865227758,-1
3810,3811,Whitefield,135050,50100,84950,0.6290262865605332,0
3811,3812,Malleswaram,116450,82680,33770,0.2899957063117218,1
3812,3813,Horamavu,219700,67490,152210,0.6928083750568957,0
3813,3814,Varthur,127700,70960,56740,0.44432263116679716,1
3814,3815,Whitefield,417600,79110,338490,0.8105603448275862,-1
3815,3816,Horamavu,357800,79690,278110,0.7772778088317496,0
3816,3817,Horamavu,197500,61350,136150,0.689367088607595,0
3817,3818,Whitefield,438900,47450,391450,0.8918888129414445,-1
3818,3819,CV Raman Nagar,441000,43030,397970,0.9024263038548753,-1
3819,3820,CV Raman Nagar,413500,17120,396380,0.9585973397823458,-1
3820,3821,Vasanth Nagar,331850,49370,282480,0.8512279644417658,-1
3821,3822,Hebbal,312200,67720,244480,0.7830877642536835,0
3822,3823,Kammanahalli,147600,89930,57670,0.3907181571815718,1
3823,3824,Kammanahalli,357800,49750,308050,0.8609558412520961,-1
3824,3825,Varthur,438100,22690,415410,0.9482081716503081,-1
3825,3826,Whitefield,47850,96770,-48920,-1.0223615464994775,1
3826,3827,Banaswadi,225300,23860,201440,0.8940967598757212,-1
3827,3828,Mahadevapura,49700,87610,-37910,-0.7627766599597585,1
3828,3829,Hoodi,164750,61840,102910,0.6246433990895296,0
3829,3830,Hebbal,386350,19510,366840,0.9495017471204866,-1
3830,3831,Rajajinagar,97150,100020,-2870,-0.029541945445187855,1
3831,3832,Jalahalli,300900,123350,177550,0.5900631439016284,0
3832,3833,Krishnarajapuram,90600,54610,35990,0.39724061810154526,1
3833,3834,Horamavu,183850,121500,62350,0.33913516453630677,1
3834,3835,Shivajinagar,308200,69530,238670,0.7743997404282933,0
3835,3836,Hoodi,127000,63220,63780,0.5022047244094489,0
3836,3837,Indiranagar,382650,56150,326500,0.8532601594146086,-1
3837,3838,Malleswaram,322550,91440,231110,0.7165090683614943,0
3838,3839,Jalahalli,431450,45240,386210,0.8951442809131996,-1
3839,3840,Hoodi,251500,19550,231950,0.9222664015904573,-1
3840,3841,Indiranagar,250700,101280,149420,0.5960111687275629,0
3841,3842,Shivajinagar,177450,79710,97740,0.5508030431107355,0
3842,3843,Malleswaram,397800,50760,347040,0.8723981900452489,-1
3843,3844,Hebbal,408350,88290,320060,0.7837884167993143,0
3844,3845,Varthur,251450,55240,196210,0.7803141777689402,0
3845,3846,HBR Layout,401300,91010,310290,0.7732120608023922,0
3846,3847,Mahadevapura,99350,102140,-2790,-0.028082536487166583,1
3847,3848,Mahadevapura,30050,16620,13430,0.4469217970049917,1
3848,3849,Malleswaram,159300,1070,158230,0.9932831136220966,-1
3849,3850,Krishnarajapuram,331700,4830,326870,0.9854386493819717,-1
3850,3851,Banaswadi,39400,57380,-17980,-0.4563451776649746,1
3851,3852,CV Raman Nagar,190800,12430,178370,0.934853249475891,-1
3852,3853,Whitefield,46300,54130,-7830,-0.1691144708423326,1
3853,3854,Hoodi,65900,72890,-6990,-0.10606980273141123,1
3854,3855,Hoodi,46400,59890,-13490,-0.29073275862068965,1
3855,3856,Vasanth Nagar,370000,54110,315890,0.8537567567567568,-1
3856,3857,HBR Layout,448500,47130,401370,0.8949163879598662,-1
3857,3858,Indiranagar,68650,112660,-44010,-0.6410779315367807,1
3858,3859,Malleswaram,178450,65450,113000,0.6332305968058279,0
3859,3860,Banaswadi,59950,39580,20370,0.33978315262718933,1
3860,3861,Whitefield,376950,11490,365460,0.9695185037803422,-1
3861,3862,Krishnarajapuram,29900,40480,-10580,-0.35384615384615387,1
3862,3863,Malleswaram,256450,32800,223650,0.8720998245271983,-1
3863,3864,Varthur,81300,39350,41950,0.515990159901599,0
3864,3865,Malleswaram,144650,71040,73610,0.508883511925337,0
3865,3866,Kalyan Nagar,251750,27460,224290,0.8909235352532274,-1
3866,3867,Shivajinagar,368850,0,368850,1.0,-1
3867,3868,CV Raman Nagar,242800,76050,166750,0.6867792421746294,0
3868,3869,Varthur,64550,70170,-5620,-0.08706429124709528,1
3869,3870,Mahadevapura,385100,44670,340430,0.884004154764996,-1
3870,3871,Varthur,428000,98280,329720,0.770373831775701,0
3871,3872,Vasanth Nagar,252600,32420,220180,0.8716547901821061,-1
3872,3873,Horamavu,363650,74100,289550,0.7962326412759522,0
3873,3874,Kammanahalli,262600,64330,198270,0.755026656511805,0
3874,3875,Jalahalli,90450,53890,36560,0.40420121614151466,1
3875,3876,Banaswadi,312500,76860,235640,0.754048,0
3876,3877,Varthur,280450,45240,235210,0.8386878231413799,-1
3877,3878,Shivajinagar,306300,76910,229390,0.7489063010120797,0
3878,3879,Shivajinagar,252250,196700,55550,0.22021803766105055,1
3879,3880,Varthur,124200,47220,76980,0.6198067632850242,0
3880,3881,Rajajinagar,55900,102400,-46500,-0.8318425760286225,1
3881,3882,Mahadevapura,319400,32480,286920,0.8983093299937382,-1
3882,3883,Hebbal,405300,45750,359550,0.887120651369356,-1
3883,3884,Rajajinagar,446800,144820,301980,0.6758728737690242,0
3884,3885,Kammanahalli,121950,16510,105440,0.8646166461664616,-1
3885,3886,Shivajinagar,140300,128230,12070,0.08602993585174626,1
3886,3887,Indiranagar,224750,43140,181610,0.8080533926585095,-1
3887,3888,Kammanahalli,181450,34560,146890,0.8095343069716175,-1
3888,3889,Malleswaram,435650,62500,373150,0.8565362102605303,-1
3889,3890,Kalyan Nagar,325300,42420,282880,0.8695972948047955,-1
3890,3891,Kammanahalli,205800,32070,173730,0.8441690962099125,-1
3891,3892,Varthur,291700,25830,265870,0.9114501199862873,-1
3892,3893,Kalyan Nagar,120100,53000,67100,0.5587010824313072,0
3893,3894,Krishnarajapuram,270550,81740,188810,0.6978746996858252,0
3894,3895,Marathahalli,440600,39990,400610,0.9092374035406264,-1
3895,3896,HBR Layout,142400,26380,116020,0.8147471910112359,-1
3896,3897,CV Raman Nagar,359950,59560,300390,0.8345325739686068,-1
3897,3898,Whitefield,301050,34440,266610,0.8856003986048829,-1
3898,3899,Malleswaram,425700,51800,373900,0.878318064364576,-1
3899,3900,Shivajinagar,316650,61170,255480,0.806821411653245,-1
3900,3901,Indiranagar,299500,92520,206980,0.6910851419031719,0
3901,3902,CV Raman Nagar,386700,63990,322710,0.8345228859581071,-1
3902,3903,Kammanahalli,50950,48310,2640,0.05181550539744848,1
3903,3904,Kalyan Nagar,302900,93860,209040,0.6901287553648069,0
3904,3905,Marathahalli,438150,114450,323700,0.7387880862718247,0
3905,3906,Hoodi,383150,39940,343210,0.8957588411849146,-1
3906,3907,Hoodi,42750,77750,-35000,-0.8187134502923976,1
3907,3908,HBR Layout,373200,112510,260690,0.6985262593783494,0
3908,3909,Kalyan Nagar,123650,47720,75930,0.6140719773554387,0
3909,3910,Varthur,171400,59650,111750,0.6519836639439907,0
3910,3911,Shivajinagar,138950,60020,78930,0.5680460597337171,0
3911,3912,Mahadevapura,231950,46910,185040,0.79775813752964,0
3912,3913,Varthur,419250,11480,407770,0.9726177698270722,-1
3913,3914,Hoodi,365650,51650,314000,0.8587447012170109,-1
3914,3915,Hoodi,115600,52050,63550,0.5497404844290658,0
3915,3916,Varthur,78450,19800,58650,0.7476099426386233,0
3916,3917,Indiranagar,428200,99980,328220,0.7665109761793555,0
3917,3918,Vasanth Nagar,144600,97230,47370,0.3275933609958506,1
3918,3919,Horamavu,405900,47860,358040,0.882089184528209,-1
3919,3920,Kalyan Nagar,328850,89080,239770,0.7291166185190816,0
3920,3921,Krishnarajapuram,332050,49820,282230,0.849962355067008,-1
3921,3922,Marathahalli,444600,91800,352800,0.7935222672064778,0
3922,3923,HBR Layout,277500,81210,196290,0.7073513513513513,0
3923,3924,Jalahalli,127500,85210,42290,0.3316862745098039,1
3924,3925,Krishnarajapuram,167850,51190,116660,0.6950253202263926,0
3925,3926,Indiranagar,101650,48030,53620,0.5274963108706345,0
3926,3927,Horamavu,134200,79570,54630,0.40707898658718333,1
3927,3928,Malleswaram,228300,126750,101550,0.4448094612352168,1
3928,3929,Kalyan Nagar,243450,69400,174050,0.7149311973711234,0
3929,3930,Hebbal,72450,63810,8640,0.11925465838509317,1
3930,3931,CV Raman Nagar,293150,22060,271090,0.9247484223093979,-1
3931,3932,Kammanahalli,80400,47140,33260,0.413681592039801,1
3932,3933,Rajajinagar,431250,69100,362150,0.8397681159420289,-1
3933,3934,Vasanth Nagar,53200,73830,-20630,-0.38778195488721806,1
3934,3935,Rajajinagar,158550,67870,90680,0.5719331441185745,0
3935,3936,Marathahalli,404550,75640,328910,0.8130268199233717,-1
3936,3937,Marathahalli,97550,55180,42370,0.43434136340338286,1
3937,3938,Mahadevapura,123200,146440,-23240,-0.18863636363636363,1
3938,3939,Horamavu,363000,46570,316430,0.8717079889807162,-1
3939,3940,Kalyan Nagar,308300,51700,256600,0.8323061952643529,-1
3940,3941,Horamavu,193200,79900,113300,0.5864389233954451,0
3941,3942,Banaswadi,52650,98160,-45510,-0.8643874643874644,1
3942,3943,Kammanahalli,282950,72520,210430,0.7437003004064322,0
3943,3944,Rajajinagar,46000,11420,34580,0.7517391304347826,0
3944,3945,Rajajinagar,320100,40740,279360,0.8727272727272727,-1
3945,3946,Marathahalli,74400,110940,-36540,-0.49112903225806454,1
3946,3947,Shivajinagar,161650,59610,102040,0.6312403340550572,0
3947,3948,HBR Layout,339450,99440,240010,0.7070555310060391,0
3948,3949,Hoodi,62150,75010,-12860,-0.20691874497184232,1
3949,3950,Banaswadi,168800,42920,125880,0.7457345971563981,0
3950,3951,Marathahalli,361350,22810,338540,0.936875605368756,-1
3951,3952,Hebbal,94800,23860,70940,0.7483122362869198,0
3952,3953,Malleswaram,230400,41900,188500,0.8181423611111112,-1
3953,3954,Hebbal,35000,72510,-37510,-1.0717142857142856,1
3954,3955,Indiranagar,425950,94270,331680,0.7786829440075126,0
3955,3956,Shivajinagar,237750,86080,151670,0.6379390115667718,0
3956,3957,Whitefield,235300,51040,184260,0.7830854228644284,0
3957,3958,Vasanth Nagar,276050,31430,244620,0.8861438145263539,-1
3958,3959,Vasanth Nagar,223500,47750,175750,0.7863534675615212,0
3959,3960,Indiranagar,151300,80190,71110,0.4699933906146728,1
3960,3961,Mahadevapura,295750,154400,141350,0.4779374471682164,1
3961,3962,Mahadevapura,95300,69100,26200,0.27492130115424973,1
3962,3963,Kammanahalli,408050,5200,402850,0.987256463668668,-1
3963,3964,Hoodi,425550,29450,396100,0.9307954411937492,-1
3964,3965,Banaswadi,63650,61540,2110,0.03315003927729772,1
3965,3966,Marathahalli,238200,83620,154580,0.6489504617968094,0
3966,3967,Hoodi,391200,53040,338160,0.8644171779141104,-1
3967,3968,Kammanahalli,426900,63380,363520,0.8515343171702975,-1
3968,3969,Malleswaram,396550,16040,380510,0.9595511284831674,-1
3969,3970,Vasanth Nagar,361250,73690,287560,0.7960138408304498,0
3970,3971,Horamavu,440450,110290,330160,0.7495970030650471,0
3971,3972,Indiranagar,362800,49170,313630,0.864470782800441,-1
3972,3973,Whitefield,121150,92560,28590,0.23598844407758976,1
3973,3974,Rajajinagar,228200,110960,117240,0.5137598597721297,0
3974,3975,CV Raman Nagar,28650,20000,8650,0.3019197207678883,1
3975,3976,Horamavu,369050,69670,299380,0.8112179921419862,-1
3976,3977,Whitefield,80150,125830,-45680,-0.5699313786650031,1
3977,3978,Varthur,223000,70450,152550,0.6840807174887893,0
3978,3979,Hoodi,134550,61710,72840,0.5413600891861762,0
3979,3980,Marathahalli,171750,70280,101470,0.5908005822416302,0
3980,3981,Malleswaram,255950,55760,200190,0.7821449501855832,0
3981,3982,Jalahalli,395800,44060,351740,0.8886811520970187,-1
3982,3983,Shivajinagar,289650,72040,217610,0.7512860348696703,0
3983,3984,Indiranagar,361350,120200,241150,0.6673585166735851,0
3984,3985,Shivajinagar,261150,60380,200770,0.7687918820601187,0
3985,3986,Marathahalli,260500,165010,95490,0.3665642994241843,1
3986,3987,Banaswadi,95000,44590,50410,0.5306315789473685,0
3987,3988,Banaswadi,437700,120860,316840,0.7238748000913868,0
3988,3989,Vasanth Nagar,67850,45970,21880,0.3224760501105379,1
3989,3990,Hoodi,81400,75840,5560,0.0683046683046683,1
3990,3991,Hebbal,354200,50210,303990,0.8582439299830604,-1
3991,3992,Shivajinagar,374650,84750,289900,0.7737888696116375,0
3992,3993,Mahadevapura,45950,9980,35970,0.7828073993471164,0
3993,3994,Varthur,65450,71600,-6150,-0.09396485867074103,1
3994,3995,Horamavu,79600,39710,39890,0.5011306532663317,0
3995,3996,CV Raman Nagar,316500,46800,269700,0.852132701421801,-1
3996,3997,Whitefield,143500,51720,91780,0.639581881533101,0
3997,3998,Horamavu,182700,93830,88870,0.48642583470169676,1
3998,3999,HBR Layout,404800,52980,351820,0.8691205533596837,-1
3999,4000,Marathahalli,224250,41800,182450,0.8136008918617614,-1
4000,4001,Indiranagar,341800,110250,231550,0.6774429490930368,0
4001,4002,Hebbal,317750,93420,224330,0.7059952793076318,0
4002,4003,Whitefield,260400,43480,216920,0.833026113671275,-1
4003,4004,Malleswaram,156350,96830,59520,0.3806843620083147,1
4004,4005,Horamavu,174650,38050,136600,0.7821356999713713,0
4005,4006,Malleswaram,166900,47380,119520,0.7161174355901737,0
4006,4007,HBR Layout,141300,47410,93890,0.6644727530077849,0
4007,4008,Hoodi,161550,23700,137850,0.8532961931290622,-1
4008,4009,Indiranagar,264550,12070,252480,0.9543753543753544,-1
4009,4010,Vasanth Nagar,405350,109840,295510,0.7290242999876649,0
4010,4011,Kammanahalli,277150,15260,261890,0.9449395634133141,-1
4011,4012,Shivajinagar,438950,99850,339100,0.7725253445722747,0
4012,4013,Krishnarajapuram,324100,15320,308780,0.9527306386917618,-1
4013,4014,Varthur,120250,58980,61270,0.5095218295218296,0
4014,4015,Horamavu,354600,51430,303170,0.8549633389734913,-1
4015,4016,Hoodi,140050,35360,104690,0.7475187433059621,0
4016,4017,Vasanth Nagar,94300,73660,20640,0.2188759278897137,1
4017,4018,Rajajinagar,161100,75100,86000,0.5338299193047796,0
4018,4019,HBR Layout,170450,68090,102360,0.6005280140803755,0
4019,4020,HBR Layout,393500,98110,295390,0.7506734434561626,0
4020,4021,Krishnarajapuram,222400,87650,134750,0.6058902877697842,0
4021,4022,Marathahalli,397500,46560,350940,0.8828679245283019,-1
4022,4023,Mahadevapura,428250,67660,360590,0.8420081727962638,-1
4023,4024,Kammanahalli,261400,65690,195710,0.748699311400153,0
4024,4025,Banaswadi,378650,20780,357870,0.9451208239799287,-1
4025,4026,Whitefield,420800,29580,391220,0.9297053231939163,-1
4026,4027,HBR Layout,210400,27650,182750,0.8685836501901141,-1
4027,4028,Krishnarajapuram,442600,96870,345730,0.7811342069588794,0
4028,4029,HBR Layout,384650,61950,322700,0.8389444949954504,-1
4029,4030,Banaswadi,352900,37900,315000,0.8926041371493341,-1
4030,4031,Jalahalli,256000,51280,204720,0.7996875,0
4031,4032,Hebbal,427150,81290,345860,0.809692145616294,-1
4032,4033,Jalahalli,393850,60840,333010,0.8455249460454488,-1
4033,4034,Varthur,243300,100630,142670,0.5863953966296753,0
4034,4035,Rajajinagar,75550,50210,25340,0.33540701522170746,1
4035,4036,Marathahalli,29350,10130,19220,0.654855195911414,0
4036,4037,Kammanahalli,333350,77680,255670,0.7669716514174292,0
4037,4038,Rajajinagar,86200,58300,27900,0.3236658932714617,1
4038,4039,Jalahalli,197400,64520,132880,0.6731509625126646,0
4039,4040,Kalyan Nagar,87800,35410,52390,0.5966970387243736,0
4040,4041,Kalyan Nagar,102450,38710,63740,0.622157149829185,0
4041,4042,Rajajinagar,161000,48760,112240,0.6971428571428572,0
4042,4043,Hoodi,39350,24510,14840,0.37712833545108004,1
4043,4044,CV Raman Nagar,275250,95010,180240,0.6548228882833788,0
4044,4045,Varthur,108800,31100,77700,0.7141544117647058,0
4045,4046,Jalahalli,357200,161020,196180,0.5492161254199328,0
4046,4047,Jalahalli,437450,91600,345850,0.7906046405303463,0
4047,4048,Malleswaram,181250,60060,121190,0.6686344827586207,0
4048,4049,Varthur,159100,59410,99690,0.6265870521684476,0
4049,4050,Shivajinagar,225850,41850,184000,0.8147000221385876,-1
4050,4051,Hoodi,279850,41650,238200,0.8511702697873861,-1
4051,4052,Jalahalli,299100,61180,237920,0.7954530257438983,0
4052,4053,Kammanahalli,66450,104100,-37650,-0.5665914221218962,1
4053,4054,Mahadevapura,184650,65790,118860,0.6437043054427295,0
4054,4055,Hebbal,369200,31340,337860,0.9151137594799567,-1
4055,4056,Vasanth Nagar,431000,49890,381110,0.8842459396751741,-1
4056,4057,Kammanahalli,53000,127150,-74150,-1.399056603773585,1
4057,4058,Varthur,84000,85560,-1560,-0.018571428571428572,1
4058,4059,Malleswaram,118100,59470,58630,0.4964436917866215,1
4059,4060,Mahadevapura,217300,77360,139940,0.6439944776806259,0
4060,4061,Krishnarajapuram,38800,36540,2260,0.05824742268041237,1
4061,4062,Kammanahalli,355600,97440,258160,0.7259842519685039,0
4062,4063,Jalahalli,380100,143460,236640,0.6225730071033938,0
4063,4064,Kalyan Nagar,351850,3410,348440,0.9903083700440528,-1
4064,4065,Kammanahalli,243700,25110,218590,0.8969634796881412,-1
4065,4066,Marathahalli,246500,39150,207350,0.8411764705882353,-1
4066,4067,Banaswadi,285550,95610,189940,0.6651724741726492,0
4067,4068,Hoodi,129350,91170,38180,0.2951681484344801,1
4068,4069,Kammanahalli,141900,73980,67920,0.47864693446088796,1
4069,4070,HBR Layout,128500,68830,59670,0.4643579766536965,1
4070,4071,Whitefield,175650,42110,133540,0.7602618844292628,0
4071,4072,Varthur,79100,27890,51210,0.6474083438685209,0
4072,4073,Malleswaram,61950,59550,2400,0.0387409200968523,1
4073,4074,Varthur,47200,67620,-20420,-0.4326271186440678,1
4074,4075,HBR Layout,399450,134740,264710,0.6626861935160846,0
4075,4076,Whitefield,72150,107190,-35040,-0.4856548856548857,1
4076,4077,Krishnarajapuram,390300,54720,335580,0.8598001537279016,-1
4077,4078,Krishnarajapuram,186300,65240,121060,0.6498121309715512,0
4078,4079,Vasanth Nagar,251400,45140,206260,0.8204455051710422,-1
4079,4080,HBR Layout,439050,106240,332810,0.7580230042136431,0
4080,4081,Horamavu,391500,138440,253060,0.6463856960408685,0
4081,4082,Horamavu,161000,69330,91670,0.5693788819875777,0
4082,4083,Kammanahalli,288350,138250,150100,0.5205479452054794,0
4083,4084,Shivajinagar,376100,118180,257920,0.6857750598245148,0
4084,4085,Mahadevapura,228150,68070,160080,0.7016436554898093,0
4085,4086,HBR Layout,429400,42550,386850,0.9009082440614812,-1
4086,4087,Hebbal,25700,64590,-38890,-1.5132295719844358,1
4087,4088,Horamavu,179850,45710,134140,0.7458437586877954,0
4088,4089,Kammanahalli,318400,58970,259430,0.8147927135678392,-1
4089,4090,Mahadevapura,72900,91300,-18400,-0.252400548696845,1
4090,4091,Marathahalli,299800,48340,251460,0.8387591727818545,-1
4091,4092,Vasanth Nagar,250650,77750,172900,0.6898065030919609,0
4092,4093,Whitefield,26750,22080,4670,0.17457943925233646,1
4093,4094,Marathahalli,404650,30130,374520,0.9255405906338812,-1
4094,4095,Jalahalli,121800,71560,50240,0.4124794745484401,1
4095,4096,Vasanth Nagar,373150,72670,300480,0.8052525793916655,-1
4096,4097,Hebbal,166150,62350,103800,0.6247366837195305,0
4097,4098,Jalahalli,192100,29160,162940,0.848204060385216,-1
4098,4099,HBR Layout,332300,41110,291190,0.8762864881131508,-1
4099,4100,Kammanahalli,159450,107090,52360,0.3283788021323299,1
4100,4101,Indiranagar,298750,88020,210730,0.7053723849372385,0
4101,4102,Whitefield,105450,50710,54740,0.519108582266477,0
4102,4103,Krishnarajapuram,157900,36760,121140,0.7671944268524382,0
4103,4104,Marathahalli,343200,26720,316480,0.9221445221445221,-1
4104,4105,Hoodi,387300,105360,281940,0.7279628195197522,0
4105,4106,Rajajinagar,100900,57360,43540,0.4315163528245788,1
4106,4107,Kammanahalli,129700,43660,86040,0.6633770239013107,0
4107,4108,Hebbal,318850,68670,250180,0.7846322722283205,0
4108,4109,Hoodi,156750,2770,153980,0.9823285486443382,-1
4109,4110,Jalahalli,51150,49290,1860,0.03636363636363636,1
4110,4111,CV Raman Nagar,335850,72090,263760,0.7853506029477445,0
4111,4112,Shivajinagar,372200,49240,322960,0.8677055346587856,-1
4112,4113,Marathahalli,414150,106630,307520,0.7425328987081975,0
4113,4114,Malleswaram,146600,54230,92370,0.6300818553888131,0
4114,4115,Malleswaram,248500,67630,180870,0.7278470824949698,0
4115,4116,CV Raman Nagar,423500,52760,370740,0.8754191263282173,-1
4116,4117,Indiranagar,128750,64860,63890,0.49623300970873785,1
4117,4118,Marathahalli,304100,50310,253790,0.8345609996711608,-1
4118,4119,Varthur,83000,103980,-20980,-0.2527710843373494,1
4119,4120,Whitefield,51100,110410,-59310,-1.160665362035225,1
4120,4121,Vasanth Nagar,245800,39700,206100,0.838486574450773,-1
4121,4122,Marathahalli,37500,113030,-75530,-2.0141333333333336,1
4122,4123,CV Raman Nagar,49500,75850,-26350,-0.5323232323232323,1
4123,4124,Rajajinagar,192350,83470,108880,0.566051468676891,0
4124,4125,Jalahalli,233550,31010,202540,0.8672232926568186,-1
4125,4126,HBR Layout,66900,50860,16040,0.2397608370702541,1
4126,4127,Rajajinagar,437600,36690,400910,0.9161563071297989,-1
4127,4128,Marathahalli,69700,77170,-7470,-0.10717360114777619,1
4128,4129,Whitefield,319050,108780,210270,0.6590503055947343,0
4129,4130,HBR Layout,116650,78070,38580,0.3307329618516931,1
4130,4131,Horamavu,360350,131980,228370,0.6337449701678923,0
4131,4132,Varthur,151950,29470,122480,0.806054623231326,-1
4132,4133,Banaswadi,300650,29960,270690,0.9003492433061699,-1
4133,4134,Jalahalli,211300,106350,104950,0.4966871746332229,1
4134,4135,Vasanth Nagar,282950,74460,208490,0.7368439653649055,0
4135,4136,CV Raman Nagar,276750,73070,203680,0.7359710930442638,0
4136,4137,Varthur,329250,32650,296600,0.90083523158694,-1
4137,4138,Hebbal,405900,24390,381510,0.9399113082039912,-1
4138,4139,Horamavu,363950,86440,277510,0.7624948481934332,0
4139,4140,Horamavu,230950,81600,149350,0.6466767698636069,0
4140,4141,CV Raman Nagar,198200,47010,151190,0.7628153380423814,0
4141,4142,Kalyan Nagar,221150,34250,186900,0.8451277413520235,-1
4142,4143,Kalyan Nagar,58750,17860,40890,0.696,0
4143,4144,Rajajinagar,338000,3060,334940,0.9909467455621301,-1
4144,4145,Whitefield,158800,33020,125780,0.7920654911838791,0
4145,4146,Horamavu,25600,66380,-40780,-1.59296875,1
4146,4147,Varthur,72950,104570,-31620,-0.4334475668265936,1
4147,4148,HBR Layout,29650,109940,-80290,-2.7079258010118044,1
4148,4149,Rajajinagar,367700,57160,310540,0.8445471852053305,-1
4149,4150,Mahadevapura,442100,75620,366480,0.8289527256276861,-1
4150,4151,Vasanth Nagar,396750,115710,281040,0.7083553875236295,0
4151,4152,Kammanahalli,261300,65480,195820,0.7494068120933792,0
4152,4153,Banaswadi,230700,62640,168060,0.728478543563069,0
4153,4154,Kalyan Nagar,198150,34930,163220,0.8237194044915468,-1
4154,4155,Marathahalli,439650,61750,377900,0.8595473672239281,-1
4155,4156,Whitefield,123450,76320,47130,0.38177399756986635,1
4156,4157,Jalahalli,79050,116710,-37660,-0.4764073371283997,1
4157,4158,Horamavu,248700,67890,180810,0.7270205066344994,0
4158,4159,CV Raman Nagar,329250,85940,243310,0.7389825360668185,0
4159,4160,Kalyan Nagar,350350,7370,342980,0.9789638932496075,-1
4160,4161,Marathahalli,253500,132610,120890,0.4768836291913215,1
4161,4162,Rajajinagar,146700,28190,118510,0.8078391274710293,-1
4162,4163,Banaswadi,79900,105440,-25540,-0.31964956195244054,1
4163,4164,CV Raman Nagar,62300,61360,940,0.015088282504012842,1
4164,4165,Vasanth Nagar,247600,69560,178040,0.7190630048465266,0
4165,4166,Marathahalli,345350,45730,299620,0.8675836108295931,-1
4166,4167,Jalahalli,118750,91060,27690,0.23317894736842104,1
4167,4168,Kammanahalli,306400,47030,259370,0.8465078328981723,-1
4168,4169,Horamavu,317450,49990,267460,0.8425263821074185,-1
4169,4170,Malleswaram,92050,22340,69710,0.7573058120586638,0
4170,4171,Whitefield,343300,28050,315250,0.9182930381590446,-1
4171,4172,Varthur,175500,96790,78710,0.4484900284900285,1
4172,4173,Mahadevapura,291150,34470,256680,0.8816074188562597,-1
4173,4174,Banaswadi,132400,25380,107020,0.8083081570996978,-1
4174,4175,Rajajinagar,236850,70960,165890,0.7004010977411864,0
4175,4176,Whitefield,225000,79690,145310,0.6458222222222222,0
4176,4177,Rajajinagar,146100,46650,99450,0.6806981519507187,0
4177,4178,Banaswadi,377350,17350,360000,0.9540214654829734,-1
4178,4179,Vasanth Nagar,197500,119050,78450,0.3972151898734177,1
4179,4180,Mahadevapura,152050,86660,65390,0.4300559026635975,1
4180,4181,Kalyan Nagar,207900,66130,141770,0.6819143819143819,0
4181,4182,Hebbal,375300,80040,295260,0.7867306155075939,0
4182,4183,Marathahalli,337350,64840,272510,0.8077960575070402,-1
4183,4184,Varthur,424650,86780,337870,0.795643471093842,0
4184,4185,Varthur,367950,69060,298890,0.8123114553607828,-1
4185,4186,Whitefield,186150,22050,164100,0.8815471394037067,-1
4186,4187,Jalahalli,231700,47560,184140,0.7947345705653863,0
4187,4188,Krishnarajapuram,447300,71120,376180,0.8410015649452269,-1
4188,4189,Whitefield,378050,36240,341810,0.9041396640655998,-1
4189,4190,Jalahalli,79800,93170,-13370,-0.1675438596491228,1
4190,4191,Indiranagar,176300,78320,97980,0.5557572319909245,0
4191,4192,Varthur,253950,78390,175560,0.6913171884229179,0
4192,4193,Varthur,263900,52620,211280,0.8006062902614627,-1
4193,4194,Marathahalli,52850,84510,-31660,-0.5990539262062441,1
4194,4195,Whitefield,104300,68580,35720,0.3424736337488015,1
4195,4196,Marathahalli,189050,75870,113180,0.5986775985189103,0
4196,4197,Horamavu,243200,113570,129630,0.5330180921052632,0
4197,4198,Krishnarajapuram,192650,43870,148780,0.7722813392161951,0
4198,4199,Horamavu,361550,34030,327520,0.9058774719955746,-1
4199,4200,Varthur,89750,59960,29790,0.33192200557103063,1
4200,4201,Marathahalli,127650,84650,43000,0.33685859772816296,1
4201,4202,Varthur,424150,59620,364530,0.8594365200990216,-1
4202,4203,HBR Layout,328400,78500,249900,0.7609622411693058,0
4203,4204,Banaswadi,191450,98500,92950,0.4855053538782972,1
4204,4205,Banaswadi,191450,87470,103980,0.5431183076521285,0
4205,4206,Horamavu,415700,31120,384580,0.9251383209044984,-1
4206,4207,Mahadevapura,332800,31390,301410,0.9056790865384615,-1
4207,4208,Rajajinagar,244200,49450,194750,0.7975020475020475,0
4208,4209,CV Raman Nagar,204950,49030,155920,0.7607709197365211,0
4209,4210,HBR Layout,40700,81350,-40650,-0.9987714987714987,1
4210,4211,CV Raman Nagar,392100,27460,364640,0.9299668451925529,-1
4211,4212,Malleswaram,104500,80790,23710,0.22688995215311006,1
4212,4213,Marathahalli,449450,24440,425010,0.9456224274112804,-1
4213,4214,Kammanahalli,239700,120380,119320,0.49778890279516064,1
4214,4215,Horamavu,418600,39620,378980,0.9053511705685618,-1
4215,4216,Kalyan Nagar,266450,46840,219610,0.8242071683242634,-1
4216,4217,HBR Layout,301050,42420,258630,0.8590931738913802,-1
4217,4218,Banaswadi,255850,68000,187850,0.7342192691029901,0
4218,4219,Shivajinagar,114750,66710,48040,0.4186492374727669,1
4219,4220,Mahadevapura,27150,22230,4920,0.18121546961325966,1
4220,4221,Vasanth Nagar,418250,82690,335560,0.8022952779438135,-1
4221,4222,Kammanahalli,215600,57250,158350,0.7344619666048238,0
4222,4223,Rajajinagar,113100,61050,52050,0.46021220159151194,1
4223,4224,HBR Layout,82000,169030,-87030,-1.061341463414634,1
4224,4225,HBR Layout,197200,75380,121820,0.6177484787018256,0
4225,4226,Varthur,316750,65690,251060,0.7926124704025257,0
4226,4227,Horamavu,322800,40080,282720,0.8758364312267658,-1
4227,4228,Varthur,280050,53120,226930,0.8103195857882521,-1
4228,4229,Horamavu,32850,35160,-2310,-0.07031963470319634,1
4229,4230,Varthur,426100,47590,378510,0.8883126026754283,-1
4230,4231,Krishnarajapuram,141200,108000,33200,0.23512747875354106,1
4231,4232,Shivajinagar,258950,64180,194770,0.7521529252751497,0
4232,4233,Krishnarajapuram,442100,144280,297820,0.6736484958154264,0
4233,4234,Kammanahalli,260500,58280,202220,0.7762763915547025,0
4234,4235,Kalyan Nagar,414400,45550,368850,0.8900820463320464,-1
4235,4236,Indiranagar,119950,57200,62750,0.5231346394330971,0
4236,4237,Shivajinagar,310500,41230,269270,0.8672141706924316,-1
4237,4238,CV Raman Nagar,178400,51840,126560,0.7094170403587444,0
4238,4239,Krishnarajapuram,199600,19000,180600,0.9048096192384769,-1
4239,4240,Marathahalli,142750,61930,80820,0.5661646234676007,0
4240,4241,Horamavu,253450,70390,183060,0.7222726376011047,0
4241,4242,Whitefield,179750,57150,122600,0.6820584144645341,0
4242,4243,Vasanth Nagar,118850,11600,107250,0.9023979806478755,-1
4243,4244,Hebbal,237650,13160,224490,0.9446244477172312,-1
4244,4245,Varthur,431550,50830,380720,0.8822152705364384,-1
4245,4246,CV Raman Nagar,427650,86450,341200,0.797848708055653,0
4246,4247,Indiranagar,336000,54820,281180,0.8368452380952381,-1
4247,4248,Kammanahalli,121750,23190,98560,0.8095277207392197,-1
4248,4249,Kammanahalli,382800,82950,299850,0.783307210031348,0
4249,4250,Rajajinagar,121500,33390,88110,0.7251851851851852,0
4250,4251,Hoodi,63350,70470,-7120,-0.11239147592738753,1
4251,4252,Varthur,220250,97790,122460,0.5560045402951191,0
4252,4253,Malleswaram,146200,33510,112690,0.7707934336525308,0
4253,4254,Kammanahalli,334650,86240,248410,0.7422979232033468,0
4254,4255,Banaswadi,184450,19820,164630,0.8925454052588777,-1
4255,4256,CV Raman Nagar,138150,75960,62190,0.4501628664495114,1
4256,4257,Mahadevapura,205450,37580,167870,0.8170844487709905,-1
4257,4258,Hoodi,116300,77280,39020,0.3355116079105761,1
4258,4259,Malleswaram,225950,61250,164700,0.7289223279486612,0
4259,4260,Hoodi,332050,74570,257480,0.7754253877428098,0
4260,4261,CV Raman Nagar,164850,51390,113460,0.6882620564149227,0
4261,4262,Hebbal,338300,89520,248780,0.7353827963346142,0
4262,4263,Kammanahalli,141200,83660,57540,0.4075070821529745,1
4263,4264,Varthur,425700,99210,326490,0.7669485553206483,0
4264,4265,Malleswaram,393100,46930,346170,0.8806156194352582,-1
4265,4266,Jalahalli,393300,64080,329220,0.8370709382151029,-1
4266,4267,Varthur,280750,63320,217430,0.7744612644701692,0
4267,4268,Malleswaram,104750,72820,31930,0.30482100238663484,1
4268,4269,Hoodi,241450,34660,206790,0.8564506108925243,-1
4269,4270,Mahadevapura,413700,62920,350780,0.8479091128837322,-1
4270,4271,Hebbal,65200,80840,-15640,-0.23987730061349694,1
4271,4272,Vasanth Nagar,228850,18510,210340,0.9191173257592309,-1
4272,4273,Mahadevapura,292000,104430,187570,0.6423630136986301,0
4273,4274,CV Raman Nagar,345100,16800,328300,0.9513184584178499,-1
4274,4275,Malleswaram,314550,48190,266360,0.8467970116038785,-1
4275,4276,Horamavu,401100,90730,310370,0.7737970580902518,0
4276,4277,Horamavu,99850,108040,-8190,-0.08202303455182774,1
4277,4278,Mahadevapura,146550,25090,121460,0.8287956328897987,-1
4278,4279,Kammanahalli,149000,42340,106660,0.7158389261744966,0
4279,4280,Jalahalli,327350,84700,242650,0.7412555368871239,0
4280,4281,Varthur,304200,71210,232990,0.7659105851413543,0
4281,4282,Vasanth Nagar,150800,65370,85430,0.5665119363395226,0
4282,4283,Horamavu,149350,43740,105610,0.7071309005691329,0
4283,4284,Krishnarajapuram,321100,11470,309630,0.9642790407972595,-1
4284,4285,Malleswaram,322600,61870,260730,0.8082145071295722,-1
4285,4286,Whitefield,435900,109930,325970,0.7478091305345262,0
4286,4287,Marathahalli,185200,72890,112310,0.6064254859611231,0
4287,4288,Marathahalli,316550,40960,275590,0.8706049597220028,-1
4288,4289,Kammanahalli,135750,26660,109090,0.803609576427256,-1
4289,4290,Hebbal,266650,22820,243830,0.9144196512282018,-1
4290,4291,Marathahalli,153450,110010,43440,0.283088954056696,1
4291,4292,HBR Layout,123900,47510,76390,0.616545601291364,0
4292,4293,Shivajinagar,130450,60270,70180,0.5379839018781142,0
4293,4294,Indiranagar,42050,144490,-102440,-2.4361474435196193,1
4294,4295,Mahadevapura,44550,35190,9360,0.2101010101010101,1
4295,4296,Banaswadi,357100,31780,325320,0.9110053206384766,-1
4296,4297,Shivajinagar,158900,94810,64090,0.40333543108873504,1
4297,4298,Banaswadi,448250,88730,359520,0.8020524261015058,-1
4298,4299,Banaswadi,396400,61420,334980,0.8450554994954591,-1
4299,4300,Hebbal,410650,60170,350480,0.8534761962741995,-1
4300,4301,Varthur,103900,13870,90030,0.8665062560153994,-1
4301,4302,Rajajinagar,269600,116600,153000,0.5675074183976261,0
4302,4303,Marathahalli,37250,31160,6090,0.16348993288590605,1
4303,4304,Marathahalli,344900,107550,237350,0.6881704841983184,0
4304,4305,Whitefield,104950,95370,9580,0.09128156264888042,1
4305,4306,Kammanahalli,36000,51430,-15430,-0.4286111111111111,1
4306,4307,Rajajinagar,253000,113810,139190,0.5501581027667984,0
4307,4308,Malleswaram,174450,51220,123230,0.7063915161937518,0
4308,4309,Jalahalli,301350,81320,220030,0.730147668823627,0
4309,4310,Mahadevapura,166450,54770,111680,0.670952237909282,0
4310,4311,Shivajinagar,336150,74760,261390,0.777599286033021,0
4311,4312,Marathahalli,92800,44920,47880,0.5159482758620689,0
4312,4313,Rajajinagar,327300,130960,196340,0.5998777879621142,0
4313,4314,Horamavu,254950,104390,150560,0.5905471661110021,0
4314,4315,CV Raman Nagar,284350,80130,204220,0.7181994021452436,0
4315,4316,Varthur,315900,85650,230250,0.7288698955365622,0
4316,4317,Shivajinagar,347700,67170,280530,0.806816220880069,-1
4317,4318,Kammanahalli,260450,70450,190000,0.7295066231522365,0
4318,4319,Jalahalli,335600,34300,301300,0.8977949940405244,-1
4319,4320,Shivajinagar,432750,66850,365900,0.845522819179665,-1
4320,4321,Hebbal,146150,87640,58510,0.4003421142661649,1
4321,4322,Mahadevapura,400450,62200,338250,0.844674740916469,-1
4322,4323,Shivajinagar,378350,82100,296250,0.7830051539579754,0
4323,4324,Krishnarajapuram,436900,68580,368320,0.8430304417486839,-1
4324,4325,Mahadevapura,67200,66210,990,0.014732142857142857,1
4325,4326,Varthur,86900,76950,9950,0.1144994246260069,1
4326,4327,Mahadevapura,41800,61760,-19960,-0.47751196172248805,1
4327,4328,Hebbal,438450,101380,337070,0.7687763713080169,0
4328,4329,Indiranagar,371500,53790,317710,0.8552086137281292,-1
4329,4330,Indiranagar,325500,20420,305080,0.9372657450076805,-1
4330,4331,Horamavu,318850,61980,256870,0.8056139250431237,-1
4331,4332,Kalyan Nagar,154850,5550,149300,0.9641588634162093,-1
4332,4333,Jalahalli,274250,47560,226690,0.8265815861440292,-1
4333,4334,Varthur,365450,70090,295360,0.8082090573265837,-1
4334,4335,Mahadevapura,230800,87220,143580,0.6220970537261699,0
4335,4336,CV Raman Nagar,64200,47850,16350,0.2546728971962617,1
4336,4337,HBR Layout,250450,65360,185090,0.7390297464563785,0
4337,4338,Shivajinagar,295500,125730,169770,0.5745177664974619,0
4338,4339,CV Raman Nagar,405300,56990,348310,0.859388107574636,-1
4339,4340,Kammanahalli,323400,98450,224950,0.6955782312925171,0
4340,4341,Malleswaram,407200,62060,345140,0.8475933202357564,-1
4341,4342,Hoodi,148700,48600,100100,0.6731674512441157,0
4342,4343,Mahadevapura,314900,60420,254480,0.8081295649412512,-1
4343,4344,Kalyan Nagar,285350,41740,243610,0.8537234974592606,-1
4344,4345,Horamavu,100750,60490,40260,0.3996029776674938,1
4345,4346,Hebbal,356050,47380,308670,0.8669288021345317,-1
4346,4347,CV Raman Nagar,220400,60060,160340,0.7274954627949183,0
4347,4348,Banaswadi,241950,50670,191280,0.7905765654060757,0
4348,4349,Hebbal,131050,50780,80270,0.6125143075162152,0
4349,4350,Vasanth Nagar,180550,68250,112300,0.6219883688728884,0
4350,4351,Varthur,118150,50320,67830,0.5741007194244604,0
4351,4352,Malleswaram,362700,9230,353470,0.9745519713261649,-1
4352,4353,Rajajinagar,252200,59360,192840,0.7646312450436161,0
4353,4354,Mahadevapura,83800,90020,-6220,-0.07422434367541766,1
4354,4355,Vasanth Nagar,201450,105010,96440,0.47872921320426903,1
4355,4356,Marathahalli,107250,69290,37960,0.35393939393939394,1
4356,4357,Kalyan Nagar,437700,134080,303620,0.6936714644733836,0
4357,4358,Krishnarajapuram,396250,52070,344180,0.8685930599369085,-1
4358,4359,Varthur,186050,59760,126290,0.6787960225745767,0
4359,4360,Banaswadi,86850,24670,62180,0.7159470351180196,0
4360,4361,Hoodi,362000,115740,246260,0.6802762430939227,0
4361,4362,HBR Layout,388650,78690,309960,0.7975299112311849,0
4362,4363,Hoodi,394250,72430,321820,0.816284083703234,-1
4363,4364,Horamavu,266900,76630,190270,0.7128887223679281,0
4364,4365,Indiranagar,319450,120100,199350,0.624041321020504,0
4365,4366,Jalahalli,224250,22150,202100,0.9012263099219621,-1
4366,4367,Hoodi,188250,32730,155520,0.8261354581673307,-1
4367,4368,Jalahalli,346350,102520,243830,0.7039988450988884,0
4368,4369,Shivajinagar,75400,164880,-89480,-1.186737400530504,1
4369,4370,Varthur,71400,78530,-7130,-0.09985994397759104,1
4370,4371,Horamavu,115000,47560,67440,0.5864347826086956,0
4371,4372,Rajajinagar,405300,113840,291460,0.7191216382926228,0
4372,4373,Vasanth Nagar,447050,57650,389400,0.8710435074376468,-1
4373,4374,HBR Layout,47350,139520,-92170,-1.9465681098204857,1
4374,4375,Vasanth Nagar,401500,40270,361230,0.8997011207970113,-1
4375,4376,Malleswaram,337550,58780,278770,0.8258628351355355,-1
4376,4377,Mahadevapura,53550,33030,20520,0.3831932773109244,1
4377,4378,Kammanahalli,310650,114570,196080,0.6311926605504588,0
4378,4379,Marathahalli,127750,79920,47830,0.37440313111545986,1
4379,4380,Whitefield,77400,74820,2580,0.03333333333333333,1
4380,4381,Vasanth Nagar,78650,51220,27430,0.3487603305785124,1
4381,4382,Kalyan Nagar,287650,41350,246300,0.8562489136102903,-1
4382,4383,Kalyan Nagar,126500,99050,27450,0.21699604743083004,1
4383,4384,Kalyan Nagar,435450,66950,368500,0.8462510047077736,-1
4384,4385,Krishnarajapuram,207650,135740,71910,0.34630387671562723,1
4385,4386,Jalahalli,346200,118020,228180,0.6590987868284228,0
4386,4387,Whitefield,267750,7510,260240,0.9719514472455649,-1
4387,4388,Horamavu,429900,81490,348410,0.8104442893696209,-1
4388,4389,Kalyan Nagar,263200,115390,147810,0.5615881458966565,0
4389,4390,Hoodi,179300,28170,151130,0.8428890128276632,-1
4390,4391,Marathahalli,182150,175400,6750,0.03705737029920395,1
4391,4392,Malleswaram,261250,37890,223360,0.8549665071770335,-1
4392,4393,Vasanth Nagar,74150,39920,34230,0.46163182737693864,1
4393,4394,Horamavu,343450,65310,278140,0.8098413160576503,-1
4394,4395,Marathahalli,410050,108970,301080,0.7342519204975003,0
4395,4396,Krishnarajapuram,200000,51580,148420,0.7421,0
4396,4397,Rajajinagar,90900,40250,50650,0.5572057205720572,0
4397,4398,HBR Layout,146850,91430,55420,0.3773918964930201,1
4398,4399,Whitefield,90850,60710,30140,0.3317556411667584,1
4399,4400,Vasanth Nagar,210600,76990,133610,0.6344254510921178,0
4400,4401,Kalyan Nagar,405800,112620,293180,0.7224741251848201,0
4401,4402,Hoodi,126550,84760,41790,0.33022520742789413,1
4402,4403,Hebbal,249350,72760,176590,0.7082013234409464,0
4403,4404,HBR Layout,191600,12070,179530,0.9370041753653444,-1
4404,4405,HBR Layout,284550,42620,241930,0.8502196450535934,-1
4405,4406,Kammanahalli,410550,63650,346900,0.844964072585556,-1
4406,4407,Mahadevapura,299100,24780,274320,0.9171514543630893,-1
4407,4408,Mahadevapura,94550,45080,49470,0.5232152300370174,0
4408,4409,Mahadevapura,334550,102430,232120,0.693827529517262,0
4409,4410,Hoodi,404550,37410,367140,0.9075268817204301,-1
4410,4411,CV Raman Nagar,81800,88770,-6970,-0.0852078239608802,1
4411,4412,Whitefield,427950,63080,364870,0.8525996027573315,-1
4412,4413,Hebbal,112500,38610,73890,0.6568,0
4413,4414,Vasanth Nagar,311500,33320,278180,0.8930337078651686,-1
4414,4415,Varthur,239200,96490,142710,0.5966137123745819,0
4415,4416,Varthur,73850,44480,29370,0.3976980365605958,1
4416,4417,Vasanth Nagar,194900,96650,98250,0.504104669061057,0
4417,4418,Shivajinagar,283950,44280,239670,0.8440570522979398,-1
4418,4419,Horamavu,297000,31150,265850,0.8951178451178451,-1
4419,4420,Kammanahalli,437600,45430,392170,0.8961837294332724,-1
4420,4421,HBR Layout,126500,56870,69630,0.5504347826086956,0
4421,4422,CV Raman Nagar,395400,57480,337920,0.854628224582701,-1
4422,4423,Horamavu,301900,57570,244330,0.8093077177873468,-1
4423,4424,Krishnarajapuram,152700,45400,107300,0.7026850032743942,0
4424,4425,Banaswadi,220450,66070,154380,0.7002948514402358,0
4425,4426,Marathahalli,168250,52860,115390,0.6858246656760772,0
4426,4427,Vasanth Nagar,210050,47240,162810,0.775101166388955,0
4427,4428,Kalyan Nagar,73250,110600,-37350,-0.5098976109215017,1
4428,4429,Kalyan Nagar,247300,73370,173930,0.7033158107561666,0
4429,4430,Horamavu,151500,62920,88580,0.5846864686468647,0
4430,4431,Indiranagar,166700,76240,90460,0.5426514697060588,0
4431,4432,Vasanth Nagar,134400,63390,71010,0.5283482142857143,0
4432,4433,Vasanth Nagar,244550,104420,140130,0.5730116540584748,0
4433,4434,Marathahalli,121150,8720,112430,0.9280231118448204,-1
4434,4435,Horamavu,245850,69640,176210,0.7167378482814725,0
4435,4436,Whitefield,398050,19070,378980,0.9520914457982665,-1
4436,4437,Krishnarajapuram,83650,47280,36370,0.4347878063359235,1
4437,4438,Banaswadi,149150,100800,48350,0.3241702983573584,1
4438,4439,Rajajinagar,266750,90040,176710,0.6624554826616682,0
4439,4440,Shivajinagar,310500,147460,163040,0.5250885668276972,0
4440,4441,Vasanth Nagar,357750,50800,306950,0.8580013976240392,-1
4441,4442,Marathahalli,44900,131000,-86100,-1.9175946547884186,1
4442,4443,Krishnarajapuram,35800,157210,-121410,-3.391340782122905,1
4443,4444,Horamavu,259550,83510,176040,0.6782508187247158,0
4444,4445,HBR Layout,131800,53410,78390,0.5947647951441578,0
4445,4446,Malleswaram,216300,89750,126550,0.5850670365233472,0
4446,4447,Horamavu,232500,88350,144150,0.62,0
4447,4448,Hebbal,126100,92210,33890,0.26875495638382235,1
4448,4449,Whitefield,119200,76290,42910,0.3599832214765101,1
4449,4450,Varthur,232450,94380,138070,0.59397719939772,0
4450,4451,CV Raman Nagar,309650,23410,286240,0.9243985144518004,-1
4451,4452,Varthur,341700,44740,296960,0.8690664325431665,-1
4452,4453,Krishnarajapuram,367350,80400,286950,0.7811351572070233,0
4453,4454,Marathahalli,343150,62130,281020,0.8189421535771528,-1
4454,4455,CV Raman Nagar,421250,110590,310660,0.7374718100890207,0
4455,4456,Vasanth Nagar,39650,64800,-25150,-0.6343001261034048,1
4456,4457,Krishnarajapuram,373000,23780,349220,0.9362466487935657,-1
4457,4458,Kalyan Nagar,65600,100460,-34860,-0.5314024390243902,1
4458,4459,CV Raman Nagar,188550,119850,68700,0.3643595863166269,1
4459,4460,Varthur,47500,16640,30860,0.6496842105263158,0
4460,4461,Marathahalli,247700,47010,200690,0.8102139685102947,-1
4461,4462,Banaswadi,120400,18870,101530,0.8432724252491695,-1
4462,4463,Horamavu,326100,33470,292630,0.8973627721557804,-1
4463,4464,Vasanth Nagar,128350,52260,76090,0.5928320997273081,0
4464,4465,Shivajinagar,178850,85680,93170,0.5209393346379648,0
4465,4466,Rajajinagar,328550,58570,269980,0.8217318520773094,-1
4466,4467,Vasanth Nagar,141150,61970,79180,0.5609635139922069,0
4467,4468,Marathahalli,329150,105860,223290,0.6783837156311712,0
4468,4469,Malleswaram,290900,49800,241100,0.8288071502234445,-1
4469,4470,Hoodi,246550,94860,151690,0.6152504562968972,0
4470,4471,Vasanth Nagar,124150,95850,28300,0.22795006041079338,1
4471,4472,Malleswaram,64500,75820,-11320,-0.17550387596899225,1
4472,4473,Indiranagar,224050,62180,161870,0.7224726623521536,0
4473,4474,Shivajinagar,239600,24370,215230,0.898288814691152,-1
4474,4475,Banaswadi,304750,83840,220910,0.7248892534864643,0
4475,4476,Rajajinagar,28250,61660,-33410,-1.1826548672566373,1
4476,4477,Jalahalli,46300,44100,2200,0.047516198704103674,1
4477,4478,Hebbal,266050,37690,228360,0.8583348994549896,-1
4478,4479,Rajajinagar,86300,16250,70050,0.8117033603707995,-1
4479,4480,Hebbal,268450,68400,200050,0.7452039485937791,0
4480,4481,Kalyan Nagar,54650,38920,15730,0.2878316559926807,1
4481,4482,Hebbal,96400,44820,51580,0.5350622406639004,0
4482,4483,Vasanth Nagar,43600,61460,-17860,-0.4096330275229358,1
4483,4484,HBR Layout,294500,34630,259870,0.8824108658743633,-1
4484,4485,Whitefield,202000,38810,163190,0.8078712871287129,-1
4485,4486,HBR Layout,311300,111130,200170,0.6430131705750081,0
4486,4487,Rajajinagar,131000,44780,86220,0.6581679389312977,0
4487,4488,Whitefield,88650,106130,-17480,-0.19717992103778906,1
4488,4489,Jalahalli,241750,57670,184080,0.7614477766287487,0
4489,4490,Banaswadi,404350,90170,314180,0.7770001236552492,0
4490,4491,Jalahalli,247600,56950,190650,0.7699919224555735,0
4491,4492,Vasanth Nagar,34000,60470,-26470,-0.7785294117647059,1
4492,4493,Shivajinagar,128950,66970,61980,0.48065141527723926,1
4493,4494,Rajajinagar,149150,61420,87730,0.5881997988602078,0
4494,4495,Shivajinagar,169750,95540,74210,0.4371723122238586,1
4495,4496,Whitefield,210450,93530,116920,0.5555713946305536,0
4496,4497,Rajajinagar,293100,70500,222600,0.759467758444217,0
4497,4498,Rajajinagar,65850,60330,5520,0.08382687927107062,1
4498,4499,Banaswadi,73200,47880,25320,0.34590163934426227,1
4499,4500,HBR Layout,397850,66560,331290,0.8327007666205857,-1
4500,4501,Jalahalli,107950,66320,41630,0.3856415006947661,1
4501,4502,Jalahalli,303800,9240,294560,0.9695852534562212,-1
4502,4503,HBR Layout,369900,63430,306470,0.8285212219518789,-1
4503,4504,CV Raman Nagar,353000,79700,273300,0.7742209631728045,0
4504,4505,Kammanahalli,70150,37930,32220,0.4593014967925873,1
4505,4506,Hoodi,392150,72850,319300,0.8142292490118577,-1
4506,4507,Indiranagar,205850,87810,118040,0.57342725285402,0
4507,4508,HBR Layout,385900,31350,354550,0.9187613371339726,-1
4508,4509,Vasanth Nagar,57850,93110,-35260,-0.6095073465859983,1
4509,4510,Hebbal,174200,95760,78440,0.45028702640642937,1
4510,4511,Kalyan Nagar,72850,124470,-51620,-0.7085792724776939,1
4511,4512,Kalyan Nagar,229350,34680,194670,0.8487900588620013,-1
4512,4513,Kalyan Nagar,34600,89280,-54680,-1.5803468208092486,1
4513,4514,Varthur,413550,31340,382210,0.924217144238907,-1
4514,4515,Kammanahalli,449750,87720,362030,0.804958310172318,-1
4515,4516,Whitefield,348800,58820,289980,0.8313646788990826,-1
4516,4517,Horamavu,117250,35520,81730,0.6970575692963753,0
4517,4518,Whitefield,302550,67390,235160,0.7772599570318955,0
4518,4519,Horamavu,423050,43520,379530,0.8971279990544853,-1
4519,4520,Mahadevapura,424150,95310,328840,0.7752917599905694,0
4520,4521,Malleswaram,344650,38150,306500,0.8893079936167126,-1
4521,4522,Whitefield,61400,78560,-17160,-0.27947882736156354,1
4522,4523,Indiranagar,207950,24300,183650,0.8831449867756672,-1
4523,4524,Rajajinagar,425500,12200,413300,0.9713278495887192,-1
4524,4525,Krishnarajapuram,42000,91610,-49610,-1.1811904761904761,1
4525,4526,Kammanahalli,229150,57830,171320,0.747632555094916,0
4526,4527,Kammanahalli,375700,58420,317280,0.8445035932925207,-1
4527,4528,Kalyan Nagar,278250,78760,199490,0.7169451931716083,0
4528,4529,Horamavu,226750,74840,151910,0.6699448732083793,0
4529,4530,Malleswaram,190600,33940,156660,0.8219307450157398,-1
4530,4531,Horamavu,64650,29030,35620,0.5509667440061872,0
4531,4532,Varthur,51250,132550,-81300,-1.5863414634146342,1
4532,4533,Varthur,215600,32610,182990,0.848747680890538,-1
4533,4534,Kammanahalli,146100,23830,122270,0.836892539356605,-1
4534,4535,Kalyan Nagar,361650,99390,262260,0.7251762754043966,0
4535,4536,Whitefield,299700,17250,282450,0.9424424424424425,-1
4536,4537,Indiranagar,441850,81450,360400,0.8156614235600317,-1
4537,4538,Whitefield,331550,5140,326410,0.9844970592670789,-1
4538,4539,Varthur,73750,32220,41530,0.5631186440677967,0
4539,4540,Hoodi,283000,51670,231330,0.8174204946996466,-1
4540,4541,Kalyan Nagar,57650,54070,3580,0.06209887250650477,1
4541,4542,Banaswadi,76300,78880,-2580,-0.03381389252948886,1
4542,4543,Indiranagar,328850,62680,266170,0.8093963813288734,-1
4543,4544,Vasanth Nagar,173900,39370,134530,0.7736055204140311,0
4544,4545,Rajajinagar,77450,30170,47280,0.610458360232408,0
4545,4546,Indiranagar,144500,33250,111250,0.7698961937716263,0
4546,4547,Mahadevapura,304950,10650,294300,0.9650762420068864,-1
4547,4548,Hoodi,83250,33440,49810,0.5983183183183183,0
4548,4549,HBR Layout,295350,46270,249080,0.8433384120534958,-1
4549,4550,Hoodi,35250,40210,-4960,-0.14070921985815601,1
4550,4551,Varthur,83100,74900,8200,0.098676293622142,1
4551,4552,Shivajinagar,319050,78940,240110,0.7525779658360758,0
4552,4553,Rajajinagar,102850,94170,8680,0.08439474963539134,1
4553,4554,Rajajinagar,77300,81600,-4300,-0.055627425614489,1
4554,4555,Mahadevapura,295900,64180,231720,0.7831023994592767,0
4555,4556,Vasanth Nagar,272400,37070,235330,0.863913362701909,-1
4556,4557,Kammanahalli,149200,22910,126290,0.8464477211796246,-1
4557,4558,Jalahalli,231950,36360,195590,0.843242078034059,-1
4558,4559,Kalyan Nagar,181000,76820,104180,0.5755801104972376,0
4559,4560,HBR Layout,318600,34800,283800,0.8907721280602636,-1
4560,4561,Rajajinagar,369050,22820,346230,0.9381655602221921,-1
4561,4562,Horamavu,308150,41950,266200,0.8638650008112932,-1
4562,4563,HBR Layout,336700,43050,293650,0.8721413721413721,-1
4563,4564,Jalahalli,44650,46370,-1720,-0.038521836506159014,1
4564,4565,Mahadevapura,428950,39320,389630,0.9083343046975172,-1
4565,4566,Vasanth Nagar,423950,67120,356830,0.8416794433305814,-1
4566,4567,Krishnarajapuram,241950,26500,215450,0.8904732382723703,-1
4567,4568,Kammanahalli,326200,45380,280820,0.8608828939301042,-1
4568,4569,Shivajinagar,413750,65610,348140,0.8414259818731118,-1
4569,4570,Mahadevapura,328750,70040,258710,0.7869505703422053,0
4570,4571,Jalahalli,410600,48640,361960,0.8815392109108622,-1
4571,4572,Mahadevapura,174500,22210,152290,0.8727220630372493,-1
4572,4573,Kalyan Nagar,273600,31320,242280,0.8855263157894737,-1
4573,4574,Marathahalli,372450,100540,271910,0.7300577258692442,0
4574,4575,Hoodi,132050,116590,15460,0.11707686482393033,1
4575,4576,Varthur,325300,66390,258910,0.7959114663387642,0
4576,4577,Varthur,412450,49470,362980,0.8800581888713783,-1
4577,4578,Varthur,92400,72040,20360,0.22034632034632035,1
4578,4579,CV Raman Nagar,285300,86860,198440,0.6955485453908167,0
4579,4580,Marathahalli,309550,80180,229370,0.7409788402519787,0
4580,4581,Shivajinagar,240400,31650,208750,0.8683444259567388,-1
4581,4582,Vasanth Nagar,401000,58470,342530,0.8541895261845387,-1
4582,4583,Whitefield,204400,35250,169150,0.8275440313111546,-1
4583,4584,Malleswaram,342750,62340,280410,0.8181181619256017,-1
4584,4585,Mahadevapura,200950,7900,193050,0.960686737994526,-1
4585,4586,Kammanahalli,281350,32990,248360,0.8827439132752799,-1
4586,4587,Hoodi,250600,79740,170860,0.6818036711891461,0
4587,4588,Horamavu,319300,84710,234590,0.7347009082367679,0
4588,4589,HBR Layout,189200,46600,142600,0.7536997885835095,0
4589,4590,CV Raman Nagar,112000,72070,39930,0.35651785714285716,1
4590,4591,Mahadevapura,362650,25380,337270,0.9300151661381497,-1
4591,4592,Kammanahalli,421950,44560,377390,0.8943950705059841,-1
4592,4593,Hebbal,353750,121970,231780,0.6552084805653711,0
4593,4594,Hebbal,122600,18900,103700,0.8458401305057096,-1
4594,4595,Vasanth Nagar,124900,63210,61690,0.49391513210568455,1
4595,4596,Krishnarajapuram,444000,49850,394150,0.8877252252252252,-1
4596,4597,Whitefield,72550,85170,-12620,-0.17394900068917987,1
4597,4598,Horamavu,295400,136610,158790,0.5375423155044008,0
4598,4599,HBR Layout,420550,9050,411500,0.9784805611698966,-1
4599,4600,Marathahalli,386600,59120,327480,0.8470770822555613,-1
4600,4601,Krishnarajapuram,411700,52970,358730,0.8713383531697838,-1
4601,4602,Banaswadi,124300,88690,35610,0.28648431214802894,1
4602,4603,Krishnarajapuram,310500,64840,245660,0.7911755233494364,0
4603,4604,Krishnarajapuram,375050,46570,328480,0.8758298893480869,-1
4604,4605,Hebbal,99400,69440,29960,0.30140845070422534,1
4605,4606,Jalahalli,404700,47770,356930,0.8819619471213245,-1
4606,4607,Banaswadi,226400,61980,164420,0.7262367491166077,0
4607,4608,Krishnarajapuram,412800,58340,354460,0.858672480620155,-1
4608,4609,Whitefield,35450,27450,8000,0.22566995768688294,1
4609,4610,Banaswadi,128050,59990,68060,0.5315111284654432,0
4610,4611,Kammanahalli,328000,143970,184030,0.5610670731707317,0
4611,4612,Kammanahalli,360550,61710,298840,0.8288448204132576,-1
4612,4613,Marathahalli,258200,84530,173670,0.6726181254841208,0
4613,4614,CV Raman Nagar,204200,127060,77140,0.37776689520078355,1
4614,4615,Krishnarajapuram,324300,83270,241030,0.743231575701511,0
4615,4616,CV Raman Nagar,164550,86540,78010,0.4740808264965056,1
4616,4617,Mahadevapura,371850,13310,358540,0.964205997041818,-1
4617,4618,Indiranagar,397450,39470,357980,0.9006919109321927,-1
4618,4619,Kammanahalli,166100,24240,141860,0.8540638169777243,-1
4619,4620,Vasanth Nagar,266500,10410,256090,0.96093808630394,-1
4620,4621,Jalahalli,103050,103710,-660,-0.006404657933042212,1
4621,4622,Hoodi,126650,28950,97700,0.7714172917489144,0
4622,4623,Horamavu,409700,65340,344360,0.8405174517939956,-1
4623,4624,Rajajinagar,143700,88300,55400,0.38552540013917885,1
4624,4625,CV Raman Nagar,289850,68690,221160,0.7630153527686735,0
4625,4626,Kalyan Nagar,72350,57330,15020,0.20760193503800967,1
4626,4627,Kalyan Nagar,254300,99310,154990,0.6094769956744003,0
4627,4628,Kammanahalli,42250,11950,30300,0.7171597633136094,0
4628,4629,Hebbal,166950,74730,92220,0.5523809523809524,0
4629,4630,Hebbal,277150,138710,138440,0.4995128991520837,1
4630,4631,Vasanth Nagar,121500,68360,53140,0.43736625514403293,1
4631,4632,HBR Layout,297550,80930,216620,0.7280120988069232,0
4632,4633,Krishnarajapuram,424000,72560,351440,0.8288679245283019,-1
4633,4634,Varthur,160550,67140,93410,0.5818125194643413,0
4634,4635,Kammanahalli,46950,26550,20400,0.43450479233226835,1
4635,4636,Banaswadi,420700,89200,331500,0.7879724269075351,0
4636,4637,Hebbal,178250,134650,43600,0.24460028050490884,1
4637,4638,Krishnarajapuram,258850,109100,149750,0.5785203785976434,0
4638,4639,Vasanth Nagar,223000,47570,175430,0.7866816143497758,0
4639,4640,HBR Layout,415500,13890,401610,0.9665703971119134,-1
4640,4641,Horamavu,304900,99250,205650,0.6744834371925221,0
4641,4642,Banaswadi,282500,90540,191960,0.679504424778761,0
4642,4643,Banaswadi,430100,23970,406130,0.9442687747035573,-1
4643,4644,Rajajinagar,436700,101590,335110,0.7673689031371651,0
4644,4645,Malleswaram,259700,74260,185440,0.7140546784751637,0
4645,4646,Jalahalli,321100,76190,244910,0.7627218934911243,0
4646,4647,Jalahalli,81300,119780,-38480,-0.47330873308733085,1
4647,4648,Vasanth Nagar,340100,79920,260180,0.7650102910908556,0
4648,4649,Shivajinagar,432400,55680,376720,0.8712303422756706,-1
4649,4650,Jalahalli,29200,39680,-10480,-0.3589041095890411,1
4650,4651,Kalyan Nagar,366550,64170,302380,0.8249352066566635,-1
4651,4652,Jalahalli,334050,53550,280500,0.8396946564885496,-1
4652,4653,Jalahalli,343800,46940,296860,0.8634671320535194,-1
4653,4654,Mahadevapura,347600,119830,227770,0.6552646720368239,0
4654,4655,Horamavu,123850,37410,86440,0.6979410577311264,0
4655,4656,Varthur,231350,55820,175530,0.7587205532742598,0
4656,4657,Marathahalli,239750,55400,184350,0.7689259645464025,0
4657,4658,Horamavu,36750,92370,-55620,-1.513469387755102,1
4658,4659,Varthur,431650,61010,370640,0.8586586354685509,-1
4659,4660,Varthur,251100,106790,144310,0.5747112704101951,0
4660,4661,Varthur,423900,32400,391500,0.9235668789808917,-1
4661,4662,Varthur,336750,31540,305210,0.9063400148478099,-1
4662,4663,Banaswadi,138700,44160,94540,0.6816149963950974,0
4663,4664,CV Raman Nagar,261150,76290,184860,0.7078690407811603,0
4664,4665,Jalahalli,299450,56280,243170,0.8120554349641008,-1
4665,4666,Hoodi,317200,1740,315460,0.9945145018915511,-1
4666,4667,Indiranagar,234100,36550,197550,0.8438701409653994,-1
4667,4668,Jalahalli,28350,64720,-36370,-1.2828924162257496,1
4668,4669,Horamavu,169200,17710,151490,0.8953309692671395,-1
4669,4670,Varthur,172650,72260,100390,0.581465392412395,0
4670,4671,Kalyan Nagar,153350,74910,78440,0.5115096185197261,0
4671,4672,Malleswaram,327300,40450,286850,0.8764130766880538,-1
4672,4673,Varthur,386750,58310,328440,0.8492307692307692,-1
4673,4674,Marathahalli,419850,89380,330470,0.7871144456353459,0
4674,4675,Horamavu,260950,14340,246610,0.9450469438589768,-1
4675,4676,Marathahalli,377200,60120,317080,0.8406150583244962,-1
4676,4677,Mahadevapura,50500,14940,35560,0.7041584158415841,0
4677,4678,Whitefield,123100,75980,47120,0.3827782290820471,1
4678,4679,Hoodi,373200,80120,293080,0.7853161843515541,0
4679,4680,Indiranagar,37050,72970,-35920,-0.9695006747638326,1
4680,4681,Jalahalli,332450,60380,272070,0.8183787035644458,-1
4681,4682,Varthur,253450,62250,191200,0.7543894259222726,0
4682,4683,Malleswaram,444050,53370,390680,0.8798108321135008,-1
4683,4684,Horamavu,359700,54360,305340,0.8488740617180984,-1
4684,4685,Whitefield,61900,48640,13260,0.21421647819063006,1
4685,4686,Horamavu,332650,54480,278170,0.8362242597324515,-1
4686,4687,Horamavu,330850,28810,302040,0.9129212634124225,-1
4687,4688,Horamavu,217100,71870,145230,0.6689543988945187,0
4688,4689,Banaswadi,231700,64460,167240,0.721795425118688,0
4689,4690,Jalahalli,375650,0,375650,1.0,-1
4690,4691,Indiranagar,108300,24360,83940,0.7750692520775623,0
4691,4692,CV Raman Nagar,264500,102150,162350,0.6137996219281664,0
4692,4693,Hebbal,278250,63270,214980,0.7726145552560647,0
4693,4694,Jalahalli,121050,70060,50990,0.42123089632383315,1
4694,4695,Shivajinagar,290950,54360,236590,0.8131637738443032,-1
4695,4696,Krishnarajapuram,61800,18690,43110,0.6975728155339805,0
4696,4697,CV Raman Nagar,318250,46670,271580,0.8533542812254516,-1
4697,4698,Kammanahalli,349950,47280,302670,0.8648949849978569,-1
4698,4699,Horamavu,329850,67910,261940,0.7941185387297256,0
4699,4700,Shivajinagar,121750,105870,15880,0.1304312114989733,1
4700,4701,Hebbal,37650,104390,-66740,-1.7726427622841965,1
4701,4702,Jalahalli,85900,53440,32460,0.3778812572759022,1
4702,4703,Whitefield,359050,47780,311270,0.8669266118924941,-1
4703,4704,Rajajinagar,245050,30450,214600,0.8757396449704142,-1
4704,4705,Kammanahalli,343400,55270,288130,0.8390506697728597,-1
4705,4706,Kalyan Nagar,305400,84240,221160,0.7241650294695481,0
4706,4707,Hoodi,228400,65050,163350,0.7151926444833625,0
4707,4708,Varthur,271150,95620,175530,0.6473538631753641,0
4708,4709,CV Raman Nagar,275250,56150,219100,0.7960036330608538,0
4709,4710,Krishnarajapuram,54150,144670,-90520,-1.6716528162511541,1
4710,4711,Shivajinagar,269550,48500,221050,0.8200704878501206,-1
4711,4712,CV Raman Nagar,309500,39370,270130,0.872794830371567,-1
4712,4713,HBR Layout,343700,21300,322400,0.9380273494326448,-1
4713,4714,Horamavu,92050,54570,37480,0.4071700162954916,1
4714,4715,Vasanth Nagar,34200,58730,-24530,-0.7172514619883041,1
4715,4716,Marathahalli,50300,130850,-80550,-1.6013916500994037,1
4716,4717,Hoodi,444300,34140,410160,0.9231600270087779,-1
4717,4718,Kalyan Nagar,38600,56410,-17810,-0.46139896373056993,1
4718,4719,Horamavu,202250,89140,113110,0.5592583436341162,0
4719,4720,CV Raman Nagar,158600,125590,33010,0.20813366960907945,1
4720,4721,Vasanth Nagar,110100,79300,30800,0.27974568574023617,1
4721,4722,HBR Layout,277600,70430,207170,0.7462896253602306,0
4722,4723,Shivajinagar,352050,30660,321390,0.9129100979974435,-1
4723,4724,Mahadevapura,87500,55570,31930,0.3649142857142857,1
4724,4725,Whitefield,442300,25390,416910,0.942595523400407,-1
4725,4726,Krishnarajapuram,114400,59390,55010,0.48085664335664335,1
4726,4727,Malleswaram,205150,43980,161170,0.7856202778454789,0
4727,4728,Kammanahalli,89350,66890,22460,0.25137101287073305,1
4728,4729,Hoodi,292900,48010,244890,0.8360874018436326,-1
4729,4730,Krishnarajapuram,407700,47400,360300,0.88373804267844,-1
4730,4731,CV Raman Nagar,437800,72290,365510,0.834878940155322,-1
4731,4732,Rajajinagar,396650,155980,240670,0.6067565864111938,0
4732,4733,Vasanth Nagar,189350,0,189350,1.0,-1
4733,4734,Vasanth Nagar,432750,19980,412770,0.9538301559792027,-1
4734,4735,Hoodi,315900,53500,262400,0.8306426084203862,-1
4735,4736,Malleswaram,184700,48160,136540,0.7392528424472117,0
4736,4737,Horamavu,397900,74650,323250,0.8123900477506911,-1
4737,4738,Vasanth Nagar,372150,71000,301150,0.8092167136907161,-1
4738,4739,Hebbal,438200,78570,359630,0.8206983112733911,-1
4739,4740,Horamavu,204200,61770,142430,0.6975024485798237,0
4740,4741,Kammanahalli,96650,30590,66060,0.6834971546818417,0
4741,4742,Kammanahalli,166450,56560,109890,0.6601982577350556,0
4742,4743,Marathahalli,251750,36570,215180,0.8547368421052631,-1
4743,4744,Kalyan Nagar,278750,71600,207150,0.7431390134529148,0
4744,4745,Shivajinagar,172650,42900,129750,0.7515204170286707,0
4745,4746,Mahadevapura,185350,97300,88050,0.47504720798489347,1
4746,4747,Kammanahalli,219050,118480,100570,0.4591189226204063,1
4747,4748,Marathahalli,30950,131430,-100480,-3.2465266558966075,1
4748,4749,Hebbal,257800,92670,165130,0.6405352986811482,0
4749,4750,Kalyan Nagar,225100,70400,154700,0.6872501110617504,0
4750,4751,Indiranagar,442400,104020,338380,0.764873417721519,0
4751,4752,Kammanahalli,342200,26210,315990,0.9234073641145529,-1
4752,4753,Indiranagar,228500,56370,172130,0.7533041575492342,0
4753,4754,Banaswadi,380500,29430,351070,0.9226544021024967,-1
4754,4755,Malleswaram,149350,68810,80540,0.5392701707398728,0
4755,4756,Hebbal,150050,22570,127480,0.8495834721759413,-1
4756,4757,Horamavu,113050,42050,71000,0.6280406899601946,0
4757,4758,Kalyan Nagar,409150,53150,356000,0.8700965416106562,-1
4758,4759,Jalahalli,272650,116360,156290,0.5732257472950669,0
4759,4760,Kammanahalli,281800,35050,246750,0.8756210078069553,-1
4760,4761,Shivajinagar,199200,29830,169370,0.8502510040160642,-1
4761,4762,Kalyan Nagar,385200,44880,340320,0.8834890965732087,-1
4762,4763,Hebbal,139700,70050,69650,0.4985683607730852,1
4763,4764,Horamavu,363300,34680,328620,0.904541701073493,-1
4764,4765,Whitefield,40050,62440,-22390,-0.5590511860174782,1
4765,4766,Mahadevapura,384150,14490,369660,0.9622803592346739,-1
4766,4767,Horamavu,357050,67940,289110,0.8097185268169724,-1
4767,4768,CV Raman Nagar,101150,70840,30310,0.2996539792387543,1
4768,4769,Varthur,380550,32250,348300,0.9152542372881356,-1
4769,4770,Indiranagar,138050,74330,63720,0.461571894241217,1
4770,4771,HBR Layout,247850,49880,197970,0.7987492434940489,0
4771,4772,Rajajinagar,388950,117850,271100,0.6970047563954236,0
4772,4773,Indiranagar,140700,8910,131790,0.9366737739872069,-1
4773,4774,Indiranagar,399250,84460,314790,0.7884533500313087,0
4774,4775,Krishnarajapuram,389650,76120,313530,0.8046451944052355,-1
4775,4776,Horamavu,27500,109950,-82450,-2.998181818181818,1
4776,4777,Hebbal,424750,51050,373700,0.8798116539140671,-1
4777,4778,Varthur,264600,51870,212730,0.803968253968254,-1
4778,4779,Rajajinagar,157850,39790,118060,0.7479252454862211,0
4779,4780,Banaswadi,51650,75510,-23860,-0.46195546950629235,1
4780,4781,Marathahalli,96600,29730,66870,0.6922360248447205,0
4781,4782,Whitefield,265050,67860,197190,0.7439728353140916,0
4782,4783,Whitefield,65400,10740,54660,0.8357798165137614,-1
4783,4784,Marathahalli,383450,94140,289310,0.7544921110966227,0
4784,4785,Marathahalli,334850,114620,220230,0.6576974764820068,0
4785,4786,Banaswadi,168500,35240,133260,0.7908605341246291,0
4786,4787,Hebbal,280400,26830,253570,0.9043152639087019,-1
4787,4788,Varthur,348500,37770,310730,0.8916212338593974,-1
4788,4789,HBR Layout,81300,100260,-18960,-0.23321033210332104,1
4789,4790,Jalahalli,324750,127200,197550,0.6083140877598152,0
4790,4791,Mahadevapura,125800,25720,100080,0.7955484896661367,0
4791,4792,Whitefield,32650,99970,-67320,-2.0618683001531393,1
4792,4793,Krishnarajapuram,78200,70670,7530,0.09629156010230179,1
4793,4794,CV Raman Nagar,183200,37010,146190,0.7979803493449782,0
4794,4795,Marathahalli,222850,61320,161530,0.7248373345299529,0
4795,4796,Horamavu,163050,40200,122850,0.7534498620055198,0
4796,4797,Krishnarajapuram,298700,70440,228260,0.7641781051221962,0
4797,4798,Kammanahalli,44700,37910,6790,0.15190156599552573,1
4798,4799,Varthur,137450,54990,82460,0.5999272462713714,0
4799,4800,Kammanahalli,446650,116130,330520,0.7399977611104892,0
4800,4801,Jalahalli,362650,55930,306720,0.8457741624155521,-1
4801,4802,Rajajinagar,376500,63220,313280,0.8320849933598937,-1
4802,4803,HBR Layout,251900,34750,217150,0.8620484319174275,-1
4803,4804,Hebbal,421900,97380,324520,0.7691870111400806,0
4804,4805,Hebbal,202000,65880,136120,0.6738613861386139,0
4805,4806,Malleswaram,84250,74430,9820,0.11655786350148369,1
4806,4807,Shivajinagar,357550,61310,296240,0.8285274786743113,-1
4807,4808,Vasanth Nagar,215450,38110,177340,0.8231144116964493,-1
4808,4809,Malleswaram,449450,36210,413240,0.9194348648347981,-1
4809,4810,Shivajinagar,307950,35210,272740,0.8856632570222439,-1
4810,4811,Indiranagar,291700,82770,208930,0.7162495714775454,0
4811,4812,HBR Layout,221500,51700,169800,0.7665914221218961,0
4812,4813,Vasanth Nagar,374200,56530,317670,0.8489310529128808,-1
4813,4814,Indiranagar,272000,60040,211960,0.779264705882353,0
4814,4815,Hoodi,242750,29960,212790,0.8765808444902162,-1
4815,4816,Jalahalli,282500,112600,169900,0.6014159292035398,0
4816,4817,Rajajinagar,278300,16060,262240,0.9422924901185771,-1
4817,4818,Shivajinagar,378600,59850,318750,0.8419175911251982,-1
4818,4819,HBR Layout,436650,77490,359160,0.8225352112676056,-1
4819,4820,Malleswaram,64300,37150,27150,0.42223950233281493,1
4820,4821,CV Raman Nagar,371500,75210,296290,0.797550471063257,0
4821,4822,Jalahalli,124550,25020,99530,0.7991168205539944,0
4822,4823,Banaswadi,421100,55760,365340,0.8675848966991213,-1
4823,4824,Kalyan Nagar,324750,18230,306520,0.9438645111624326,-1
4824,4825,Whitefield,63600,62000,1600,0.025157232704402517,1
4825,4826,Hoodi,165600,56670,108930,0.6577898550724638,0
4826,4827,Hoodi,140600,107990,32610,0.23193456614509247,1
4827,4828,Shivajinagar,211850,100140,111710,0.5273070568798678,0
4828,4829,Indiranagar,45550,36390,9160,0.20109769484083426,1
4829,4830,HBR Layout,256800,39600,217200,0.8457943925233645,-1
4830,4831,Malleswaram,387500,89370,298130,0.7693677419354839,0
4831,4832,Rajajinagar,426950,69710,357240,0.8367256118983487,-1
4832,4833,Jalahalli,292450,67830,224620,0.768062916737904,0
4833,4834,Kammanahalli,120050,45130,74920,0.624073302790504,0
4834,4835,Shivajinagar,230750,30970,199780,0.8657854821235103,-1
4835,4836,HBR Layout,191850,21140,170710,0.8898097471983321,-1
4836,4837,Kammanahalli,76550,54680,21870,0.28569562377531027,1
4837,4838,Mahadevapura,393200,74890,318310,0.8095371312309257,-1
4838,4839,Malleswaram,249050,64600,184450,0.7406143344709898,0
4839,4840,Hoodi,213850,46760,167090,0.7813420621931261,0
4840,4841,Rajajinagar,58300,59290,-990,-0.016981132075471698,1
4841,4842,Shivajinagar,76400,67330,9070,0.118717277486911,1
4842,4843,Varthur,384700,29580,355120,0.9231089160384716,-1
4843,4844,Indiranagar,30300,46550,-16250,-0.5363036303630363,1
4844,4845,Malleswaram,328050,108620,219430,0.6688919372046944,0
4845,4846,Vasanth Nagar,247800,67720,180080,0.7267150928167877,0
4846,4847,Horamavu,389050,72900,316150,0.8126204857987406,-1
4847,4848,Kalyan Nagar,374850,63760,311090,0.8299052954515139,-1
4848,4849,Kalyan Nagar,410900,112260,298640,0.7267948405938185,0
4849,4850,Marathahalli,172750,34840,137910,0.7983212735166425,0
4850,4851,Indiranagar,250050,68310,181740,0.7268146370725855,0
4851,4852,Banaswadi,49850,114290,-64440,-1.292678034102307,1
4852,4853,Horamavu,147950,53930,94020,0.6354849611355188,0
4853,4854,Rajajinagar,291650,76850,214800,0.7364992285273444,0
4854,4855,Shivajinagar,413400,48700,364700,0.8821964199322689,-1
4855,4856,Hoodi,211100,71100,140000,0.6631927996210327,0
4856,4857,Malleswaram,343500,125780,217720,0.6338282387190685,0
4857,4858,Hebbal,248500,111500,137000,0.5513078470824949,0
4858,4859,Krishnarajapuram,144200,114040,30160,0.20915395284327323,1
4859,4860,Indiranagar,31500,33780,-2280,-0.07238095238095238,1
4860,4861,Shivajinagar,197050,120830,76220,0.3868053793453438,1
4861,4862,Vasanth Nagar,184200,54150,130050,0.7060260586319218,0
4862,4863,Varthur,248450,111230,137220,0.552304286576776,0
4863,4864,Hebbal,321900,56710,265190,0.8238272755514134,-1
4864,4865,Indiranagar,285400,63810,221590,0.7764190609670638,0
4865,4866,Horamavu,374050,42030,332020,0.8876353428686005,-1
4866,4867,Kalyan Nagar,264850,54410,210440,0.7945629601661318,0
4867,4868,Mahadevapura,129900,81440,48460,0.3730561970746728,1
4868,4869,Shivajinagar,419150,80260,338890,0.8085172372658953,-1
4869,4870,Kammanahalli,346200,64920,281280,0.8124783362218371,-1
4870,4871,Banaswadi,428350,46590,381760,0.8912338041321349,-1
4871,4872,Krishnarajapuram,336750,53680,283070,0.8405939123979214,-1
4872,4873,Whitefield,180400,10720,169680,0.9405764966740576,-1
4873,4874,Kalyan Nagar,78900,63580,15320,0.194169835234474,1
4874,4875,Kammanahalli,392750,99420,293330,0.746861871419478,0
4875,4876,Banaswadi,431000,36820,394180,0.914570765661253,-1
4876,4877,Hoodi,209850,73640,136210,0.6490826781034071,0
4877,4878,Mahadevapura,216650,18120,198530,0.9163627971382414,-1
4878,4879,Vasanth Nagar,200300,31550,168750,0.8424862705941089,-1
4879,4880,Horamavu,202800,67070,135730,0.6692800788954635,0
4880,4881,Indiranagar,118750,36400,82350,0.6934736842105264,0
4881,4882,Vasanth Nagar,390150,33570,356580,0.9139561707035756,-1
4882,4883,Varthur,144300,68380,75920,0.5261261261261261,0
4883,4884,Marathahalli,99800,52020,47780,0.47875751503006014,1
4884,4885,CV Raman Nagar,194100,54570,139530,0.7188562596599691,0
4885,4886,Horamavu,59950,81470,-21520,-0.35896580483736445,1
4886,4887,Mahadevapura,423350,47470,375880,0.8878705562773119,-1
4887,4888,Marathahalli,255850,26790,229060,0.8952902091068986,-1
4888,4889,Whitefield,237150,49460,187690,0.7914400168669619,0
4889,4890,Kammanahalli,346200,6910,339290,0.9800404390525708,-1
4890,4891,Banaswadi,86400,68110,18290,0.2116898148148148,1
4891,4892,CV Raman Nagar,112550,32710,79840,0.7093736117281209,0
4892,4893,Kalyan Nagar,380350,81300,299050,0.7862495070329959,0
4893,4894,Malleswaram,252050,33470,218580,0.8672088871255703,-1
4894,4895,HBR Layout,153100,81730,71370,0.46616590463749186,1
4895,4896,Hebbal,274550,63770,210780,0.7677290111090876,0
4896,4897,Banaswadi,136900,64860,72040,0.5262235208181154,0
4897,4898,Jalahalli,106450,56490,49960,0.4693283231564115,1
4898,4899,Kalyan Nagar,349100,75990,273110,0.7823259810942423,0
4899,4900,Krishnarajapuram,349950,43820,306130,0.8747821117302472,-1
4900,4901,Kalyan Nagar,98750,25210,73540,0.7447088607594937,0
4901,4902,Rajajinagar,262950,41860,221090,0.8408062369271725,-1
4902,4903,Rajajinagar,69000,33050,35950,0.5210144927536232,0
4903,4904,Indiranagar,165900,89950,75950,0.4578059071729958,1
4904,4905,CV Raman Nagar,335500,106000,229500,0.684053651266766,0
4905,4906,Rajajinagar,90950,34620,56330,0.6193512919186366,0
4906,4907,Mahadevapura,274150,28950,245200,0.894400875433157,-1
4907,4908,Krishnarajapuram,336500,15040,321460,0.9553046062407132,-1
4908,4909,Varthur,275850,56770,219080,0.794199746238898,0
4909,4910,Varthur,348700,82350,266350,0.7638371092629768,0
4910,4911,HBR Layout,406000,40410,365590,0.9004679802955665,-1
4911,4912,Whitefield,120550,32160,88390,0.7332227291580257,0
4912,4913,Kammanahalli,224800,71140,153660,0.6835409252669039,0
4913,4914,Whitefield,402700,20820,381880,0.9482989818723616,-1
4914,4915,Hoodi,82800,95730,-12930,-0.15615942028985508,1
4915,4916,Rajajinagar,252950,59080,193870,0.7664360545562364,0
4916,4917,Mahadevapura,334150,54420,279730,0.8371390094269041,-1
4917,4918,Varthur,379400,59250,320150,0.8438323668950976,-1
4918,4919,Horamavu,116100,100060,16040,0.13815676141257538,1
4919,4920,Hebbal,267900,67680,200220,0.7473684210526316,0
4920,4921,Shivajinagar,210950,32780,178170,0.8446077269495141,-1
4921,4922,Whitefield,149200,103540,45660,0.30603217158176943,1
4922,4923,Hebbal,293950,66910,227040,0.7723762544650451,0
4923,4924,Whitefield,261000,32980,228020,0.873639846743295,-1
4924,4925,Kammanahalli,366250,32860,333390,0.9102798634812287,-1
4925,4926,Rajajinagar,249750,127850,121900,0.48808808808808807,1
4926,4927,Kalyan Nagar,418300,33360,384940,0.9202486253884772,-1
4927,4928,Krishnarajapuram,205150,84050,121100,0.5902997806483061,0
4928,4929,Shivajinagar,117500,108000,9500,0.08085106382978724,1
4929,4930,Varthur,46400,64810,-18410,-0.39676724137931035,1
4930,4931,Indiranagar,267200,9060,258140,0.9660928143712575,-1
4931,4932,Hebbal,132700,164690,-31990,-0.2410700828937453,1
4932,4933,Banaswadi,215350,44340,171010,0.7941026236359415,0
4933,4934,HBR Layout,178300,34470,143830,0.8066741446999439,-1
4934,4935,Krishnarajapuram,227900,42950,184950,0.8115401491882405,-1
4935,4936,Whitefield,257500,79660,177840,0.6906407766990291,0
4936,4937,Vasanth Nagar,153100,54180,98920,0.6461136512083605,0
4937,4938,Marathahalli,94950,23810,71140,0.7492364402317009,0
4938,4939,Banaswadi,310800,33840,276960,0.8911196911196911,-1
4939,4940,CV Raman Nagar,89700,137830,-48130,-0.5365663322185061,1
4940,4941,Malleswaram,27150,73130,-45980,-1.6935543278084715,1
4941,4942,Shivajinagar,433400,108810,324590,0.7489386248269497,0
4942,4943,CV Raman Nagar,398500,44140,354360,0.8892346298619824,-1
4943,4944,Jalahalli,285900,45520,240380,0.8407834907310249,-1
4944,4945,Horamavu,409800,53490,356310,0.8694729136163982,-1
4945,4946,Varthur,92950,2640,90310,0.9715976331360947,-1
4946,4947,Whitefield,77650,56880,20770,0.26748229233741144,1
4947,4948,Shivajinagar,79300,10150,69150,0.8720050441361917,-1
4948,4949,Jalahalli,83850,100540,-16690,-0.19904591532498508,1
4949,4950,Hoodi,250500,63760,186740,0.7454690618762475,0
4950,4951,Hoodi,126700,50900,75800,0.5982636148382005,0
4951,4952,Krishnarajapuram,395700,80760,314940,0.7959059893858984,0
4952,4953,Banaswadi,408100,71040,337060,0.8259250183778486,-1
4953,4954,CV Raman Nagar,152200,16000,136200,0.8948751642575559,-1
4954,4955,Indiranagar,319100,107700,211400,0.6624882481980571,0
4955,4956,Indiranagar,277700,30470,247230,0.8902772776377386,-1
4956,4957,Horamavu,264450,79800,184650,0.6982416335791265,0
4957,4958,Indiranagar,125650,57850,67800,0.5395941106247513,0
4958,4959,Jalahalli,294000,73590,220410,0.7496938775510205,0
4959,4960,Varthur,370900,113900,257000,0.6929091399299002,0
4960,4961,Indiranagar,90650,10520,80130,0.8839492553778268,-1
4961,4962,Rajajinagar,108100,62040,46060,0.4260869565217391,1
4962,4963,CV Raman Nagar,331900,2930,328970,0.9911720397710153,-1
4963,4964,Krishnarajapuram,183400,115390,68010,0.3708287895310796,1
4964,4965,Malleswaram,288600,37670,250930,0.8694733194733195,-1
4965,4966,Marathahalli,40100,31400,8700,0.2169576059850374,1
4966,4967,Malleswaram,288950,79140,209810,0.7261117840456827,0
4967,4968,Jalahalli,244000,16210,227790,0.9335655737704918,-1
4968,4969,Banaswadi,105400,69140,36260,0.34402277039848195,1
4969,4970,Indiranagar,385650,106500,279150,0.7238428626993387,0
4970,4971,Kalyan Nagar,397300,26640,370660,0.9329473949156808,-1
4971,4972,Hebbal,439450,53560,385890,0.8781203777449084,-1
4972,4973,Horamavu,99550,183070,-83520,-0.8389753892516324,1
4973,4974,Whitefield,46700,46500,200,0.004282655246252677,1
4974,4975,Marathahalli,209650,16760,192890,0.9200572382542332,-1
4975,4976,Varthur,235050,31630,203420,0.8654328866198681,-1
4976,4977,Mahadevapura,317750,55110,262640,0.8265617623918174,-1
4977,4978,Banaswadi,258550,45740,212810,0.8230903113517695,-1
4978,4979,Malleswaram,301400,30400,271000,0.8991373589913736,-1
4979,4980,Jalahalli,141550,50720,90830,0.641681384669728,0
4980,4981,Indiranagar,27500,83420,-55920,-2.0334545454545454,1
4981,4982,CV Raman Nagar,78050,85580,-7530,-0.09647661755285074,1
4982,4983,Krishnarajapuram,299350,84470,214880,0.7178219475530315,0
4983,4984,Malleswaram,360850,70810,290040,0.8037688790356103,-1
4984,4985,HBR Layout,280850,50450,230400,0.8203667438134236,-1
4985,4986,Kalyan Nagar,391300,108820,282480,0.721901354459494,0
4986,4987,Vasanth Nagar,51200,23280,27920,0.5453125,0
4987,4988,Malleswaram,133100,118310,14790,0.11111945905334335,1
4988,4989,Krishnarajapuram,209100,77430,131670,0.6296987087517933,0
4989,4990,Rajajinagar,210750,87590,123160,0.5843890865954923,0
4990,4991,CV Raman Nagar,34100,52930,-18830,-0.5521994134897361,1
4991,4992,Krishnarajapuram,432500,39430,393070,0.9088323699421965,-1
4992,4993,Varthur,87000,63340,23660,0.27195402298850574,1
4993,4994,Mahadevapura,256500,71410,185090,0.721598440545809,0
4994,4995,Hoodi,331600,25130,306470,0.9242159227985525,-1
4995,4996,Vasanth Nagar,210250,104320,105930,0.5038287752675387,0
4996,4997,Rajajinagar,401500,70840,330660,0.8235616438356165,-1
4997,4998,Vasanth Nagar,286400,45980,240420,0.8394553072625698,-1
4998,4999,Malleswaram,254550,72910,181640,0.7135729719112158,0
4999,5000,Krishnarajapuram,280250,56110,224140,0.79978590544157,0
5000,5001,Rajajinagar,316450,72660,243790,0.7703902670248064,0
5001,5002,Vasanth Nagar,346900,82680,264220,0.7616604208705678,0
5002,5003,Banaswadi,226050,55090,170960,0.7562928555629286,0
5003,5004,HBR Layout,297550,60000,237550,0.7983532179465636,0
5004,5005,Malleswaram,167550,37070,130480,0.7787526111608475,0
5005,5006,Kammanahalli,431950,73600,358350,0.8296099085542308,-1
5006,5007,HBR Layout,75750,56170,19580,0.2584818481848185,1
5007,5008,Hoodi,289100,81700,207400,0.7173988239363542,0
5008,5009,Whitefield,426500,51730,374770,0.8787104337631887,-1
5009,5010,Kammanahalli,54500,118540,-64040,-1.175045871559633,1
5010,5011,Krishnarajapuram,221100,57580,163520,0.7395748530076889,0
5011,5012,Mahadevapura,151600,101190,50410,0.3325197889182058,1
5012,5013,Banaswadi,426050,75230,350820,0.8234244806947542,-1
5013,5014,Banaswadi,243900,94390,149510,0.6129971299712997,0
5014,5015,Kalyan Nagar,184900,39590,145310,0.7858842617631152,0
5015,5016,Hebbal,404650,56750,347900,0.8597553441245521,-1
5016,5017,HBR Layout,42800,72290,-29490,-0.689018691588785,1
5017,5018,CV Raman Nagar,289250,38580,250670,0.8666205704407952,-1
5018,5019,Banaswadi,93700,156380,-62680,-0.6689434364994664,1
5019,5020,Varthur,431200,60990,370210,0.8585575139146567,-1
5020,5021,Kammanahalli,82700,83310,-610,-0.007376058041112455,1
5021,5022,Horamavu,403850,31430,372420,0.9221740745326235,-1
5022,5023,Jalahalli,222950,38420,184530,0.8276743664498767,-1
5023,5024,Horamavu,36950,76150,-39200,-1.060893098782138,1
5024,5025,Mahadevapura,72550,33810,38740,0.5339765678842178,0
5025,5026,Banaswadi,279850,82690,197160,0.7045202787207433,0
5026,5027,Hebbal,369850,75730,294120,0.795241314046235,0
5027,5028,Malleswaram,306600,63380,243220,0.7932811480756686,0
5028,5029,Kalyan Nagar,50550,95670,-45120,-0.8925816023738873,1
5029,5030,Kalyan Nagar,37350,83170,-45820,-1.2267737617135208,1
5030,5031,Hebbal,349000,109030,239970,0.6875931232091691,0
5031,5032,Krishnarajapuram,157350,73290,84060,0.5342230695900858,0
5032,5033,Kammanahalli,134500,83950,50550,0.3758364312267658,1
5033,5034,HBR Layout,33500,44440,-10940,-0.3265671641791045,1
5034,5035,Horamavu,111100,13230,97870,0.8809180918091809,-1
5035,5036,Jalahalli,133350,85910,47440,0.35575553055868014,1
5036,5037,Kammanahalli,103500,67720,35780,0.3457004830917874,1
5037,5038,Jalahalli,187000,70930,116070,0.6206951871657754,0
5038,5039,Malleswaram,417200,58650,358550,0.8594199424736337,-1
5039,5040,Vasanth Nagar,276150,15640,260510,0.943364113706319,-1
5040,5041,Jalahalli,331700,73360,258340,0.7788362978595116,0
5041,5042,Hoodi,204700,69200,135500,0.6619443087445042,0
5042,5043,Krishnarajapuram,394800,15370,379430,0.9610688956433637,-1
5043,5044,Krishnarajapuram,421500,27080,394420,0.9357532621589562,-1
5044,5045,Vasanth Nagar,56650,101220,-44570,-0.7867608120035304,1
5045,5046,CV Raman Nagar,412450,78070,334380,0.8107164504788459,-1
5046,5047,Malleswaram,281550,34820,246730,0.8763274729177766,-1
5047,5048,CV Raman Nagar,202300,66680,135620,0.6703905091448344,0
5048,5049,Krishnarajapuram,340450,69830,270620,0.7948891173446908,0
5049,5050,Hoodi,295850,46630,249220,0.8423863444312997,-1
5050,5051,Horamavu,127650,49760,77890,0.6101840971406188,0
5051,5052,Banaswadi,308850,67380,241470,0.7818358426420593,0
5052,5053,Marathahalli,437750,33620,404130,0.9231981724728726,-1
5053,5054,Jalahalli,108700,95000,13700,0.12603495860165592,1
5054,5055,Krishnarajapuram,303350,60660,242690,0.8000329652216911,-1
5055,5056,Kammanahalli,151550,78410,73140,0.48261299901022764,1
5056,5057,Whitefield,411750,37700,374050,0.9084395871281117,-1
5057,5058,Malleswaram,198700,119450,79250,0.398842476094615,1
5058,5059,Hebbal,189150,55680,133470,0.7056304520222046,0
5059,5060,Banaswadi,298100,51010,247090,0.8288829251928883,-1
5060,5061,Rajajinagar,383750,20160,363590,0.9474657980456026,-1
5061,5062,Varthur,348200,96820,251380,0.7219414129810454,0
5062,5063,Hebbal,165300,26550,138750,0.8393829401088929,-1
5063,5064,Mahadevapura,423350,159450,263900,0.62336128498878,0
5064,5065,Kalyan Nagar,318500,83820,234680,0.736828885400314,0
5065,5066,Kammanahalli,279950,168910,111040,0.39664225754599036,1
5066,5067,Horamavu,296200,87120,209080,0.7058744091829845,0
5067,5068,Indiranagar,358000,86530,271470,0.7582960893854749,0
5068,5069,Hebbal,272700,26400,246300,0.9031903190319032,-1
5069,5070,Rajajinagar,134600,49000,85600,0.6359583952451708,0
5070,5071,Kammanahalli,449350,21040,428310,0.9531768109491487,-1
5071,5072,Krishnarajapuram,118150,61320,56830,0.48099873042742275,1
5072,5073,Banaswadi,407450,81340,326110,0.80036814333047,-1
5073,5074,Whitefield,230600,55970,174630,0.757285342584562,0
5074,5075,Kalyan Nagar,258400,46690,211710,0.819311145510836,-1
5075,5076,Mahadevapura,181900,60430,121470,0.6677844969763607,0
5076,5077,Hoodi,337350,26210,311140,0.9223062101674818,-1
5077,5078,Whitefield,329450,92080,237370,0.7205038700865078,0
5078,5079,Krishnarajapuram,238200,17610,220590,0.9260705289672544,-1
5079,5080,Marathahalli,236600,66740,169860,0.717920540997464,0
5080,5081,Varthur,171550,51600,119950,0.6992130574176625,0
5081,5082,Indiranagar,194850,42900,151950,0.7798306389530408,0
5082,5083,Whitefield,195750,61170,134580,0.6875095785440613,0
5083,5084,Hebbal,267500,105470,162030,0.6057196261682243,0
5084,5085,Vasanth Nagar,362750,107290,255460,0.7042315644383184,0
5085,5086,Rajajinagar,114150,25270,88880,0.7786246167323697,0
5086,5087,Jalahalli,168800,31490,137310,0.8134478672985782,-1
5087,5088,Krishnarajapuram,390750,80570,310180,0.7938067818298145,0
5088,5089,Varthur,175900,64200,111700,0.6350198976691301,0
5089,5090,Hebbal,131450,54430,77020,0.5859262076835299,0
5090,5091,Shivajinagar,371250,66820,304430,0.820013468013468,-1
5091,5092,Kalyan Nagar,259650,65260,194390,0.7486616599268245,0
5092,5093,HBR Layout,65850,77670,-11820,-0.179498861047836,1
5093,5094,Kammanahalli,448500,29440,419060,0.9343589743589743,-1
5094,5095,Malleswaram,59950,98630,-38680,-0.6452043369474562,1
5095,5096,Marathahalli,224450,155540,68910,0.3070171530407663,1
5096,5097,Marathahalli,195800,26710,169090,0.863585291113381,-1
5097,5098,Marathahalli,48150,79940,-31790,-0.6602284527518172,1
5098,5099,Hoodi,322650,49670,272980,0.8460560979389431,-1
5099,5100,Krishnarajapuram,406400,27550,378850,0.9322096456692913,-1
5100,5101,Shivajinagar,403100,131920,271180,0.6727362937236417,0
5101,5102,Banaswadi,392750,52850,339900,0.8654360280076384,-1
5102,5103,Krishnarajapuram,310150,18720,291430,0.9396421086571014,-1
5103,5104,Whitefield,271100,93520,177580,0.6550350424197713,0
5104,5105,CV Raman Nagar,52650,55590,-2940,-0.05584045584045584,1
5105,5106,Hebbal,76050,109140,-33090,-0.43510848126232743,1
5106,5107,Kammanahalli,390600,57570,333030,0.8526113671274962,-1
5107,5108,Kammanahalli,271350,47130,224220,0.8263128800442233,-1
5108,5109,Varthur,398800,108030,290770,0.7291123370110331,0
5109,5110,Vasanth Nagar,47150,73780,-26630,-0.5647932131495228,1
5110,5111,Varthur,448450,74560,373890,0.8337384323781916,-1
5111,5112,Vasanth Nagar,248250,35300,212950,0.8578046324269889,-1
5112,5113,Vasanth Nagar,78300,14350,63950,0.8167305236270753,-1
5113,5114,Rajajinagar,97600,112620,-15020,-0.15389344262295082,1
5114,5115,Jalahalli,240500,32290,208210,0.8657380457380457,-1
5115,5116,Shivajinagar,183600,135070,48530,0.26432461873638347,1
5116,5117,HBR Layout,391500,23690,367810,0.9394891443167305,-1
5117,5118,Marathahalli,285650,71520,214130,0.749623665324698,0
5118,5119,Horamavu,136250,86580,49670,0.3645504587155963,1
5119,5120,Rajajinagar,199450,62100,137350,0.6886437703685134,0
5120,5121,Kammanahalli,350600,23490,327110,0.933000570450656,-1
5121,5122,Whitefield,51200,79480,-28280,-0.55234375,1
5122,5123,Banaswadi,120550,60900,59650,0.4948154292824554,1
5123,5124,Hebbal,426050,78540,347510,0.8156554395024058,-1
5124,5125,Malleswaram,403350,19010,384340,0.9528697161274328,-1
5125,5126,Krishnarajapuram,233000,32340,200660,0.8612017167381975,-1
5126,5127,Marathahalli,396450,142220,254230,0.6412662378610166,0
5127,5128,Hoodi,161350,47500,113850,0.7056089246978617,0
5128,5129,Horamavu,125850,59580,66270,0.5265792610250298,0
5129,5130,Malleswaram,231500,97290,134210,0.5797408207343413,0
5130,5131,Vasanth Nagar,178000,72900,105100,0.5904494382022472,0
5131,5132,Hoodi,52050,25940,26110,0.5016330451488953,0
5132,5133,Hebbal,351100,100070,251030,0.71498148675591,0
5133,5134,Hoodi,59300,71460,-12160,-0.20505902192242834,1
5134,5135,Malleswaram,137050,53130,83920,0.612331265961328,0
5135,5136,Marathahalli,405150,73670,331480,0.8181661113167963,-1
5136,5137,Kammanahalli,59900,131470,-71570,-1.1948247078464107,1
5137,5138,Marathahalli,431600,61670,369930,0.8571130676552363,-1
5138,5139,Krishnarajapuram,346650,16810,329840,0.9515072840040386,-1
5139,5140,Horamavu,281950,63230,218720,0.7757403794999114,0
5140,5141,Kammanahalli,396900,75460,321440,0.8098765432098766,-1
5141,5142,Vasanth Nagar,68900,24520,44380,0.644121915820029,0
5142,5143,Mahadevapura,390500,55930,334570,0.8567733674775928,-1
5143,5144,Varthur,126400,88620,37780,0.2988924050632911,1
5144,5145,Hoodi,296750,63740,233010,0.7852064026958719,0
5145,5146,Malleswaram,427150,79570,347580,0.8137188341332084,-1
5146,5147,Vasanth Nagar,173150,36810,136340,0.787409760323419,0
5147,5148,Krishnarajapuram,48650,25330,23320,0.47934224049331964,1
5148,5149,Mahadevapura,133850,64170,69680,0.5205827418752335,0
5149,5150,Hoodi,52800,177170,-124370,-2.355492424242424,1
5150,5151,Kammanahalli,263500,73710,189790,0.7202656546489563,0
5151,5152,Shivajinagar,83600,55810,27790,0.3324162679425837,1
5152,5153,Jalahalli,151950,93110,58840,0.3872326423165515,1
5153,5154,Horamavu,286450,97640,188810,0.6591377203700471,0
5154,5155,Hoodi,53350,80100,-26750,-0.5014058106841612,1
5155,5156,Varthur,91150,95910,-4760,-0.05222161272627537,1
5156,5157,Marathahalli,416500,103810,312690,0.7507563025210084,0
5157,5158,CV Raman Nagar,285100,41670,243430,0.8538407576289021,-1
5158,5159,Marathahalli,54450,30470,23980,0.4404040404040404,1
5159,5160,Shivajinagar,238600,46830,191770,0.8037300922045264,-1
5160,5161,Jalahalli,240300,84630,155670,0.6478152309612983,0
5161,5162,Kalyan Nagar,449950,106820,343130,0.7625958439826648,0
5162,5163,CV Raman Nagar,191150,95200,95950,0.5019618100967826,0
5163,5164,Indiranagar,204400,48390,156010,0.7632583170254403,0
5164,5165,Banaswadi,146250,49710,96540,0.6601025641025641,0
5165,5166,Krishnarajapuram,191250,9060,182190,0.9526274509803921,-1
5166,5167,Malleswaram,206700,51370,155330,0.7514755684567005,0
5167,5168,Kammanahalli,364400,68370,296030,0.8123765093304062,-1
5168,5169,Kalyan Nagar,408850,83020,325830,0.7969426440014675,0
5169,5170,Krishnarajapuram,357750,0,357750,1.0,-1
5170,5171,Horamavu,159800,79060,80740,0.5052565707133917,0
5171,5172,Indiranagar,275600,52880,222720,0.8081277213352686,-1
5172,5173,HBR Layout,128800,36250,92550,0.718555900621118,0
5173,5174,Indiranagar,210700,17260,193440,0.9180825818699573,-1
5174,5175,Jalahalli,396850,92280,304570,0.7674688169333501,0
5175,5176,Hebbal,156250,51080,105170,0.673088,0
5176,5177,Krishnarajapuram,396250,58600,337650,0.8521135646687698,-1
5177,5178,Jalahalli,243050,74010,169040,0.6954947541658095,0
5178,5179,Shivajinagar,202500,60230,142270,0.7025679012345679,0
5179,5180,Vasanth Nagar,321650,113370,208280,0.6475361417690035,0
5180,5181,Shivajinagar,390450,22170,368280,0.9432193622742989,-1
5181,5182,Krishnarajapuram,91950,34230,57720,0.6277324632952692,0
5182,5183,Marathahalli,210450,24730,185720,0.8824899025896887,-1
5183,5184,Vasanth Nagar,174350,47980,126370,0.7248064238600517,0
5184,5185,Vasanth Nagar,125650,105360,20290,0.16148030242737763,1
5185,5186,Shivajinagar,406400,53630,352770,0.8680364173228347,-1
5186,5187,Banaswadi,83700,49250,34450,0.4115890083632019,1
5187,5188,Krishnarajapuram,63000,105430,-42430,-0.6734920634920635,1
5188,5189,Malleswaram,374550,36190,338360,0.9033773861967694,-1
5189,5190,Jalahalli,449100,12950,436150,0.971164551324872,-1
5190,5191,Hebbal,361800,81090,280710,0.7758706467661691,0
5191,5192,Banaswadi,67400,35730,31670,0.4698813056379822,1
5192,5193,Shivajinagar,216600,67590,149010,0.6879501385041551,0
5193,5194,Shivajinagar,58550,48630,9920,0.16942783945345857,1
5194,5195,Vasanth Nagar,51150,19970,31180,0.6095796676441838,0
5195,5196,Rajajinagar,259750,89720,170030,0.6545909528392685,0
5196,5197,Varthur,132400,21110,111290,0.840558912386707,-1
5197,5198,HBR Layout,240350,69860,170490,0.7093405450384855,0
5198,5199,CV Raman Nagar,345300,78350,266950,0.7730958586736172,0
5199,5200,Malleswaram,224600,103050,121550,0.5411843276936776,0
5200,5201,Kalyan Nagar,64250,126140,-61890,-0.9632684824902724,1
5201,5202,Vasanth Nagar,100850,127230,-26380,-0.2615765989092712,1
5202,5203,Varthur,296700,122960,173740,0.5855746545331986,0
5203,5204,Krishnarajapuram,146650,81170,65480,0.4465052846914422,1
5204,5205,Krishnarajapuram,202000,66690,135310,0.6698514851485149,0
5205,5206,Marathahalli,435700,58390,377310,0.8659857700252467,-1
5206,5207,Shivajinagar,25450,36680,-11230,-0.4412573673870334,1
5207,5208,CV Raman Nagar,75400,121000,-45600,-0.6047745358090185,1
5208,5209,Rajajinagar,272150,10120,262030,0.9628146242880764,-1
5209,5210,Malleswaram,355900,35050,320850,0.9015172801348693,-1
5210,5211,Indiranagar,271100,25740,245360,0.9050534857985983,-1
5211,5212,Rajajinagar,225350,126690,98660,0.43780785444863546,1
5212,5213,Malleswaram,315200,77320,237880,0.7546954314720812,0
5213,5214,Whitefield,345050,46960,298090,0.863903782060571,-1
5214,5215,Rajajinagar,434850,38030,396820,0.9125445555938829,-1
5215,5216,Krishnarajapuram,423950,152050,271900,0.6413492157093997,0
5216,5217,Vasanth Nagar,132000,26460,105540,0.7995454545454546,0
5217,5218,Kalyan Nagar,45850,61380,-15530,-0.3387131952017448,1
5218,5219,Krishnarajapuram,155950,49100,106850,0.6851554985572299,0
5219,5220,Shivajinagar,118450,37220,81230,0.6857745884339383,0
5220,5221,Hoodi,174650,83860,90790,0.5198396793587174,0
5221,5222,HBR Layout,437250,90060,347190,0.7940308747855918,0
5222,5223,HBR Layout,372700,74920,297780,0.7989804132009659,0
5223,5224,Kammanahalli,222700,42230,180470,0.8103726986977997,-1
5224,5225,Krishnarajapuram,188250,93110,95140,0.5053917662682603,0
5225,5226,Jalahalli,194100,71650,122450,0.63086038124678,0
5226,5227,HBR Layout,92150,85700,6450,0.06999457406402604,1
5227,5228,Marathahalli,72600,45120,27480,0.3785123966942149,1
5228,5229,Rajajinagar,428850,63730,365120,0.8513932610469861,-1
5229,5230,HBR Layout,284050,61740,222310,0.782643900721704,0
5230,5231,Kammanahalli,234500,50930,183570,0.7828144989339019,0
5231,5232,Marathahalli,176400,57780,118620,0.6724489795918367,0
5232,5233,Krishnarajapuram,436850,21930,414920,0.9497997024150165,-1
5233,5234,Hoodi,409000,206450,202550,0.49523227383863083,1
5234,5235,Malleswaram,154800,59330,95470,0.6167312661498708,0
5235,5236,Vasanth Nagar,96950,35880,61070,0.6299123259412068,0
5236,5237,Hebbal,194300,45210,149090,0.7673185795162121,0
5237,5238,Kammanahalli,379950,88020,291930,0.7683379392025267,0
5238,5239,Banaswadi,271300,82910,188390,0.6943973461113159,0
5239,5240,Mahadevapura,318300,80740,237560,0.7463399308828149,0
5240,5241,Hebbal,290850,19280,271570,0.9337115351555785,-1
5241,5242,Marathahalli,308650,106180,202470,0.6559857443706464,0
5242,5243,Vasanth Nagar,318250,57220,261030,0.820204241948154,-1
5243,5244,Mahadevapura,125100,54970,70130,0.5605915267785772,0
5244,5245,Krishnarajapuram,168850,81130,87720,0.5195143618596387,0
5245,5246,Krishnarajapuram,176300,66190,110110,0.6245604083947817,0
5246,5247,Malleswaram,65800,63390,2410,0.03662613981762918,1
5247,5248,Mahadevapura,58250,50000,8250,0.14163090128755365,1
5248,5249,Horamavu,302500,42960,259540,0.8579834710743801,-1
5249,5250,Kalyan Nagar,58550,34920,23630,0.4035866780529462,1
5250,5251,Horamavu,374300,53500,320800,0.8570665241784665,-1
5251,5252,Vasanth Nagar,396750,63590,333160,0.8397227473219911,-1
5252,5253,Krishnarajapuram,121600,19590,102010,0.8388980263157895,-1
5253,5254,Jalahalli,138550,19240,119310,0.8611331649224107,-1
5254,5255,Varthur,55200,40520,14680,0.26594202898550723,1
5255,5256,Jalahalli,313300,2450,310850,0.9921800191509735,-1
5256,5257,Hebbal,235300,74090,161210,0.6851253718657033,0
5257,5258,Kammanahalli,280250,45860,234390,0.8363603925066905,-1
5258,5259,Indiranagar,348650,112380,236270,0.6776710167790048,0
5259,5260,Malleswaram,330750,87130,243620,0.7365684051398337,0
5260,5261,Vasanth Nagar,80200,54930,25270,0.3150872817955112,1
5261,5262,Kammanahalli,387700,30710,356990,0.9207892700541656,-1
5262,5263,CV Raman Nagar,321300,21770,299530,0.9322440087145969,-1
5263,5264,Indiranagar,427650,24190,403460,0.943435052028528,-1
5264,5265,Vasanth Nagar,434450,41830,392620,0.9037173437679825,-1
5265,5266,Jalahalli,369100,83230,285870,0.7745055540503929,0
5266,5267,Kammanahalli,98350,34870,63480,0.6454499237417387,0
5267,5268,CV Raman Nagar,401800,63940,337860,0.8408661025385764,-1
5268,5269,Kalyan Nagar,163900,17440,146460,0.8935936546674802,-1
5269,5270,Hoodi,337300,26510,310790,0.9214052772013045,-1
5270,5271,Horamavu,61050,67470,-6420,-0.10515970515970516,1
5271,5272,Horamavu,222050,22890,199160,0.8969151092096375,-1
5272,5273,Whitefield,177550,21690,155860,0.8778372289495917,-1
5273,5274,Indiranagar,266250,28460,237790,0.8931079812206573,-1
5274,5275,Varthur,447950,105780,342170,0.7638575733898872,0
5275,5276,Indiranagar,283750,90130,193620,0.6823612334801762,0
5276,5277,Whitefield,120050,13120,106930,0.8907122032486464,-1
5277,5278,Malleswaram,358800,25140,333660,0.929933110367893,-1
5278,5279,Banaswadi,48900,83660,-34760,-0.710838445807771,1
5279,5280,Indiranagar,371200,59330,311870,0.8401670258620689,-1
5280,5281,Kalyan Nagar,220400,15190,205210,0.9310798548094373,-1
5281,5282,Hebbal,143900,59310,84590,0.5878387769284226,0
5282,5283,Kammanahalli,362050,52610,309440,0.8546885789255627,-1
5283,5284,Hebbal,117700,52010,65690,0.5581138487680544,0
5284,5285,Kalyan Nagar,226750,9390,217360,0.9585887541345094,-1
5285,5286,Hebbal,434950,119240,315710,0.725853546384642,0
5286,5287,Kammanahalli,407300,106750,300550,0.7379081757917997,0
5287,5288,Vasanth Nagar,244400,45080,199320,0.8155482815057283,-1
5288,5289,Kalyan Nagar,219500,83250,136250,0.6207289293849658,0
5289,5290,Jalahalli,122050,54380,67670,0.5544448996312986,0
5290,5291,Shivajinagar,129850,88970,40880,0.3148247978436658,1
5291,5292,Horamavu,337400,43610,293790,0.870746887966805,-1
5292,5293,HBR Layout,328100,152760,175340,0.5344102407802499,0
5293,5294,Kalyan Nagar,376650,48000,328650,0.8725607327757865,-1
5294,5295,Malleswaram,445350,63970,381380,0.8563601661614461,-1
5295,5296,Whitefield,210950,122980,87970,0.4170182507703247,1
5296,5297,Krishnarajapuram,90450,27280,63170,0.6983969043670536,0
5297,5298,Indiranagar,106650,62080,44570,0.4179090482887951,1
5298,5299,Horamavu,162200,85620,76580,0.4721331689272503,1
5299,5300,Mahadevapura,200500,46270,154230,0.7692269326683292,0
5300,5301,Jalahalli,188200,51490,136710,0.7264080765143465,0
5301,5302,Hebbal,304100,53060,251040,0.8255179217362709,-1
5302,5303,Jalahalli,147000,610,146390,0.9958503401360544,-1
5303,5304,Varthur,301900,105730,196170,0.6497846969195098,0
5304,5305,Kammanahalli,338300,61680,276620,0.8176766183860479,-1
5305,5306,CV Raman Nagar,409850,54670,355180,0.8666097352690009,-1
5306,5307,Hoodi,351600,46440,305160,0.8679180887372013,-1
5307,5308,CV Raman Nagar,410000,99230,310770,0.7579756097560976,0
5308,5309,Indiranagar,159300,99550,59750,0.37507846829880725,1
5309,5310,Indiranagar,104900,127850,-22950,-0.21877979027645378,1
5310,5311,HBR Layout,401550,70440,331110,0.8245797534553605,-1
5311,5312,Hoodi,84650,100670,-16020,-0.18924985233313643,1
5312,5313,Marathahalli,397650,77580,320070,0.804903809883063,-1
5313,5314,Shivajinagar,224350,27800,196550,0.8760864720303098,-1
5314,5315,Hoodi,190000,100640,89360,0.4703157894736842,1
5315,5316,Krishnarajapuram,284100,68630,215470,0.7584301302358325,0
5316,5317,Varthur,176150,64210,111940,0.6354811240420096,0
5317,5318,Krishnarajapuram,365500,0,365500,1.0,-1
5318,5319,Indiranagar,327000,87890,239110,0.731223241590214,0
5319,5320,Malleswaram,354550,48340,306210,0.8636581582287407,-1
5320,5321,Marathahalli,429000,79470,349530,0.8147552447552447,-1
5321,5322,Shivajinagar,395000,69380,325620,0.8243544303797469,-1
5322,5323,Vasanth Nagar,137900,139270,-1370,-0.009934735315445975,1
5323,5324,Horamavu,252100,64920,187180,0.742483141610472,0
5324,5325,Marathahalli,315250,32440,282810,0.8970975416336241,-1
5325,5326,Hoodi,44800,83220,-38420,-0.8575892857142857,1
5326,5327,Hoodi,421500,72930,348570,0.8269750889679716,-1
5327,5328,Banaswadi,412450,57350,355100,0.8609528427688204,-1
5328,5329,Malleswaram,430000,0,430000,1.0,-1
5329,5330,Horamavu,60700,102380,-41680,-0.6866556836902801,1
5330,5331,Hoodi,423950,18910,405040,0.9553956834532374,-1
5331,5332,Malleswaram,54050,78700,-24650,-0.45605920444033304,1
5332,5333,Marathahalli,176600,59680,116920,0.6620611551528879,0
5333,5334,Rajajinagar,150100,153480,-3380,-0.02251832111925383,1
5334,5335,Hebbal,156250,86240,70010,0.448064,1
5335,5336,Shivajinagar,54100,77910,-23810,-0.4401109057301294,1
5336,5337,Rajajinagar,34950,45460,-10510,-0.3007153075822604,1
5337,5338,Vasanth Nagar,94500,89070,5430,0.05746031746031746,1
5338,5339,Jalahalli,294800,91110,203690,0.690943012211669,0
5339,5340,Jalahalli,274100,84950,189150,0.6900766143743159,0
5340,5341,Rajajinagar,349200,74800,274400,0.7857961053837342,0
5341,5342,Banaswadi,227750,43850,183900,0.8074643249176728,-1
5342,5343,Hebbal,391400,20850,370550,0.946729688298416,-1
5343,5344,Shivajinagar,78850,66320,12530,0.15890932149651238,1
5344,5345,Malleswaram,81750,78900,2850,0.03486238532110092,1
5345,5346,Marathahalli,190250,26850,163400,0.8588699080157687,-1
5346,5347,Krishnarajapuram,215350,19150,196200,0.9110749941954958,-1
5347,5348,Horamavu,332600,136790,195810,0.5887251954299458,0
5348,5349,Varthur,436150,109080,327070,0.7499025564599335,0
5349,5350,Marathahalli,378650,32790,345860,0.9134028786478278,-1
5350,5351,Rajajinagar,237050,6670,230380,0.9718624762708289,-1
5351,5352,Hoodi,209750,29690,180060,0.858450536352801,-1
5352,5353,Marathahalli,335950,71030,264920,0.7885697276380413,0
5353,5354,Shivajinagar,300000,63220,236780,0.7892666666666667,0
5354,5355,Hebbal,61500,37460,24040,0.3908943089430894,1
5355,5356,Mahadevapura,212450,62920,149530,0.703836196752177,0
5356,5357,Rajajinagar,433700,37690,396010,0.9130966105602951,-1
5357,5358,Hebbal,191650,44060,147590,0.7701017479780851,0
5358,5359,HBR Layout,440750,64290,376460,0.8541349971639252,-1
5359,5360,Kalyan Nagar,371850,93640,278210,0.7481780287750437,0
5360,5361,Whitefield,142400,30300,112100,0.7872191011235955,0
5361,5362,Jalahalli,294250,54480,239770,0.8148513169073917,-1
5362,5363,Varthur,284550,64570,219980,0.7730803022315937,0
5363,5364,HBR Layout,292200,80390,211810,0.724880219028063,0
5364,5365,Malleswaram,441800,61680,380120,0.860389316432775,-1
5365,5366,Jalahalli,55900,41980,13920,0.24901610017889086,1
5366,5367,Horamavu,373500,28900,344600,0.922623828647925,-1
5367,5368,Kammanahalli,395900,130850,265050,0.6694872442535994,0
5368,5369,HBR Layout,338150,78610,259540,0.7675292030164128,0
5369,5370,Hoodi,336600,42150,294450,0.874777183600713,-1
5370,5371,Kalyan Nagar,122900,55850,67050,0.5455655004068348,0
5371,5372,Indiranagar,261250,19580,241670,0.9250526315789473,-1
5372,5373,Marathahalli,239100,107510,131590,0.5503554997908825,0
5373,5374,Rajajinagar,151600,27070,124530,0.8214379947229552,-1
5374,5375,Kalyan Nagar,310000,15520,294480,0.9499354838709677,-1
5375,5376,Horamavu,55350,50730,4620,0.08346883468834689,1
5376,5377,Indiranagar,214000,62340,151660,0.7086915887850467,0
5377,5378,Horamavu,395250,63720,331530,0.838785578747628,-1
5378,5379,CV Raman Nagar,306150,83590,222560,0.7269639065817409,0
5379,5380,Hebbal,50750,87650,-36900,-0.7270935960591133,1
5380,5381,Mahadevapura,388400,88380,300020,0.7724510813594233,0
5381,5382,Varthur,187600,21420,166180,0.8858208955223881,-1
5382,5383,Hoodi,46750,75360,-28610,-0.6119786096256684,1
5383,5384,Whitefield,337500,35400,302100,0.8951111111111111,-1
5384,5385,Whitefield,201550,51770,149780,0.7431406598858844,0
5385,5386,Krishnarajapuram,265700,97320,168380,0.6337222431313512,0
5386,5387,Indiranagar,67150,17890,49260,0.7335815338793745,0
5387,5388,Kammanahalli,162000,86090,75910,0.46858024691358025,1
5388,5389,Malleswaram,421300,74680,346620,0.8227391407548066,-1
5389,5390,Hebbal,371650,26350,345300,0.9290999596394457,-1
5390,5391,Horamavu,206600,60160,146440,0.708809293320426,0
5391,5392,Banaswadi,305100,56460,248640,0.8149459193706982,-1
5392,5393,CV Raman Nagar,174750,44600,130150,0.7447782546494993,0
5393,5394,Shivajinagar,88050,17970,70080,0.7959114139693356,0
5394,5395,Mahadevapura,268100,119640,148460,0.5537486012681835,0
5395,5396,Mahadevapura,57400,50010,7390,0.12874564459930313,1
5396,5397,HBR Layout,418150,59440,358710,0.8578500538084419,-1
5397,5398,Vasanth Nagar,89100,40580,48520,0.5445566778900113,0
5398,5399,Horamavu,74950,88050,-13100,-0.17478318879252835,1
5399,5400,Vasanth Nagar,80250,49300,30950,0.3856697819314642,1
5400,5401,Jalahalli,256550,27570,228980,0.8925355681153772,-1
5401,5402,Marathahalli,294050,97350,196700,0.668933854786601,0
5402,5403,HBR Layout,326350,53730,272620,0.835360808947449,-1
5403,5404,Malleswaram,401500,90940,310560,0.7734993773349937,0
5404,5405,Kalyan Nagar,115100,114300,800,0.0069504778453518675,1
5405,5406,Whitefield,286150,56690,229460,0.8018871221387385,-1
5406,5407,Kalyan Nagar,75150,27980,47170,0.6276779773785762,0
5407,5408,Hebbal,28000,93810,-65810,-2.350357142857143,1
5408,5409,Malleswaram,372650,70350,302300,0.8112169596135784,-1
5409,5410,Jalahalli,58750,114630,-55880,-0.9511489361702128,1
5410,5411,Hebbal,304850,119340,185510,0.6085287846481876,0
5411,5412,Krishnarajapuram,151550,70780,80770,0.5329594193335533,0
5412,5413,Jalahalli,397100,153930,243170,0.6123646436665827,0
5413,5414,Marathahalli,102700,62120,40580,0.3951314508276534,1
5414,5415,Hoodi,377950,109660,268290,0.7098558010318825,0
5415,5416,HBR Layout,442450,16980,425470,0.9616227822352809,-1
5416,5417,Vasanth Nagar,232700,44130,188570,0.8103566824237215,-1
5417,5418,Marathahalli,364450,35200,329250,0.9034161064617917,-1
5418,5419,Horamavu,64150,83780,-19630,-0.30600155884645364,1
5419,5420,Marathahalli,133200,79390,53810,0.403978978978979,1
5420,5421,Krishnarajapuram,218150,58170,159980,0.7333486133394453,0
5421,5422,Rajajinagar,293200,72680,220520,0.7521145975443383,0
5422,5423,Varthur,51000,24880,26120,0.5121568627450981,0
5423,5424,Indiranagar,82550,135300,-52750,-0.6390066626287099,1
5424,5425,Krishnarajapuram,412100,52300,359800,0.8730890560543557,-1
5425,5426,Krishnarajapuram,80550,102550,-22000,-0.27312228429546864,1
5426,5427,Malleswaram,89800,89320,480,0.005345211581291759,1
5427,5428,Mahadevapura,96450,92310,4140,0.04292379471228616,1
5428,5429,Hoodi,93350,48650,44700,0.4788430637386181,1
5429,5430,CV Raman Nagar,302250,49130,253120,0.8374524400330852,-1
5430,5431,Indiranagar,277300,57520,219780,0.7925712225027046,0
5431,5432,Kammanahalli,128300,38160,90140,0.7025720966484801,0
5432,5433,Rajajinagar,282400,31590,250810,0.8881373937677054,-1
5433,5434,Mahadevapura,147350,74160,73190,0.49670851713607056,1
5434,5435,Hoodi,216050,66480,149570,0.6922934505901411,0
5435,5436,Whitefield,220150,7310,212840,0.9667953667953668,-1
5436,5437,Banaswadi,119950,36380,83570,0.6967069612338475,0
5437,5438,Mahadevapura,381600,138400,243200,0.6373165618448637,0
5438,5439,Indiranagar,138350,106100,32250,0.23310444524756052,1
5439,5440,Rajajinagar,175050,38730,136320,0.7787489288774636,0
5440,5441,Kammanahalli,52500,57290,-4790,-0.09123809523809524,1
5441,5442,Indiranagar,147350,68710,78640,0.5336952833389889,0
5442,5443,HBR Layout,83700,12840,70860,0.8465949820788531,-1
5443,5444,Krishnarajapuram,160200,74220,85980,0.5367041198501873,0
5444,5445,Indiranagar,218050,45580,172470,0.7909653749140105,0
5445,5446,Horamavu,40850,75680,-34830,-0.8526315789473684,1
5446,5447,Horamavu,159850,62950,96900,0.6061933062245856,0
5447,5448,Hoodi,82200,94660,-12460,-0.1515815085158151,1
5448,5449,Kalyan Nagar,350250,118400,231850,0.6619557458957888,0
5449,5450,Hebbal,32700,28830,3870,0.11834862385321102,1
5450,5451,Hebbal,61900,35080,26820,0.4332794830371567,1
5451,5452,Rajajinagar,286700,74120,212580,0.74147192186955,0
5452,5453,Kammanahalli,200900,106430,94470,0.47023394723743156,1
5453,5454,Hebbal,194350,0,194350,1.0,-1
5454,5455,Indiranagar,291450,72270,219180,0.7520329387545034,0
5455,5456,Marathahalli,139600,137850,1750,0.012535816618911174,1
5456,5457,Malleswaram,291400,89540,201860,0.6927247769389155,0
5457,5458,Kammanahalli,87150,47830,39320,0.45117613310384397,1
5458,5459,CV Raman Nagar,198200,97250,100950,0.5093340060544904,0
5459,5460,Kalyan Nagar,243100,60270,182830,0.7520773344302756,0
5460,5461,Banaswadi,322650,66530,256120,0.7938013327134666,0
5461,5462,Marathahalli,91500,59720,31780,0.3473224043715847,1
5462,5463,Kalyan Nagar,425300,121160,304140,0.7151187397131437,0
5463,5464,Varthur,212050,105680,106370,0.5016269747701014,0
5464,5465,Banaswadi,310950,59300,251650,0.8092940987296993,-1
5465,5466,Hoodi,155050,71810,83240,0.5368590777168655,0
5466,5467,Hoodi,100850,41510,59340,0.5883986117997025,0
5467,5468,Hoodi,405950,94610,311340,0.7669417415937924,0
5468,5469,Indiranagar,219650,44210,175440,0.7987252447074892,0
5469,5470,Jalahalli,432750,41040,391710,0.9051646447140381,-1
5470,5471,Rajajinagar,77600,129010,-51410,-0.6625,1
5471,5472,Hoodi,358400,16900,341500,0.9528459821428571,-1
5472,5473,Hebbal,96550,80190,16360,0.16944588296219576,1
5473,5474,Indiranagar,330050,75030,255020,0.7726708074534161,0
5474,5475,Banaswadi,64300,48660,15640,0.2432348367029549,1
5475,5476,Horamavu,413250,74280,338970,0.8202540834845735,-1
5476,5477,Marathahalli,243650,68550,175100,0.7186538066899241,0
5477,5478,Horamavu,144950,73850,71100,0.49051397033459815,1
5478,5479,Hebbal,182350,71260,111090,0.6092130518234165,0
5479,5480,Marathahalli,290450,94280,196170,0.6754002410053366,0
5480,5481,Jalahalli,31900,122520,-90620,-2.8407523510971786,1
5481,5482,HBR Layout,382450,32460,349990,0.9151261602823898,-1
5482,5483,Marathahalli,138650,0,138650,1.0,-1
5483,5484,Horamavu,364800,93220,271580,0.7444627192982456,0
5484,5485,Mahadevapura,123950,50600,73350,0.5917708753529649,0
5485,5486,Horamavu,96600,92770,3830,0.039648033126293995,1
5486,5487,Horamavu,316300,61550,254750,0.8054062598798609,-1
5487,5488,Rajajinagar,255650,144180,111470,0.43602581654605904,1
5488,5489,Vasanth Nagar,168300,32350,135950,0.8077837195484254,-1
5489,5490,Varthur,318350,44890,273460,0.8589916758284907,-1
5490,5491,Jalahalli,85050,95460,-10410,-0.12239858906525573,1
5491,5492,Jalahalli,357850,41280,316570,0.8846444040799217,-1
5492,5493,Vasanth Nagar,236700,86340,150360,0.635234474017744,0
5493,5494,Kammanahalli,136550,110430,26120,0.19128524350054926,1
5494,5495,CV Raman Nagar,374650,56510,318140,0.8491658881622848,-1
5495,5496,HBR Layout,423150,50200,372950,0.881365945882075,-1
5496,5497,Kalyan Nagar,319200,48250,270950,0.8488408521303258,-1
5497,5498,Rajajinagar,208400,98000,110400,0.5297504798464492,0
5498,5499,Krishnarajapuram,244800,87890,156910,0.6409722222222223,0
5499,5500,CV Raman Nagar,416300,121170,295130,0.7089358635599328,0
5500,5501,Horamavu,177050,78520,98530,0.556509460604349,0
5501,5502,Mahadevapura,112100,24770,87330,0.7790365744870651,0
5502,5503,Vasanth Nagar,295850,38770,257080,0.8689538617542674,-1
5503,5504,Jalahalli,308400,41570,266830,0.8652075226977951,-1
5504,5505,CV Raman Nagar,125700,32280,93420,0.7431980906921241,0
5505,5506,Banaswadi,380750,57510,323240,0.8489560078791858,-1
5506,5507,HBR Layout,111450,106330,5120,0.04593988335576492,1
5507,5508,Horamavu,120800,42270,78530,0.6500827814569536,0
5508,5509,Varthur,96100,70820,25280,0.2630593132154006,1
5509,5510,Jalahalli,87400,86280,1120,0.012814645308924484,1
5510,5511,Jalahalli,327700,59490,268210,0.8184620079340861,-1
5511,5512,Marathahalli,268800,49550,219250,0.8156622023809523,-1
5512,5513,Marathahalli,329750,72300,257450,0.7807429871114481,0
5513,5514,Shivajinagar,227550,93480,134070,0.5891891891891892,0
5514,5515,HBR Layout,340700,47760,292940,0.8598180217199882,-1
5515,5516,Krishnarajapuram,39400,42320,-2920,-0.07411167512690356,1
5516,5517,Banaswadi,394850,67420,327430,0.829251614537166,-1
5517,5518,Varthur,129450,22950,106500,0.8227114716106605,-1
5518,5519,Hebbal,304600,68650,235950,0.7746224556795798,0
5519,5520,Whitefield,146700,90440,56260,0.3835037491479209,1
5520,5521,Krishnarajapuram,161100,62600,98500,0.611421477343265,0
5521,5522,HBR Layout,263350,55140,208210,0.7906208467818493,0
5522,5523,Whitefield,255500,19810,235690,0.9224657534246575,-1
5523,5524,Malleswaram,301600,44550,257050,0.8522877984084881,-1
5524,5525,Malleswaram,309000,66010,242990,0.7863754045307443,0
5525,5526,Shivajinagar,362700,96210,266490,0.7347394540942928,0
5526,5527,Hebbal,216250,88010,128240,0.5930173410404624,0
5527,5528,Whitefield,313300,73490,239810,0.7654324928183849,0
5528,5529,Varthur,306350,92250,214100,0.6988738371144116,0
5529,5530,Hebbal,255950,116110,139840,0.5463567102949795,0
5530,5531,Vasanth Nagar,303150,102570,200580,0.6616526472043542,0
5531,5532,Horamavu,300400,121660,178740,0.5950066577896138,0
5532,5533,Rajajinagar,199250,58140,141110,0.7082057716436637,0
5533,5534,Banaswadi,68750,60930,7820,0.11374545454545455,1
5534,5535,Banaswadi,189600,26830,162770,0.8584915611814345,-1
5535,5536,Shivajinagar,94800,21090,73710,0.7775316455696203,0
5536,5537,Indiranagar,373000,46570,326430,0.8751474530831099,-1
5537,5538,Hebbal,172700,67800,104900,0.6074116965836711,0
5538,5539,Shivajinagar,381500,133390,248110,0.6503538663171691,0
5539,5540,Vasanth Nagar,355650,78900,276750,0.7781526781948545,0
5540,5541,Whitefield,173500,67930,105570,0.6084726224783862,0
5541,5542,Hoodi,106750,48790,57960,0.5429508196721311,0
5542,5543,Hoodi,172650,41900,130750,0.7573124818997973,0
5543,5544,Vasanth Nagar,286300,76030,210270,0.7344393992315753,0
5544,5545,Horamavu,332800,36200,296600,0.8912259615384616,-1
5545,5546,Mahadevapura,71800,73300,-1500,-0.020891364902506964,1
5546,5547,Jalahalli,62650,156240,-93590,-1.493854748603352,1
5547,5548,Kalyan Nagar,410750,32780,377970,0.9201947656725502,-1
5548,5549,Varthur,376200,54260,321940,0.8557682083997874,-1
5549,5550,Mahadevapura,133000,63900,69100,0.5195488721804511,0
5550,5551,Kammanahalli,434000,59090,374910,0.8638479262672811,-1
5551,5552,Banaswadi,77500,24850,52650,0.6793548387096774,0
5552,5553,HBR Layout,65650,61520,4130,0.06290936785986291,1
5553,5554,Mahadevapura,194250,38580,155670,0.8013899613899614,-1
5554,5555,Rajajinagar,292900,78090,214810,0.7333902355752817,0
5555,5556,Whitefield,139450,86160,53290,0.3821441376837576,1
5556,5557,CV Raman Nagar,191600,50440,141160,0.7367432150313152,0
5557,5558,Kammanahalli,382650,77710,304940,0.7969162419966026,0
5558,5559,Mahadevapura,166150,30160,135990,0.8184772795666566,-1
5559,5560,Indiranagar,258000,43600,214400,0.8310077519379845,-1
5560,5561,Rajajinagar,113400,90820,22580,0.19911816578483246,1
5561,5562,Mahadevapura,380450,45500,334950,0.8804047838086476,-1
5562,5563,Marathahalli,235400,137200,98200,0.41716227697536107,1
5563,5564,Hoodi,333250,62610,270640,0.8121230307576894,-1
5564,5565,Krishnarajapuram,257350,52870,204480,0.7945599378278609,0
5565,5566,Malleswaram,351650,60170,291480,0.8288923645670411,-1
5566,5567,Kalyan Nagar,200650,96210,104440,0.5205083478694243,0
5567,5568,Whitefield,318250,65170,253080,0.7952238805970149,0
5568,5569,Indiranagar,241850,35950,205900,0.8513541451312797,-1
5569,5570,Horamavu,228700,78080,150620,0.6585920419763883,0
5570,5571,Indiranagar,210900,26620,184280,0.8737790422000948,-1
5571,5572,Horamavu,359550,125120,234430,0.6520094562647755,0
5572,5573,Indiranagar,64950,55920,9030,0.13903002309468823,1
5573,5574,Hebbal,449500,112860,336640,0.7489210233592881,0
5574,5575,Shivajinagar,42600,38420,4180,0.09812206572769953,1
5575,5576,Banaswadi,375000,51980,323020,0.8613866666666666,-1
5576,5577,Marathahalli,31350,47430,-16080,-0.5129186602870813,1
5577,5578,CV Raman Nagar,420800,45170,375630,0.8926568441064638,-1
5578,5579,Krishnarajapuram,445100,40310,404790,0.9094360817793754,-1
5579,5580,Jalahalli,83450,114200,-30750,-0.36848412222887955,1
5580,5581,Rajajinagar,223400,35370,188030,0.841674127126231,-1
5581,5582,Whitefield,191200,27840,163360,0.8543933054393306,-1
5582,5583,Malleswaram,213800,50590,163210,0.763376987839102,0
5583,5584,Marathahalli,368950,5590,363360,0.9848488955142973,-1
5584,5585,Whitefield,430750,28390,402360,0.9340917005223447,-1
5585,5586,Indiranagar,46500,59640,-13140,-0.28258064516129033,1
5586,5587,CV Raman Nagar,159850,135800,24050,0.1504535502033156,1
5587,5588,Malleswaram,418450,105350,313100,0.7482375433146135,0
5588,5589,Mahadevapura,341650,65810,275840,0.8073759695594908,-1
5589,5590,Rajajinagar,319200,66340,252860,0.7921679197994987,0
5590,5591,Krishnarajapuram,375450,21780,353670,0.941989612465042,-1
5591,5592,Vasanth Nagar,74150,33350,40800,0.550236008091706,0
5592,5593,CV Raman Nagar,430100,58280,371820,0.8644966286910021,-1
5593,5594,Whitefield,428050,32890,395160,0.9231631818712768,-1
5594,5595,Varthur,212150,25640,186510,0.8791421164270563,-1
5595,5596,Krishnarajapuram,129400,16940,112460,0.8690880989180835,-1
5596,5597,Malleswaram,100700,68960,31740,0.31519364448857995,1
5597,5598,Whitefield,141500,82790,58710,0.41491166077738517,1
5598,5599,Shivajinagar,232700,79450,153250,0.6585732703051139,0
5599,5600,Jalahalli,428800,57670,371130,0.865508395522388,-1
5600,5601,CV Raman Nagar,223550,16230,207320,0.9273987922165063,-1
5601,5602,Marathahalli,26450,54520,-28070,-1.0612476370510397,1
5602,5603,Hoodi,262950,72770,190180,0.7232553717436775,0
5603,5604,Malleswaram,170750,165390,5360,0.031390922401171306,1
5604,5605,Shivajinagar,120900,32160,88740,0.7339950372208437,0
5605,5606,Jalahalli,130550,55160,75390,0.5774798927613941,0
5606,5607,HBR Layout,447900,71210,376690,0.8410136191114088,-1
5607,5608,Varthur,288800,85660,203140,0.7033933518005541,0
5608,5609,Vasanth Nagar,33750,69610,-35860,-1.0625185185185184,1
5609,5610,Marathahalli,260650,39320,221330,0.849146364857088,-1
5610,5611,Varthur,442900,74920,367980,0.8308421765635584,-1
5611,5612,Kalyan Nagar,125200,103210,21990,0.17563897763578276,1
5612,5613,Kammanahalli,28150,35090,-6940,-0.24653641207815274,1
5613,5614,Indiranagar,111450,12260,99190,0.889995513683266,-1
5614,5615,Varthur,320600,71040,249560,0.7784154709918902,0
5615,5616,HBR Layout,200900,13300,187600,0.9337979094076655,-1
5616,5617,CV Raman Nagar,358250,61760,296490,0.8276064200976971,-1
5617,5618,Kalyan Nagar,306350,70480,235870,0.7699363473151624,0
5618,5619,Whitefield,346150,46160,299990,0.8666474071934133,-1
5619,5620,CV Raman Nagar,280800,83460,197340,0.7027777777777777,0
5620,5621,Varthur,402200,145700,256500,0.6377424167081054,0
5621,5622,Kammanahalli,129000,96520,32480,0.2517829457364341,1
5622,5623,Rajajinagar,421100,11790,409310,0.972001899786274,-1
5623,5624,Varthur,251150,67510,183640,0.7311964961178579,0
5624,5625,Kalyan Nagar,347900,56620,291280,0.8372520839321644,-1
5625,5626,Varthur,57550,66560,-9010,-0.15655951346655084,1
5626,5627,HBR Layout,382000,62930,319070,0.8352617801047121,-1
5627,5628,Shivajinagar,426600,42720,383880,0.89985935302391,-1
5628,5629,Mahadevapura,385700,98480,287220,0.7446720248898108,0
5629,5630,HBR Layout,142150,96600,45550,0.3204361589869856,1
5630,5631,Horamavu,236100,124330,111770,0.4734011012282931,1
5631,5632,Banaswadi,114200,36590,77610,0.6795971978984238,0
5632,5633,CV Raman Nagar,207500,50510,156990,0.7565783132530121,0
5633,5634,Kalyan Nagar,250000,109970,140030,0.56012,0
5634,5635,Shivajinagar,374450,22930,351520,0.9387635198290827,-1
5635,5636,Marathahalli,312050,6910,305140,0.9778561128024356,-1
5636,5637,HBR Layout,375550,73200,302350,0.8050858740513913,-1
5637,5638,Vasanth Nagar,421300,66340,354960,0.8425350106812248,-1
5638,5639,Mahadevapura,121000,48130,72870,0.6022314049586777,0
5639,5640,Shivajinagar,181400,72330,109070,0.6012679162072767,0
5640,5641,Vasanth Nagar,426150,47990,378160,0.8873870702804177,-1
5641,5642,Rajajinagar,300650,138500,162150,0.5393314485281889,0
5642,5643,Marathahalli,39100,34650,4450,0.11381074168797954,1
5643,5644,Hebbal,104350,64560,39790,0.38131288931480595,1
5644,5645,Krishnarajapuram,172700,151700,21000,0.12159814707585408,1
5645,5646,Kalyan Nagar,105950,39370,66580,0.6284096271826333,0
5646,5647,Malleswaram,297400,71070,226330,0.7610289172831204,0
5647,5648,Shivajinagar,32300,55440,-23140,-0.7164086687306501,1
5648,5649,Krishnarajapuram,48950,28240,20710,0.42308478038815117,1
5649,5650,Hebbal,199750,106620,93130,0.46623279098873593,1
5650,5651,Banaswadi,182000,66830,115170,0.6328021978021978,0
5651,5652,Vasanth Nagar,254000,0,254000,1.0,-1
5652,5653,Kalyan Nagar,61250,97270,-36020,-0.5880816326530612,1
5653,5654,Vasanth Nagar,210050,79210,130840,0.6228993096881695,0
5654,5655,Indiranagar,283450,52270,231180,0.8155935791144823,-1
5655,5656,Horamavu,210950,58210,152740,0.7240578336098602,0
5656,5657,Jalahalli,219850,86910,132940,0.6046850125085286,0
5657,5658,Kammanahalli,267650,55280,212370,0.7934616103119746,0
5658,5659,CV Raman Nagar,90600,141290,-50690,-0.5594922737306843,1
5659,5660,HBR Layout,67150,61800,5350,0.07967237527922562,1
5660,5661,Shivajinagar,117850,64720,53130,0.4508273228680526,1
5661,5662,CV Raman Nagar,311600,27720,283880,0.9110397946084724,-1
5662,5663,Kalyan Nagar,359950,30870,329080,0.9142380886234199,-1
5663,5664,HBR Layout,288450,81680,206770,0.7168313399202635,0
5664,5665,Hebbal,171900,54610,117290,0.6823152995927865,0
5665,5666,Shivajinagar,195150,72130,123020,0.6303868818857289,0
5666,5667,Banaswadi,319100,82240,236860,0.742275148856158,0
5667,5668,Mahadevapura,71450,75270,-3820,-0.05346396081175647,1
5668,5669,Vasanth Nagar,400350,55580,344770,0.8611714749594105,-1
5669,5670,Mahadevapura,102200,76600,25600,0.25048923679060664,1
5670,5671,Shivajinagar,60150,50090,10060,0.16724854530340816,1
5671,5672,Whitefield,308050,93350,214700,0.6969647784450577,0
5672,5673,Banaswadi,429250,104750,324500,0.7559697146185207,0
5673,5674,Banaswadi,164800,66930,97870,0.5938713592233009,0
5674,5675,Kalyan Nagar,376450,106380,270070,0.7174126710054456,0
5675,5676,Indiranagar,361850,67540,294310,0.813348072405693,-1
5676,5677,Jalahalli,199350,83390,115960,0.581690494105844,0
5677,5678,Malleswaram,87200,65120,22080,0.25321100917431194,1
5678,5679,Mahadevapura,442400,45110,397290,0.8980334538878842,-1
5679,5680,Vasanth Nagar,185800,62380,123420,0.6642626480086115,0
5680,5681,Jalahalli,98450,20210,78240,0.7947181310309802,0
5681,5682,Malleswaram,60800,57070,3730,0.06134868421052632,1
5682,5683,Banaswadi,326700,88530,238170,0.7290174471992654,0
5683,5684,Hebbal,342650,78570,264080,0.7706989639573909,0
5684,5685,CV Raman Nagar,84450,93810,-9360,-0.1108348134991119,1
5685,5686,Indiranagar,140550,81550,59000,0.41977943792244754,1
5686,5687,Banaswadi,388000,37900,350100,0.902319587628866,-1
5687,5688,Krishnarajapuram,245100,45700,199400,0.8135454916360669,-1
5688,5689,HBR Layout,400450,54410,346040,0.864127856161818,-1
5689,5690,Hebbal,404100,66630,337470,0.8351150705270972,-1
5690,5691,Kammanahalli,98650,67940,30710,0.3113025848960973,1
5691,5692,Malleswaram,103400,58320,45080,0.43597678916827853,1
5692,5693,Krishnarajapuram,441300,69680,371620,0.8421028778608656,-1
5693,5694,Hebbal,66850,80480,-13630,-0.20388930441286462,1
5694,5695,HBR Layout,317700,8950,308750,0.9718287692791943,-1
5695,5696,Krishnarajapuram,348450,77570,270880,0.7773855646434209,0
5696,5697,Marathahalli,96900,0,96900,1.0,-1
5697,5698,HBR Layout,414500,57820,356680,0.8605066344993969,-1
5698,5699,Whitefield,342200,52170,290030,0.8475452951490356,-1
5699,5700,HBR Layout,416550,122190,294360,0.7066618653222903,0
5700,5701,Malleswaram,296450,112250,184200,0.6213526733007253,0
5701,5702,Whitefield,186300,133550,52750,0.2831454643048846,1
5702,5703,Indiranagar,439050,63400,375650,0.8555973123790002,-1
5703,5704,Vasanth Nagar,418000,32270,385730,0.922799043062201,-1
5704,5705,Rajajinagar,69550,44760,24790,0.35643421998562186,1
5705,5706,Hebbal,56850,30840,26010,0.4575197889182058,1
5706,5707,Mahadevapura,440400,19620,420780,0.955449591280654,-1
5707,5708,Rajajinagar,236650,22600,214050,0.904500316923727,-1
5708,5709,CV Raman Nagar,370750,50720,320030,0.8631962238705327,-1
5709,5710,Shivajinagar,246950,69710,177240,0.7177161368698117,0
5710,5711,Shivajinagar,275250,80180,195070,0.7087011807447775,0
5711,5712,Mahadevapura,192350,16450,175900,0.9144788146607746,-1
5712,5713,Varthur,155400,58240,97160,0.6252252252252253,0
5713,5714,Hebbal,111350,53250,58100,0.5217781769196228,0
5714,5715,Banaswadi,408300,50030,358270,0.8774675483712956,-1
5715,5716,Varthur,326550,31260,295290,0.9042719338539275,-1
5716,5717,Hebbal,443900,31290,412610,0.9295111511601712,-1
5717,5718,Kalyan Nagar,268050,52980,215070,0.8023503077783996,-1
5718,5719,Hoodi,109050,121060,-12010,-0.11013296652911508,1
5719,5720,Shivajinagar,392650,87830,304820,0.7763147841589202,0
5720,5721,Rajajinagar,28750,84580,-55830,-1.9419130434782608,1
5721,5722,HBR Layout,333250,91710,241540,0.724801200300075,0
5722,5723,Shivajinagar,181850,10570,171280,0.9418751718449271,-1
5723,5724,Kalyan Nagar,187250,92580,94670,0.505580774365821,0
5724,5725,Shivajinagar,400000,26210,373790,0.934475,-1
5725,5726,CV Raman Nagar,223800,53620,170180,0.7604110813226095,0
5726,5727,Krishnarajapuram,428950,3110,425840,0.9927497377316704,-1
5727,5728,Indiranagar,90450,46960,43490,0.48081813156440023,1
5728,5729,Shivajinagar,304650,19550,285100,0.9358279993435089,-1
5729,5730,Marathahalli,156350,48450,107900,0.6901183242724657,0
5730,5731,Malleswaram,447300,88920,358380,0.8012072434607646,-1
5731,5732,Malleswaram,203750,94970,108780,0.5338895705521473,0
5732,5733,Kammanahalli,107000,47610,59390,0.5550467289719626,0
5733,5734,Kammanahalli,302600,62010,240590,0.7950760079312624,0
5734,5735,Kammanahalli,116750,47080,69670,0.596745182012848,0
5735,5736,Whitefield,137200,67020,70180,0.5115160349854228,0
5736,5737,Varthur,112350,83690,28660,0.2550956831330663,1
5737,5738,Hebbal,288350,82330,206020,0.7144789318536501,0
5738,5739,Marathahalli,165850,80400,85450,0.5152246005426591,0
5739,5740,Malleswaram,209550,148510,61040,0.29129086136960153,1
5740,5741,Marathahalli,186200,51760,134440,0.7220193340494092,0
5741,5742,Mahadevapura,244550,38220,206330,0.8437129421386219,-1
5742,5743,Mahadevapura,198650,43350,155300,0.7817769947143217,0
5743,5744,Malleswaram,188100,54450,133650,0.7105263157894737,0
5744,5745,Jalahalli,61350,79590,-18240,-0.29731051344743276,1
5745,5746,Jalahalli,345300,48820,296480,0.8586156964958007,-1
5746,5747,CV Raman Nagar,357600,54720,302880,0.8469798657718121,-1
5747,5748,Whitefield,436650,42380,394270,0.9029428604145197,-1
5748,5749,Horamavu,363950,44650,319300,0.8773183129550762,-1
5749,5750,Krishnarajapuram,89000,113900,-24900,-0.2797752808988764,1
5750,5751,Kalyan Nagar,271800,16610,255190,0.9388888888888889,-1
5751,5752,Rajajinagar,384000,71920,312080,0.8127083333333334,-1
5752,5753,Rajajinagar,174650,28080,146570,0.8392212997423418,-1
5753,5754,Krishnarajapuram,148200,36690,111510,0.7524291497975708,0
5754,5755,CV Raman Nagar,329000,104900,224100,0.6811550151975684,0
5755,5756,Jalahalli,389850,18280,371570,0.9531101705784276,-1
5756,5757,HBR Layout,226650,68100,158550,0.699536730641959,0
5757,5758,CV Raman Nagar,118850,61690,57160,0.48094236432477916,1
5758,5759,Marathahalli,70000,34040,35960,0.5137142857142857,0
5759,5760,HBR Layout,181300,85770,95530,0.5269167126309984,0
5760,5761,Mahadevapura,31950,70880,-38930,-1.2184663536776212,1
5761,5762,Whitefield,70000,40350,29650,0.4235714285714286,1
5762,5763,CV Raman Nagar,76200,68540,7660,0.1005249343832021,1
5763,5764,Rajajinagar,396000,11650,384350,0.970580808080808,-1
5764,5765,Rajajinagar,125500,97860,27640,0.2202390438247012,1
5765,5766,CV Raman Nagar,64700,67770,-3070,-0.04744976816074189,1
5766,5767,Marathahalli,95150,47540,47610,0.5003678402522334,0
5767,5768,Vasanth Nagar,357950,110080,247870,0.6924710155049588,0
5768,5769,Vasanth Nagar,155700,15850,139850,0.8982016698779705,-1
5769,5770,Malleswaram,345550,53750,291800,0.8444508754160035,-1
5770,5771,Malleswaram,154000,88190,65810,0.42733766233766235,1
5771,5772,Banaswadi,357850,44510,313340,0.8756182758138885,-1
5772,5773,HBR Layout,423200,60060,363140,0.8580812854442345,-1
5773,5774,Indiranagar,91650,101880,-10230,-0.111620294599018,1
5774,5775,Kammanahalli,84000,71690,12310,0.14654761904761904,1
5775,5776,Varthur,329800,62450,267350,0.8106428138265616,-1
5776,5777,Mahadevapura,223950,82690,141260,0.630765795936593,0
5777,5778,Mahadevapura,395850,57160,338690,0.8556018693949728,-1
5778,5779,Indiranagar,309800,63310,246490,0.7956423499031633,0
5779,5780,HBR Layout,420500,35940,384560,0.9145303210463733,-1
5780,5781,Rajajinagar,37150,61770,-24620,-0.6627187079407806,1
5781,5782,Kammanahalli,291900,52590,239310,0.8198355601233299,-1
5782,5783,Vasanth Nagar,270700,46120,224580,0.8296268932397488,-1
5783,5784,Rajajinagar,150700,36660,114040,0.7567352355673523,0
5784,5785,Malleswaram,165900,69460,96440,0.5813140446051839,0
5785,5786,Krishnarajapuram,50300,60640,-10340,-0.20556660039761432,1
5786,5787,Kammanahalli,150700,21500,129200,0.8573324485733245,-1
5787,5788,Kalyan Nagar,311400,37540,273860,0.8794476557482338,-1
5788,5789,Hoodi,83000,36270,46730,0.5630120481927711,0
5789,5790,Hebbal,33000,19150,13850,0.4196969696969697,1
5790,5791,Rajajinagar,76700,82690,-5990,-0.07809647979139504,1
5791,5792,Krishnarajapuram,104150,43980,60170,0.5777244359097455,0
5792,5793,Whitefield,336650,100290,236360,0.70209416307738,0
5793,5794,Vasanth Nagar,257150,42100,215050,0.8362823254909586,-1
5794,5795,Hoodi,321900,79150,242750,0.7541161851506679,0
5795,5796,Whitefield,150450,18210,132240,0.878963110667996,-1
5796,5797,Hoodi,26000,13010,12990,0.49961538461538463,1
5797,5798,Hoodi,87350,72370,14980,0.17149398969662277,1
5798,5799,Banaswadi,225000,96030,128970,0.5732,0
5799,5800,Banaswadi,38500,100620,-62120,-1.6135064935064936,1
5800,5801,Hebbal,254750,64260,190490,0.7477526987242394,0
5801,5802,Hoodi,233600,80640,152960,0.6547945205479452,0
5802,5803,Jalahalli,201050,81560,119490,0.5943297687142501,0
5803,5804,Vasanth Nagar,226400,48660,177740,0.7850706713780918,0
5804,5805,Krishnarajapuram,266500,39720,226780,0.8509568480300188,-1
5805,5806,HBR Layout,339550,74080,265470,0.7818288911795023,0
5806,5807,Varthur,304200,40820,263380,0.8658119658119658,-1
5807,5808,Banaswadi,60400,84150,-23750,-0.3932119205298013,1
5808,5809,Rajajinagar,277950,93620,184330,0.6631768303651736,0
5809,5810,CV Raman Nagar,46650,27950,18700,0.4008574490889603,1
5810,5811,Hebbal,283350,10840,272510,0.9617434268572437,-1
5811,5812,Marathahalli,251800,77720,174080,0.6913423351866561,0
5812,5813,Kalyan Nagar,313650,58760,254890,0.812657420691854,-1
5813,5814,Varthur,179600,35300,144300,0.8034521158129176,-1
5814,5815,CV Raman Nagar,178900,18220,160680,0.8981553940749022,-1
5815,5816,CV Raman Nagar,425650,79370,346280,0.8135322448020674,-1
5816,5817,Shivajinagar,330850,98020,232830,0.7037328094302554,0
5817,5818,Jalahalli,438850,46180,392670,0.8947704226956819,-1
5818,5819,Malleswaram,282500,91860,190640,0.6748318584070796,0
5819,5820,Shivajinagar,112900,80860,32040,0.2837909654561559,1
5820,5821,HBR Layout,175950,59190,116760,0.6635976129582267,0
5821,5822,Malleswaram,142550,2360,140190,0.9834444054717643,-1
5822,5823,Whitefield,170200,109060,61140,0.3592244418331375,1
5823,5824,Horamavu,302500,13070,289430,0.956793388429752,-1
5824,5825,Shivajinagar,429150,30070,399080,0.929931259466387,-1
5825,5826,HBR Layout,378900,67510,311390,0.8218263394035366,-1
5826,5827,Hebbal,292750,90670,202080,0.6902818104184457,0
5827,5828,Whitefield,45350,50840,-5490,-0.12105843439911797,1
5828,5829,Kammanahalli,53000,77830,-24830,-0.46849056603773587,1
5829,5830,Whitefield,148250,28380,119870,0.808566610455312,-1
5830,5831,Hebbal,215900,115780,100120,0.46373320981936084,1
5831,5832,Malleswaram,162400,166390,-3990,-0.02456896551724138,1
5832,5833,Shivajinagar,119550,47810,71740,0.6000836470096194,0
5833,5834,Hoodi,166000,52870,113130,0.6815060240963855,0
5834,5835,Indiranagar,175250,40370,134880,0.7696433666191156,0
5835,5836,Kalyan Nagar,446500,69180,377320,0.8450615901455767,-1
5836,5837,Malleswaram,355300,94120,261180,0.7350971010413735,0
5837,5838,Hebbal,232100,101410,130690,0.5630762602326583,0
5838,5839,Whitefield,388600,36410,352190,0.9063046834791559,-1
5839,5840,Whitefield,309250,3400,305850,0.9890056588520615,-1
5840,5841,Horamavu,69650,46430,23220,0.33338119167264896,1
5841,5842,Indiranagar,372900,48110,324790,0.8709841780638241,-1
5842,5843,Hoodi,421900,61580,360320,0.854041242000474,-1
5843,5844,Vasanth Nagar,444900,77300,367600,0.8262530905821532,-1
5844,5845,Malleswaram,416000,65490,350510,0.8425721153846154,-1
5845,5846,Mahadevapura,255450,41470,213980,0.8376590330788805,-1
5846,5847,Hoodi,379350,75990,303360,0.7996836694345592,0
5847,5848,Hoodi,308800,83450,225350,0.7297603626943006,0
5848,5849,Banaswadi,359550,59520,300030,0.8344597413433459,-1
5849,5850,Banaswadi,84750,121160,-36410,-0.4296165191740413,1
5850,5851,Shivajinagar,307550,56040,251510,0.817785725898228,-1
5851,5852,Banaswadi,199850,82250,117600,0.5884413309982487,0
5852,5853,Whitefield,63350,34710,28640,0.4520915548539858,1
5853,5854,Indiranagar,28500,13860,14640,0.5136842105263157,0
5854,5855,HBR Layout,356350,70830,285520,0.8012347411252981,-1
5855,5856,Vasanth Nagar,91600,133690,-42090,-0.45949781659388644,1
5856,5857,Indiranagar,263950,121260,142690,0.5405948096230346,0
5857,5858,Kalyan Nagar,103250,70960,32290,0.3127360774818402,1
5858,5859,Whitefield,240750,79900,160850,0.6681204569055036,0
5859,5860,Mahadevapura,251750,45760,205990,0.818232373386296,-1
5860,5861,Marathahalli,387800,48000,339800,0.8762248581743166,-1
5861,5862,Vasanth Nagar,198300,34720,163580,0.8249117498739283,-1
5862,5863,Whitefield,36300,137670,-101370,-2.7925619834710744,1
5863,5864,Kalyan Nagar,160050,55800,104250,0.6513589503280225,0
5864,5865,Indiranagar,333700,48520,285180,0.8545999400659274,-1
5865,5866,Indiranagar,121950,62080,59870,0.4909389093890939,1
5866,5867,Jalahalli,439900,94370,345530,0.7854739713571266,0
5867,5868,Vasanth Nagar,337700,28010,309690,0.9170565590761031,-1
5868,5869,Krishnarajapuram,298200,73350,224850,0.7540241448692153,0
5869,5870,Banaswadi,383850,57370,326480,0.850540575745734,-1
5870,5871,Shivajinagar,377850,68000,309850,0.8200344051872436,-1
5871,5872,Marathahalli,77900,41910,35990,0.462002567394095,1
5872,5873,Hoodi,221900,40180,181720,0.8189274447949527,-1
5873,5874,Shivajinagar,124950,42190,82760,0.6623449379751901,0
5874,5875,Hebbal,176950,38220,138730,0.7840067815767165,0
5875,5876,CV Raman Nagar,62850,65690,-2840,-0.04518695306284805,1
5876,5877,Kalyan Nagar,164550,87520,77030,0.4681251899118809,1
5877,5878,Jalahalli,100350,65020,35330,0.35206776283009467,1
5878,5879,Malleswaram,433200,134670,298530,0.6891274238227146,0
5879,5880,Mahadevapura,226350,67300,159050,0.7026728517782196,0
5880,5881,Hoodi,267750,56070,211680,0.7905882352941176,0
5881,5882,Whitefield,325400,0,325400,1.0,-1
5882,5883,Shivajinagar,129400,36530,92870,0.7176970633693972,0
5883,5884,Whitefield,302000,50620,251380,0.8323841059602649,-1
5884,5885,Kammanahalli,114050,95270,18780,0.16466462078035948,1
5885,5886,Hoodi,203750,52560,151190,0.7420368098159509,0
5886,5887,Rajajinagar,189200,132780,56420,0.2982029598308668,1
5887,5888,Hebbal,256100,69880,186220,0.7271378367825069,0
5888,5889,Banaswadi,226900,52560,174340,0.7683561040105773,0
5889,5890,CV Raman Nagar,199450,104770,94680,0.4747054399598897,1
5890,5891,Indiranagar,50050,116050,-66000,-1.3186813186813187,1
5891,5892,Banaswadi,61800,67840,-6040,-0.09773462783171522,1
5892,5893,Banaswadi,231400,56660,174740,0.7551426101987899,0
5893,5894,Varthur,148750,84230,64520,0.4337478991596639,1
5894,5895,Jalahalli,339900,80800,259100,0.7622830244189468,0
5895,5896,Varthur,339800,59500,280300,0.8248969982342554,-1
5896,5897,CV Raman Nagar,260550,64780,195770,0.7513720974860871,0
5897,5898,Shivajinagar,126800,62250,64550,0.5090694006309149,0
5898,5899,Jalahalli,446000,45530,400470,0.8979147982062781,-1
5899,5900,Mahadevapura,405850,86220,319630,0.7875569791794998,0
5900,5901,HBR Layout,285450,71570,213880,0.749273077596777,0
5901,5902,Indiranagar,270500,58430,212070,0.7839926062846581,0
5902,5903,Indiranagar,100950,48760,52190,0.5169886082218921,0
5903,5904,Marathahalli,50100,95620,-45520,-0.9085828343313374,1
5904,5905,Hebbal,337350,56150,281200,0.8335556543649029,-1
5905,5906,Whitefield,213250,30320,182930,0.8578194607268464,-1
5906,5907,Jalahalli,150800,25920,124880,0.8281167108753316,-1
5907,5908,CV Raman Nagar,139700,91880,47820,0.34230493915533283,1
5908,5909,Hebbal,349350,66100,283250,0.8107914698726206,-1
5909,5910,Malleswaram,79300,94110,-14810,-0.1867591424968474,1
5910,5911,Shivajinagar,446700,39590,407110,0.9113722856503246,-1
5911,5912,CV Raman Nagar,157900,100690,57210,0.3623179227359088,1
5912,5913,Varthur,318200,19080,299120,0.9400377121307354,-1
5913,5914,Mahadevapura,448600,71900,376700,0.8397235844850647,-1
5914,5915,Jalahalli,78900,96160,-17260,-0.2187579214195184,1
5915,5916,HBR Layout,266300,73330,192970,0.7246338715734134,0
5916,5917,Horamavu,134650,78600,56050,0.4162643891570739,1
5917,5918,Indiranagar,151200,52730,98470,0.6512566137566138,0
5918,5919,Hebbal,208700,56480,152220,0.7293723047436512,0
5919,5920,Indiranagar,256450,19820,236630,0.9227139793332033,-1
5920,5921,Krishnarajapuram,189550,46330,143220,0.7555790029016091,0
5921,5922,CV Raman Nagar,180650,67590,113060,0.6258510932742873,0
5922,5923,HBR Layout,418850,138120,280730,0.6702399427002507,0
5923,5924,Whitefield,110500,44170,66330,0.6002714932126697,0
5924,5925,Rajajinagar,393000,112330,280670,0.7141730279898219,0
5925,5926,Vasanth Nagar,207800,37050,170750,0.8217035611164581,-1
5926,5927,Krishnarajapuram,387450,32020,355430,0.9173570783326881,-1
5927,5928,Horamavu,91700,70960,20740,0.2261723009814613,1
5928,5929,Krishnarajapuram,408950,59010,349940,0.8557036312507642,-1
5929,5930,Marathahalli,118250,59540,58710,0.49649048625792813,1
5930,5931,Indiranagar,192800,35600,157200,0.8153526970954357,-1
5931,5932,Varthur,367650,32520,335130,0.9115463076295389,-1
5932,5933,Kalyan Nagar,379600,5050,374550,0.9866965226554267,-1
5933,5934,Shivajinagar,404350,88900,315450,0.7801409669840484,0
5934,5935,Whitefield,146850,57900,88950,0.6057201225740552,0
5935,5936,Krishnarajapuram,143400,36870,106530,0.742887029288703,0
5936,5937,Banaswadi,336450,52880,283570,0.8428295437657899,-1
5937,5938,Hoodi,266900,104900,162000,0.6069689022105658,0
5938,5939,Whitefield,79800,79650,150,0.0018796992481203006,1
5939,5940,Jalahalli,30450,94720,-64270,-2.110673234811166,1
5940,5941,Malleswaram,393450,80200,313250,0.7961621552929216,0
5941,5942,Krishnarajapuram,243350,55000,188350,0.7739880830080131,0
5942,5943,Kammanahalli,41300,89710,-48410,-1.1721549636803874,1
5943,5944,Malleswaram,353750,93160,260590,0.7366501766784452,0
5944,5945,Varthur,441850,101540,340310,0.7701935045830033,0
5945,5946,CV Raman Nagar,156800,63540,93260,0.5947704081632653,0
5946,5947,HBR Layout,444800,71540,373260,0.8391636690647482,-1
5947,5948,Banaswadi,340900,90520,250380,0.7344675858022881,0
5948,5949,Jalahalli,422750,7300,415450,0.9827321111768185,-1
5949,5950,Hoodi,143550,101500,42050,0.29292929292929293,1
5950,5951,Varthur,360350,82800,277550,0.7702233939225753,0
5951,5952,CV Raman Nagar,101450,10610,90840,0.8954164613109906,-1
5952,5953,CV Raman Nagar,186800,69550,117250,0.6276766595289079,0
5953,5954,Banaswadi,417100,93650,323450,0.7754735075521457,0
5954,5955,CV Raman Nagar,224500,29880,194620,0.8669042316258352,-1
5955,5956,Rajajinagar,68100,38610,29490,0.4330396475770925,1
5956,5957,Krishnarajapuram,144700,45720,98980,0.6840359364201797,0
5957,5958,Shivajinagar,82150,96420,-14270,-0.17370663420572124,1
5958,5959,Indiranagar,171550,65030,106520,0.6209268434858641,0
5959,5960,Kammanahalli,229450,143460,85990,0.3747657441708433,1
5960,5961,Rajajinagar,204050,82900,121150,0.5937270276892919,0
5961,5962,HBR Layout,64800,41650,23150,0.35725308641975306,1
5962,5963,Mahadevapura,345950,38370,307580,0.8890880184997833,-1
5963,5964,Hebbal,247450,30040,217410,0.8786017377247929,-1
5964,5965,Horamavu,98150,91570,6580,0.06704024452368823,1
5965,5966,Varthur,354100,90260,263840,0.74510025416549,0
5966,5967,Shivajinagar,114450,28980,85470,0.7467889908256881,0
5967,5968,Kammanahalli,73700,44070,29630,0.40203527815468115,1
5968,5969,Vasanth Nagar,150850,66010,84840,0.5624129930394431,0
5969,5970,Rajajinagar,405850,19180,386670,0.9527411605272884,-1
5970,5971,Krishnarajapuram,315750,130950,184800,0.5852731591448931,0
5971,5972,Hoodi,414750,31090,383660,0.9250391802290536,-1
5972,5973,Jalahalli,352150,120860,231290,0.6567939798381371,0
5973,5974,Varthur,384000,32490,351510,0.915390625,-1
5974,5975,Krishnarajapuram,347250,14140,333110,0.9592800575953924,-1
5975,5976,Whitefield,210150,53690,156460,0.7445158220318819,0
5976,5977,Shivajinagar,25150,32980,-7830,-0.31133200795228627,1
5977,5978,Kalyan Nagar,53150,24760,28390,0.5341486359360301,0
5978,5979,Malleswaram,100050,20120,79930,0.7989005497251375,0
5979,5980,Banaswadi,282400,72210,210190,0.744298866855524,0
5980,5981,Indiranagar,156750,85400,71350,0.4551834130781499,1
5981,5982,Varthur,182700,30090,152610,0.835303776683087,-1
5982,5983,Malleswaram,154200,75630,78570,0.5095330739299611,0
5983,5984,Kammanahalli,325100,53890,271210,0.8342356198092894,-1
5984,5985,Kammanahalli,75550,48680,26870,0.3556585043017869,1
5985,5986,Kammanahalli,154350,95860,58490,0.37894395853579527,1
5986,5987,Krishnarajapuram,205700,50370,155330,0.7551288283908605,0
5987,5988,Kalyan Nagar,235050,78200,156850,0.6673048287598383,0
5988,5989,Vasanth Nagar,27000,84520,-57520,-2.1303703703703705,1
5989,5990,Indiranagar,427550,41220,386330,0.9035902233656882,-1
5990,5991,Whitefield,32600,20910,11690,0.3585889570552147,1
5991,5992,Vasanth Nagar,85700,107760,-22060,-0.2574095682613769,1
5992,5993,Kammanahalli,65600,86930,-21330,-0.3251524390243902,1
5993,5994,Hoodi,371850,26300,345550,0.9292725561382278,-1
5994,5995,Marathahalli,369750,105760,263990,0.7139688979039892,0
5995,5996,Whitefield,139250,59270,79980,0.574362657091562,0
5996,5997,Kammanahalli,330500,37110,293390,0.887715582450832,-1
5997,5998,Jalahalli,416250,20760,395490,0.9501261261261261,-1
5998,5999,Rajajinagar,98200,79500,18700,0.19042769857433808,1
5999,6000,Kalyan Nagar,198600,49030,149570,0.7531218529707956,0
6000,6001,Kalyan Nagar,152350,44950,107400,0.7049556941253692,0
6001,6002,Malleswaram,381750,26780,354970,0.9298493778650949,-1
6002,6003,Whitefield,110800,25260,85540,0.7720216606498195,0
6003,6004,Shivajinagar,372400,20150,352250,0.9458915145005371,-1
6004,6005,Whitefield,228050,0,228050,1.0,-1
6005,6006,Marathahalli,157400,71400,86000,0.5463786531130876,0
6006,6007,Jalahalli,41900,77040,-35140,-0.8386634844868736,1
6007,6008,Horamavu,324450,49070,275380,0.8487594390507012,-1
6008,6009,Indiranagar,158600,93760,64840,0.40882723833543505,1
6009,6010,Horamavu,318950,36970,281980,0.8840884151120866,-1
6010,6011,Kammanahalli,386600,84880,301720,0.7804449042938437,0
6011,6012,Kalyan Nagar,320900,73150,247750,0.7720473667809287,0
6012,6013,CV Raman Nagar,91800,21130,70670,0.7698257080610021,0
6013,6014,Kammanahalli,167050,53950,113100,0.6770428015564203,0
6014,6015,HBR Layout,136350,67590,68760,0.5042904290429043,0
6015,6016,CV Raman Nagar,306700,81510,225190,0.7342354091946528,0
6016,6017,Whitefield,187400,124440,62960,0.335965848452508,1
6017,6018,Mahadevapura,26000,53000,-27000,-1.0384615384615385,1
6018,6019,Mahadevapura,359750,104870,254880,0.7084920083391244,0
6019,6020,CV Raman Nagar,260250,51780,208470,0.8010374639769452,-1
6020,6021,Kammanahalli,409200,62450,346750,0.8473851417399805,-1
6021,6022,Hoodi,203650,59680,143970,0.7069481954333415,0
6022,6023,Shivajinagar,314550,33910,280640,0.8921951994913369,-1
6023,6024,Shivajinagar,240000,93230,146770,0.6115416666666667,0
6024,6025,Jalahalli,80650,37520,43130,0.5347799132052077,0
6025,6026,Indiranagar,276550,26290,250260,0.9049358163080817,-1
6026,6027,Hebbal,302800,9710,293090,0.9679326287978864,-1
6027,6028,Kammanahalli,439900,88920,350980,0.7978631507160718,0
6028,6029,Indiranagar,115350,94730,20620,0.1787602947550932,1
6029,6030,Jalahalli,42050,103280,-61230,-1.4561236623067777,1
6030,6031,Shivajinagar,209650,13810,195840,0.9341283090865729,-1
6031,6032,Malleswaram,96150,74890,21260,0.22111284451378055,1
6032,6033,Kammanahalli,390750,104660,286090,0.7321561100447856,0
6033,6034,Kalyan Nagar,419050,50210,368840,0.8801813626058943,-1
6034,6035,Marathahalli,277000,52510,224490,0.8104332129963899,-1
6035,6036,Malleswaram,329550,69330,260220,0.7896222121074192,0
6036,6037,Jalahalli,87450,107810,-20360,-0.23281875357347057,1
6037,6038,Whitefield,71150,112000,-40850,-0.5741391426563598,1
6038,6039,Mahadevapura,184650,77810,106840,0.5786081776333604,0
6039,6040,Indiranagar,44200,75700,-31500,-0.7126696832579186,1
6040,6041,CV Raman Nagar,76450,75960,490,0.006409417920209287,1
6041,6042,Marathahalli,414950,41980,372970,0.8988311844800578,-1
6042,6043,Jalahalli,175650,119860,55790,0.317620267577569,1
6043,6044,Jalahalli,430400,96800,333600,0.775092936802974,0
6044,6045,Horamavu,361450,106710,254740,0.7047724443214829,0
6045,6046,Hoodi,192150,47580,144570,0.7523809523809524,0
6046,6047,Indiranagar,254950,102330,152620,0.598627181800353,0
6047,6048,HBR Layout,343850,43390,300460,0.8738112549076632,-1
6048,6049,Shivajinagar,251300,46770,204530,0.8138877835256665,-1
6049,6050,Horamavu,346050,36120,309930,0.8956220199393151,-1
6050,6051,Malleswaram,392800,50190,342610,0.8722250509164969,-1
6051,6052,Hoodi,132850,86570,46280,0.3483628152051186,1
6052,6053,Malleswaram,84750,55580,29170,0.34418879056047197,1
6053,6054,HBR Layout,40900,21880,19020,0.4650366748166259,1
6054,6055,Mahadevapura,36450,74100,-37650,-1.0329218106995885,1
6055,6056,Indiranagar,296400,34170,262230,0.8847165991902834,-1
6056,6057,Mahadevapura,156950,110930,46020,0.29321439949028355,1
6057,6058,Rajajinagar,126750,80150,46600,0.36765285996055225,1
6058,6059,Jalahalli,121500,75110,46390,0.38181069958847735,1
6059,6060,CV Raman Nagar,419450,50560,368890,0.8794611991894147,-1
6060,6061,HBR Layout,384100,42230,341870,0.8900546732621714,-1
6061,6062,Shivajinagar,58750,112300,-53550,-0.9114893617021277,1
6062,6063,Hebbal,71650,89890,-18240,-0.2545708304256804,1
6063,6064,Jalahalli,106300,97150,9150,0.08607714016933207,1
6064,6065,Banaswadi,310550,62400,248150,0.7990661729190146,0
6065,6066,Krishnarajapuram,320800,82930,237870,0.7414900249376558,0
6066,6067,Shivajinagar,281700,64100,217600,0.7724529641462549,0
6067,6068,Kalyan Nagar,290650,25750,264900,0.9114054704971616,-1
6068,6069,Vasanth Nagar,65200,75200,-10000,-0.15337423312883436,1
6069,6070,Horamavu,401400,107440,293960,0.7323368211260588,0
6070,6071,Rajajinagar,144000,58910,85090,0.5909027777777778,0
6071,6072,CV Raman Nagar,137100,71580,65520,0.47789934354485775,1
6072,6073,CV Raman Nagar,202800,9180,193620,0.9547337278106509,-1
6073,6074,Vasanth Nagar,294500,89900,204600,0.6947368421052632,0
6074,6075,Hebbal,286200,31040,255160,0.8915443745632425,-1
6075,6076,Indiranagar,192550,26440,166110,0.8626850168787328,-1
6076,6077,Banaswadi,172700,74320,98380,0.5696583671105964,0
6077,6078,Hoodi,169650,93980,75670,0.44603595638078397,1
6078,6079,Vasanth Nagar,62000,54220,7780,0.12548387096774194,1
6079,6080,Malleswaram,39000,39820,-820,-0.021025641025641025,1
6080,6081,HBR Layout,173800,134430,39370,0.22652474108170312,1
6081,6082,Mahadevapura,250750,57460,193290,0.7708474576271186,0
6082,6083,Vasanth Nagar,103550,85160,18390,0.17759536455818445,1
6083,6084,Hoodi,366800,58130,308670,0.8415212649945475,-1
6084,6085,Mahadevapura,67000,21670,45330,0.6765671641791045,0
6085,6086,Kalyan Nagar,30200,79670,-49470,-1.6380794701986754,1
6086,6087,Banaswadi,63400,64930,-1530,-0.02413249211356467,1
6087,6088,Kalyan Nagar,94500,74220,20280,0.2146031746031746,1
6088,6089,Hoodi,437250,67450,369800,0.8457404230989136,-1
6089,6090,Banaswadi,178800,33830,144970,0.8107941834451902,-1
6090,6091,Jalahalli,319100,127200,191900,0.6013788780946412,0
6091,6092,Rajajinagar,185050,56660,128390,0.6938124831126723,0
6092,6093,Whitefield,410550,39450,371100,0.9039093898428937,-1
6093,6094,CV Raman Nagar,33350,89210,-55860,-1.6749625187406296,1
6094,6095,Marathahalli,319800,9230,310570,0.9711382113821139,-1
6095,6096,Rajajinagar,386350,78380,307970,0.7971269574220267,0
6096,6097,Kalyan Nagar,148300,27930,120370,0.8116655428186109,-1
6097,6098,Whitefield,348800,45120,303680,0.8706422018348624,-1
6098,6099,Krishnarajapuram,157100,37400,119700,0.7619350732017823,0
6099,6100,Shivajinagar,352000,31510,320490,0.9104829545454546,-1
6100,6101,Rajajinagar,136750,9190,127560,0.9327970749542962,-1
6101,6102,Whitefield,429500,75240,354260,0.8248195576251455,-1
6102,6103,Rajajinagar,138600,124370,14230,0.10266955266955267,1
6103,6104,Jalahalli,328150,43460,284690,0.867560566813957,-1
6104,6105,Whitefield,102800,39380,63420,0.6169260700389105,0
6105,6106,CV Raman Nagar,194950,49900,145050,0.7440369325468069,0
6106,6107,Banaswadi,136450,40140,96310,0.7058263100036644,0
6107,6108,Indiranagar,217500,40430,177070,0.8141149425287356,-1
6108,6109,Horamavu,299550,37080,262470,0.8762143214822233,-1
6109,6110,Hoodi,394450,95560,298890,0.7577386233996705,0
6110,6111,Whitefield,253300,106930,146370,0.5778523489932886,0
6111,6112,Jalahalli,373850,44630,329220,0.8806205697472248,-1
6112,6113,CV Raman Nagar,97550,20760,76790,0.7871860584315735,0
6113,6114,Kammanahalli,375700,60970,314730,0.8377162629757785,-1
6114,6115,Banaswadi,436350,77410,358940,0.822596539475192,-1
6115,6116,Jalahalli,270550,84040,186510,0.6893734984291259,0
6116,6117,Mahadevapura,324800,88800,236000,0.7266009852216748,0
6117,6118,Rajajinagar,321400,33450,287950,0.8959240821406347,-1
6118,6119,Indiranagar,40900,34740,6160,0.1506112469437653,1
6119,6120,Horamavu,193750,27530,166220,0.8579096774193549,-1
6120,6121,Vasanth Nagar,258900,34410,224490,0.8670915411355736,-1
6121,6122,Hebbal,403150,15960,387190,0.9604117574103932,-1
6122,6123,Malleswaram,420850,19200,401650,0.9543780444338839,-1
6123,6124,Whitefield,161450,24670,136780,0.847197274698049,-1
6124,6125,CV Raman Nagar,414000,27920,386080,0.93256038647343,-1
6125,6126,Shivajinagar,135250,56890,78360,0.5793715341959335,0
6126,6127,Marathahalli,408500,57490,351010,0.859265605875153,-1
6127,6128,Kammanahalli,35150,38410,-3260,-0.09274537695590328,1
6128,6129,Whitefield,285650,48400,237250,0.830561876422195,-1
6129,6130,HBR Layout,106550,75240,31310,0.2938526513374003,1
6130,6131,Jalahalli,397100,116820,280280,0.7058171745152355,0
6131,6132,Jalahalli,362650,189240,173410,0.4781745484627051,1
6132,6133,Mahadevapura,400300,67590,332710,0.8311516362727954,-1
6133,6134,Indiranagar,356250,103590,252660,0.709221052631579,0
6134,6135,Malleswaram,179600,37570,142030,0.7908129175946548,0
6135,6136,Whitefield,158300,92570,65730,0.41522425773847127,1
6136,6137,Kalyan Nagar,180300,72350,107950,0.598724348308375,0
6137,6138,Vasanth Nagar,438300,38560,399740,0.9120237280401552,-1
6138,6139,Shivajinagar,206150,63740,142410,0.6908076643220956,0
6139,6140,Shivajinagar,66200,12720,53480,0.8078549848942598,-1
6140,6141,Hebbal,130850,86720,44130,0.33725640045854033,1
6141,6142,Kalyan Nagar,208300,18290,190010,0.9121939510321652,-1
6142,6143,Vasanth Nagar,85700,93150,-7450,-0.08693115519253208,1
6143,6144,Horamavu,311250,93500,217750,0.6995983935742972,0
6144,6145,Mahadevapura,369100,62610,306490,0.8303711731238147,-1
6145,6146,Mahadevapura,302550,64930,237620,0.7853908444885143,0
6146,6147,Hoodi,390050,102420,287630,0.7374182797077298,0
6147,6148,Banaswadi,99550,58830,40720,0.40904068307383223,1
6148,6149,Krishnarajapuram,363050,19150,343900,0.9472524445668641,-1
6149,6150,HBR Layout,314650,70030,244620,0.7774352455108852,0
6150,6151,Rajajinagar,382100,57740,324360,0.8488877257262497,-1
6151,6152,Marathahalli,336600,88410,248190,0.7373440285204991,0
6152,6153,CV Raman Nagar,205100,63340,141760,0.691175036567528,0
6153,6154,Krishnarajapuram,267900,85720,182180,0.6800298618887645,0
6154,6155,Hebbal,310000,63970,246030,0.7936451612903226,0
6155,6156,Hoodi,321600,28280,293320,0.9120646766169154,-1
6156,6157,Vasanth Nagar,410950,40130,370820,0.9023482175447135,-1
6157,6158,Rajajinagar,304350,24460,279890,0.9196320026285526,-1
6158,6159,Krishnarajapuram,165050,62070,102980,0.6239321417752196,0
6159,6160,Hoodi,372000,51970,320030,0.8602956989247312,-1
6160,6161,Shivajinagar,85100,69460,15640,0.1837837837837838,1
6161,6162,Mahadevapura,45950,32940,13010,0.28313384113166484,1
6162,6163,Indiranagar,398500,50300,348200,0.8737766624843162,-1
6163,6164,Mahadevapura,135150,157270,-22120,-0.16366999630040696,1
6164,6165,CV Raman Nagar,190350,46990,143360,0.7531389545573943,0
6165,6166,Rajajinagar,215450,50660,164790,0.7648642376421444,0
6166,6167,CV Raman Nagar,270600,42370,228230,0.8434220251293422,-1
6167,6168,Mahadevapura,232750,50170,182580,0.7844468313641246,0
6168,6169,Varthur,430150,56350,373800,0.8689991863303499,-1
6169,6170,Indiranagar,283550,45740,237810,0.8386880620701817,-1
6170,6171,Kalyan Nagar,295200,82350,212850,0.7210365853658537,0
6171,6172,Rajajinagar,424950,24140,400810,0.9431933168608072,-1
6172,6173,Whitefield,49000,71420,-22420,-0.45755102040816326,1
6173,6174,Hebbal,36950,131630,-94680,-2.562381596752368,1
6174,6175,Horamavu,362500,35710,326790,0.9014896551724138,-1
6175,6176,Shivajinagar,403600,63110,340490,0.8436323092170466,-1
6176,6177,Banaswadi,59800,36270,23530,0.3934782608695652,1
6177,6178,CV Raman Nagar,202300,20840,181460,0.8969846762234306,-1
6178,6179,Shivajinagar,215200,77200,138000,0.6412639405204461,0
6179,6180,Shivajinagar,349200,69420,279780,0.8012027491408935,-1
6180,6181,Hebbal,391000,41890,349110,0.8928644501278772,-1
6181,6182,Mahadevapura,330400,50470,279930,0.8472457627118644,-1
6182,6183,Banaswadi,55550,89200,-33650,-0.6057605760576058,1
6183,6184,Hoodi,247450,78690,168760,0.6819963629015963,0
6184,6185,Kalyan Nagar,365450,60360,305090,0.8348337665891367,-1
6185,6186,Kammanahalli,176350,59430,116920,0.6629997164729232,0
6186,6187,Jalahalli,245800,89410,156390,0.6362489829129373,0
6187,6188,Horamavu,151600,103850,47750,0.3149736147757256,1
6188,6189,Horamavu,288200,79650,208550,0.7236294240111034,0
6189,6190,Indiranagar,112200,69330,42870,0.3820855614973262,1
6190,6191,Hebbal,416100,165660,250440,0.6018745493871666,0
6191,6192,Malleswaram,399200,60970,338230,0.8472695390781563,-1
6192,6193,Vasanth Nagar,32300,85780,-53480,-1.6557275541795666,1
6193,6194,Vasanth Nagar,91350,57010,34340,0.3759168035030104,1
6194,6195,Malleswaram,343600,75330,268270,0.7807625145518045,0
6195,6196,Marathahalli,225600,55460,170140,0.7541666666666667,0
6196,6197,Varthur,238000,61380,176620,0.7421008403361344,0
6197,6198,Horamavu,432150,76950,355200,0.8219368274904547,-1
6198,6199,Whitefield,407600,50030,357570,0.8772571148184495,-1
6199,6200,Kammanahalli,155600,74140,81460,0.5235218508997429,0
6200,6201,HBR Layout,179950,82000,97950,0.5443178660739094,0
6201,6202,Kalyan Nagar,364400,12150,352250,0.9666575192096597,-1
6202,6203,CV Raman Nagar,293200,66970,226230,0.7715893587994543,0
6203,6204,Vasanth Nagar,124150,77680,46470,0.3743052758759565,1
6204,6205,Rajajinagar,226000,36340,189660,0.8392035398230089,-1
6205,6206,Krishnarajapuram,395600,49670,345930,0.8744438827098079,-1
6206,6207,Krishnarajapuram,219050,45200,173850,0.7936544167998174,0
6207,6208,Hebbal,332400,60570,271830,0.8177797833935018,-1
6208,6209,Kalyan Nagar,60800,90500,-29700,-0.48848684210526316,1
6209,6210,Rajajinagar,352200,39750,312450,0.887137989778535,-1
6210,6211,Hebbal,201950,69470,132480,0.6560039613765783,0
6211,6212,CV Raman Nagar,384200,74480,309720,0.8061426340447684,-1
6212,6213,Banaswadi,446300,82070,364230,0.8161102397490477,-1
6213,6214,Malleswaram,88900,49500,39400,0.4431946006749156,1
6214,6215,Malleswaram,84000,66710,17290,0.20583333333333334,1
6215,6216,Indiranagar,431300,98790,332510,0.7709482958497565,0
6216,6217,Indiranagar,132400,162240,-29840,-0.2253776435045317,1
6217,6218,Hebbal,267950,16610,251340,0.9380108229147229,-1
6218,6219,Varthur,248400,11290,237110,0.9545491143317231,-1
6219,6220,HBR Layout,402750,61660,341090,0.8469025450031037,-1
6220,6221,Hebbal,69550,48480,21070,0.30294751976994966,1
6221,6222,Malleswaram,278400,79260,199140,0.715301724137931,0
6222,6223,Rajajinagar,167750,70060,97690,0.582354694485842,0
6223,6224,Hoodi,137050,7600,129450,0.9445457862094127,-1
6224,6225,Indiranagar,394950,26280,368670,0.9334599316369161,-1
6225,6226,Vasanth Nagar,348450,90070,258380,0.7415124121107763,0
6226,6227,Shivajinagar,448450,53530,394920,0.8806332924517783,-1
6227,6228,Malleswaram,45650,78750,-33100,-0.7250821467688937,1
6228,6229,Indiranagar,196550,76520,120030,0.6106843042482829,0
6229,6230,Kalyan Nagar,249100,131640,117460,0.47153753512645524,1
6230,6231,Shivajinagar,365750,105530,260220,0.7114695830485304,0
6231,6232,Malleswaram,432550,105720,326830,0.7555889492544214,0
6232,6233,Malleswaram,108450,47650,60800,0.5606270170585523,0
6233,6234,Hoodi,68850,31910,36940,0.5365286855482934,0
6234,6235,Rajajinagar,338400,55190,283210,0.8369089834515366,-1
6235,6236,Krishnarajapuram,104400,78450,25950,0.24856321839080459,1
6236,6237,HBR Layout,411500,30490,381010,0.9259052247873633,-1
6237,6238,Banaswadi,336250,9680,326570,0.9712118959107807,-1
6238,6239,Rajajinagar,209200,37540,171660,0.8205544933078394,-1
6239,6240,Vasanth Nagar,296500,109040,187460,0.6322428330522766,0
6240,6241,Vasanth Nagar,86650,42200,44450,0.5129832660126947,0
6241,6242,Krishnarajapuram,205800,82770,123030,0.5978134110787172,0
6242,6243,Hoodi,273700,68240,205460,0.7506759225429303,0
6243,6244,Banaswadi,159200,37490,121710,0.7645100502512563,0
6244,6245,Mahadevapura,155550,41660,113890,0.7321761491481839,0
6245,6246,Horamavu,102200,103330,-1130,-0.011056751467710372,1
6246,6247,Krishnarajapuram,274150,56800,217350,0.7928141528360386,0
6247,6248,Kalyan Nagar,399300,101730,297570,0.745229151014275,0
6248,6249,Hoodi,384200,95470,288730,0.7515096304008329,0
6249,6250,Kammanahalli,246200,68070,178130,0.7235174654752234,0
6250,6251,Krishnarajapuram,36950,69110,-32160,-0.8703653585926928,1
6251,6252,CV Raman Nagar,270350,110420,159930,0.5915664878860736,0
6252,6253,Rajajinagar,425050,36720,388330,0.9136101635101753,-1
6253,6254,Indiranagar,197100,106530,90570,0.4595129375951294,1
6254,6255,Mahadevapura,52550,63210,-10660,-0.20285442435775453,1
6255,6256,Jalahalli,132650,67220,65430,0.49325292122125897,1
6256,6257,Krishnarajapuram,142700,152030,-9330,-0.06538192011212333,1
6257,6258,HBR Layout,429000,26770,402230,0.9375990675990676,-1
6258,6259,Mahadevapura,202800,87780,115020,0.5671597633136095,0
6259,6260,Rajajinagar,220450,34840,185610,0.8419596280335677,-1
6260,6261,Krishnarajapuram,67450,41490,25960,0.3848776871756857,1
6261,6262,Mahadevapura,142950,55110,87840,0.6144805876180482,0
6262,6263,Varthur,282100,65500,216600,0.7678128323289614,0
6263,6264,Shivajinagar,359750,34270,325480,0.904739402362752,-1
6264,6265,Kammanahalli,234550,85550,149000,0.6352590066083991,0
6265,6266,Krishnarajapuram,388650,0,388650,1.0,-1
6266,6267,Kammanahalli,267050,136550,130500,0.48867253323347687,1
6267,6268,Krishnarajapuram,319100,95960,223140,0.6992792228141649,0
6268,6269,Horamavu,326350,118760,207590,0.6360962157193197,0
6269,6270,Rajajinagar,406500,92150,314350,0.7733087330873308,0
6270,6271,Kammanahalli,438900,79360,359540,0.8191843244474823,-1
6271,6272,Jalahalli,75250,88030,-12780,-0.16983388704318936,1
6272,6273,Hebbal,86650,90270,-3620,-0.04177726485862666,1
6273,6274,Banaswadi,95400,14220,81180,0.8509433962264151,-1
6274,6275,HBR Layout,279250,33460,245790,0.8801790510295434,-1
6275,6276,Krishnarajapuram,167350,75980,91370,0.5459814759486107,0
6276,6277,HBR Layout,284850,103010,181840,0.6383710724942953,0
6277,6278,Vasanth Nagar,27000,54090,-27090,-1.0033333333333334,1
6278,6279,Hoodi,378800,54300,324500,0.8566525871172123,-1
6279,6280,Banaswadi,174400,108810,65590,0.3760894495412844,1
6280,6281,Hoodi,71000,49450,21550,0.30352112676056336,1
6281,6282,CV Raman Nagar,414000,99760,314240,0.7590338164251208,0
6282,6283,Krishnarajapuram,169950,79560,90390,0.5318623124448367,0
6283,6284,Varthur,57800,65160,-7360,-0.1273356401384083,1
6284,6285,Jalahalli,144300,66910,77390,0.5363132363132364,0
6285,6286,Mahadevapura,44850,70370,-25520,-0.5690078037904125,1
6286,6287,CV Raman Nagar,403450,35200,368250,0.9127525096046598,-1
6287,6288,Hebbal,152050,119780,32270,0.2122328181519237,1
6288,6289,Krishnarajapuram,125300,52260,73040,0.5829209896249002,0
6289,6290,Banaswadi,254500,112180,142320,0.5592141453831041,0
6290,6291,Malleswaram,255700,43400,212300,0.8302698474775128,-1
6291,6292,Hebbal,118050,14110,103940,0.8804743752647184,-1
6292,6293,Shivajinagar,171400,98640,72760,0.42450408401400236,1
6293,6294,Horamavu,265750,52270,213480,0.8033113828786453,-1
6294,6295,Kalyan Nagar,194200,46360,147840,0.7612770339855819,0
6295,6296,Krishnarajapuram,295550,75990,219560,0.7428861444763999,0
6296,6297,Varthur,94400,84630,9770,0.1034957627118644,1
6297,6298,Indiranagar,320300,46830,273470,0.853793318763659,-1
6298,6299,Malleswaram,46000,77230,-31230,-0.6789130434782609,1
6299,6300,Whitefield,114450,41110,73340,0.6408038444735692,0
6300,6301,HBR Layout,279450,93310,186140,0.6660941134371086,0
6301,6302,Hebbal,97950,85360,12590,0.12853496681980603,1
6302,6303,Jalahalli,344050,114800,229250,0.6663275686673449,0
6303,6304,Hebbal,30800,45460,-14660,-0.475974025974026,1
6304,6305,Whitefield,195000,41630,153370,0.7865128205128206,0
6305,6306,Varthur,328500,22300,306200,0.9321156773211567,-1
6306,6307,Shivajinagar,227300,104930,122370,0.5383633963924329,0
6307,6308,Malleswaram,89800,53500,36300,0.4042316258351893,1
6308,6309,Marathahalli,378700,52620,326080,0.8610509638236071,-1
6309,6310,CV Raman Nagar,142450,85410,57040,0.40042120042120044,1
6310,6311,Kalyan Nagar,70900,17010,53890,0.7600846262341325,0
6311,6312,Banaswadi,364000,10530,353470,0.9710714285714286,-1
6312,6313,Banaswadi,317500,27210,290290,0.9142992125984252,-1
6313,6314,Horamavu,389650,45550,344100,0.8831002181444887,-1
6314,6315,Hoodi,241600,29290,212310,0.8787665562913908,-1
6315,6316,Hoodi,103450,54700,48750,0.4712421459642339,1
6316,6317,Vasanth Nagar,180250,86650,93600,0.5192787794729542,0
6317,6318,Rajajinagar,107800,11520,96280,0.8931354359925788,-1
6318,6319,Whitefield,442300,98350,343950,0.7776396111236717,0
6319,6320,Varthur,422250,41350,380900,0.9020722320899941,-1
6320,6321,Whitefield,237150,54330,182820,0.7709044908285895,0
6321,6322,Krishnarajapuram,127150,64780,62370,0.4905230043255997,1
6322,6323,Horamavu,333350,48510,284840,0.8544772761361932,-1
6323,6324,HBR Layout,77700,37340,40360,0.5194337194337194,0
6324,6325,Shivajinagar,435350,79440,355910,0.8175261284024348,-1
6325,6326,Hoodi,30850,97060,-66210,-2.146191247974068,1
6326,6327,Shivajinagar,31450,5400,26050,0.8282988871224165,-1
6327,6328,Banaswadi,116700,76740,39960,0.3424164524421594,1
6328,6329,Hebbal,313700,31380,282320,0.8999681224099458,-1
6329,6330,Shivajinagar,439700,95320,344380,0.7832158289743006,0
6330,6331,Marathahalli,288100,101530,186570,0.6475876431794516,0
6331,6332,Whitefield,259050,34830,224220,0.8655471916618414,-1
6332,6333,Kammanahalli,196650,81780,114870,0.5841342486651411,0
6333,6334,HBR Layout,122050,60200,61850,0.5067595247849243,0
6334,6335,Banaswadi,410750,51690,359060,0.8741570298234936,-1
6335,6336,Vasanth Nagar,395750,140940,254810,0.6438660770688566,0
6336,6337,Marathahalli,74500,87120,-12620,-0.16939597315436242,1
6337,6338,Marathahalli,250200,39370,210830,0.8426458832933653,-1
6338,6339,Vasanth Nagar,359950,42270,317680,0.8825670231976663,-1
6339,6340,Rajajinagar,310850,20930,289920,0.9326684896252212,-1
6340,6341,Malleswaram,237750,71800,165950,0.6980021030494217,0
6341,6342,Kalyan Nagar,357400,114580,242820,0.6794068270844992,0
6342,6343,Malleswaram,228900,53890,175010,0.7645696810834426,0
6343,6344,Kalyan Nagar,85500,68850,16650,0.19473684210526315,1
6344,6345,Shivajinagar,276850,70610,206240,0.7449521401480946,0
6345,6346,Varthur,223400,97590,125810,0.5631602506714414,0
6346,6347,Kalyan Nagar,372900,123810,249090,0.6679806918744972,0
6347,6348,Jalahalli,287200,86850,200350,0.6975974930362117,0
6348,6349,Marathahalli,251650,51420,200230,0.7956685873236639,0
6349,6350,Banaswadi,184950,75570,109380,0.5914030819140308,0
6350,6351,Hoodi,272450,23230,249220,0.9147366489264085,-1
6351,6352,CV Raman Nagar,210600,70650,139950,0.6645299145299145,0
6352,6353,Rajajinagar,218600,22200,196400,0.898444647758463,-1
6353,6354,Rajajinagar,240200,38040,202160,0.8416319733555371,-1
6354,6355,Shivajinagar,120650,109310,11340,0.09399088271860755,1
6355,6356,Krishnarajapuram,146100,49820,96280,0.6590006844626968,0
6356,6357,Kalyan Nagar,251000,78990,172010,0.6852988047808765,0
6357,6358,CV Raman Nagar,272400,19240,253160,0.9293685756240823,-1
6358,6359,Krishnarajapuram,258400,9290,249110,0.9640479876160991,-1
6359,6360,Krishnarajapuram,46500,69870,-23370,-0.5025806451612903,1
6360,6361,Jalahalli,98350,48180,50170,0.5101169293340112,0
6361,6362,Krishnarajapuram,245900,58660,187240,0.7614477429849532,0
6362,6363,Varthur,238950,56250,182700,0.7645951035781544,0
6363,6364,Hebbal,408200,52050,356150,0.8724889759921607,-1
6364,6365,Kalyan Nagar,242050,39950,202100,0.8349514563106796,-1
6365,6366,CV Raman Nagar,205850,84510,121340,0.5894583434539713,0
6366,6367,Mahadevapura,166050,84100,81950,0.4935260463715748,1
6367,6368,Hebbal,128900,53530,75370,0.5847168347556245,0
6368,6369,CV Raman Nagar,232500,16490,216010,0.9290752688172043,-1
6369,6370,HBR Layout,138850,46510,92340,0.665034209578682,0
6370,6371,Kammanahalli,204650,21520,183130,0.8948448570730515,-1
6371,6372,Horamavu,432250,67010,365240,0.844973973395026,-1
6372,6373,Kammanahalli,311750,55780,255970,0.821074578989575,-1
6373,6374,Kalyan Nagar,317800,106620,211180,0.664505978602895,0
6374,6375,Mahadevapura,228550,80070,148480,0.6496609057099103,0
6375,6376,Mahadevapura,423000,91740,331260,0.7831205673758865,0
6376,6377,Malleswaram,411900,20840,391060,0.9494051954357854,-1
6377,6378,Rajajinagar,361550,63890,297660,0.8232886184483474,-1
6378,6379,Varthur,238050,137700,100350,0.4215500945179584,1
6379,6380,Vasanth Nagar,159700,45860,113840,0.7128365685660614,0
6380,6381,Mahadevapura,375600,80380,295220,0.7859957401490948,0
6381,6382,Hebbal,307050,102590,204460,0.6658850350105846,0
6382,6383,Indiranagar,274000,46120,227880,0.8316788321167883,-1
6383,6384,CV Raman Nagar,270700,46730,223970,0.8273734761728851,-1
6384,6385,Marathahalli,284200,113530,170670,0.6005277973258268,0
6385,6386,Krishnarajapuram,150000,39440,110560,0.7370666666666666,0
6386,6387,CV Raman Nagar,116600,32250,84350,0.7234133790737565,0
6387,6388,Marathahalli,277200,91530,185670,0.6698051948051948,0
6388,6389,Varthur,96500,71650,24850,0.25751295336787566,1
6389,6390,Banaswadi,173650,25360,148290,0.8539591131586525,-1
6390,6391,Mahadevapura,393400,82990,310410,0.7890442297915607,0
6391,6392,Malleswaram,272550,49510,223040,0.8183452577508714,-1
6392,6393,Varthur,156550,71510,85040,0.5432130309805174,0
6393,6394,Horamavu,372300,61130,311170,0.8358044587698092,-1
6394,6395,Shivajinagar,356900,40560,316340,0.8863547212104231,-1
6395,6396,Horamavu,78150,81920,-3770,-0.048240563019833656,1
6396,6397,Horamavu,228050,62410,165640,0.7263319447489586,0
6397,6398,Krishnarajapuram,408650,44000,364650,0.892328398384926,-1
6398,6399,Krishnarajapuram,370200,40740,329460,0.8899513776337115,-1
6399,6400,Kammanahalli,66850,42550,24300,0.36350037397157814,1
6400,6401,Shivajinagar,242950,59390,183560,0.7555464087260754,0
6401,6402,Whitefield,411250,110830,300420,0.7305045592705167,0
6402,6403,Whitefield,419600,100140,319460,0.7613441372735938,0
6403,6404,Varthur,147850,126820,21030,0.14223875549543455,1
6404,6405,Malleswaram,36950,34960,1990,0.05385656292286874,1
6405,6406,Mahadevapura,401400,55530,345870,0.861659192825112,-1
6406,6407,Kammanahalli,291650,36730,254920,0.8740613749357106,-1
6407,6408,Marathahalli,229600,37250,192350,0.8377613240418118,-1
6408,6409,Mahadevapura,25400,34860,-9460,-0.3724409448818898,1
6409,6410,HBR Layout,46950,116260,-69310,-1.4762513312034078,1
6410,6411,Hoodi,238650,21140,217510,0.9114183951393253,-1
6411,6412,Rajajinagar,436050,101940,334110,0.7662194702442381,0
6412,6413,Hoodi,177250,54210,123040,0.6941607898448519,0
6413,6414,Indiranagar,95000,107450,-12450,-0.13105263157894737,1
6414,6415,Vasanth Nagar,280350,96430,183920,0.6560370964865347,0
6415,6416,Rajajinagar,315450,30850,284600,0.9022032017752417,-1
6416,6417,Malleswaram,206250,35140,171110,0.8296242424242424,-1
6417,6418,Rajajinagar,44800,53660,-8860,-0.19776785714285713,1
6418,6419,Krishnarajapuram,238950,46510,192440,0.8053567691985771,-1
6419,6420,Marathahalli,231450,47090,184360,0.7965435299200692,0
6420,6421,Marathahalli,247600,28680,218920,0.8841680129240711,-1
6421,6422,Whitefield,97600,90790,6810,0.06977459016393443,1
6422,6423,Vasanth Nagar,160950,54570,106380,0.660950605778192,0
6423,6424,Kammanahalli,191400,19030,172370,0.9005747126436782,-1
6424,6425,Hoodi,84650,40160,44490,0.5255759007678676,0
6425,6426,Kalyan Nagar,149150,71520,77630,0.5204827355011733,0
6426,6427,Banaswadi,90650,58300,32350,0.35686707115278543,1
6427,6428,CV Raman Nagar,81400,88170,-6770,-0.08316953316953317,1
6428,6429,Shivajinagar,87600,59380,28220,0.3221461187214612,1
6429,6430,Malleswaram,383350,74330,309020,0.8061040824311987,-1
6430,6431,Mahadevapura,423100,45940,377160,0.8914204679744742,-1
6431,6432,Vasanth Nagar,338350,118490,219860,0.6498005024383036,0
6432,6433,Kalyan Nagar,69800,50550,19250,0.27578796561604585,1
6433,6434,Kammanahalli,353950,27620,326330,0.9219663794321232,-1
6434,6435,Krishnarajapuram,63700,81040,-17340,-0.27221350078492934,1
6435,6436,Hebbal,74700,85520,-10820,-0.14484605087014726,1
6436,6437,Hebbal,167550,15610,151940,0.9068337809609072,-1
6437,6438,Marathahalli,286950,56420,230530,0.803380379857118,-1
6438,6439,Jalahalli,150950,14310,136640,0.9052003974826102,-1
6439,6440,Whitefield,197100,59280,137820,0.6992389649923897,0
6440,6441,Indiranagar,393100,76670,316430,0.8049605698295599,-1
6441,6442,Varthur,298150,28400,269750,0.9047459332550729,-1
6442,6443,Varthur,386050,93070,292980,0.7589172386996503,0
6443,6444,Kalyan Nagar,232750,97310,135440,0.5819119226638023,0
6444,6445,Kalyan Nagar,96600,19070,77530,0.8025879917184265,-1
6445,6446,Vasanth Nagar,108200,53520,54680,0.5053604436229205,0
6446,6447,Malleswaram,354500,18900,335600,0.946685472496474,-1
6447,6448,Marathahalli,314900,113740,201160,0.6388059701492538,0
6448,6449,Banaswadi,46150,111370,-65220,-1.4132177681473457,1
6449,6450,Krishnarajapuram,318400,106700,211700,0.6648869346733668,0
6450,6451,Shivajinagar,201750,17040,184710,0.9155390334572491,-1
6451,6452,Jalahalli,77600,24880,52720,0.6793814432989691,0
6452,6453,Malleswaram,180050,54140,125910,0.6993057484032213,0
6453,6454,Marathahalli,203550,39930,163620,0.8038319823139278,-1
6454,6455,Hoodi,359200,89650,269550,0.7504175946547884,0
6455,6456,Varthur,125200,95420,29780,0.2378594249201278,1
6456,6457,CV Raman Nagar,283350,35450,247900,0.8748897123698606,-1
6457,6458,Horamavu,295200,47400,247800,0.8394308943089431,-1
6458,6459,Kammanahalli,192050,33090,158960,0.8277011195001301,-1
6459,6460,Hebbal,171800,119780,52020,0.3027939464493597,1
6460,6461,Marathahalli,416100,43460,372640,0.8955539533765922,-1
6461,6462,Horamavu,402450,69440,333010,0.827456826935023,-1
6462,6463,Krishnarajapuram,407550,57970,349580,0.8577597840755735,-1
6463,6464,Kammanahalli,114850,65710,49140,0.42786242925555074,1
6464,6465,Hoodi,294650,60730,233920,0.7938910571864924,0
6465,6466,Horamavu,228100,91570,136530,0.5985532661113546,0
6466,6467,Banaswadi,205900,62200,143700,0.6979116075764934,0
6467,6468,Hoodi,354150,56060,298090,0.841705492023154,-1
6468,6469,Krishnarajapuram,318550,118020,200530,0.629508711348297,0
6469,6470,Hebbal,41800,84210,-42410,-1.0145933014354067,1
6470,6471,Varthur,360100,7430,352670,0.9793668425437378,-1
6471,6472,Hoodi,92300,112410,-20110,-0.2178764897074756,1
6472,6473,Marathahalli,414350,61840,352510,0.8507541933148305,-1
6473,6474,Mahadevapura,139100,40700,98400,0.7074047447879224,0
6474,6475,Shivajinagar,104450,0,104450,1.0,-1
6475,6476,Vasanth Nagar,357250,95650,261600,0.7322603219034289,0
6476,6477,Vasanth Nagar,347150,74300,272850,0.7859714820682702,0
6477,6478,Kalyan Nagar,30250,105860,-75610,-2.499504132231405,1
6478,6479,CV Raman Nagar,350550,160050,190500,0.5434317501069748,0
6479,6480,Malleswaram,58500,39290,19210,0.32837606837606836,1
6480,6481,Whitefield,196900,95490,101410,0.5150330116810564,0
6481,6482,Banaswadi,148100,68150,79950,0.5398379473328832,0
6482,6483,Kalyan Nagar,202050,15680,186370,0.9223954466716159,-1
6483,6484,CV Raman Nagar,296100,73710,222390,0.7510638297872341,0
6484,6485,Vasanth Nagar,413650,87770,325880,0.7878157862927596,0
6485,6486,Indiranagar,331400,124940,206460,0.6229933614966807,0
6486,6487,Hoodi,285300,15640,269660,0.9451805117420259,-1
6487,6488,Horamavu,196400,44200,152200,0.774949083503055,0
6488,6489,Hoodi,98850,55740,43110,0.4361153262518968,1
6489,6490,Rajajinagar,226300,65840,160460,0.7090587715422006,0
6490,6491,Malleswaram,259000,55330,203670,0.7863706563706564,0
6491,6492,Shivajinagar,261750,90950,170800,0.652531041069723,0
6492,6493,Krishnarajapuram,125200,175440,-50240,-0.4012779552715655,1
6493,6494,Kammanahalli,127400,60740,66660,0.5232339089481947,0
6494,6495,CV Raman Nagar,320500,65340,255160,0.7961310452418097,0
6495,6496,Rajajinagar,291900,36720,255180,0.8742034943473792,-1
6496,6497,Vasanth Nagar,276050,110220,165830,0.6007245064299945,0
6497,6498,HBR Layout,180300,48380,131920,0.731669439822518,0
6498,6499,Whitefield,28150,41070,-12920,-0.4589698046181172,1
6499,6500,Shivajinagar,339800,101330,238470,0.701795173631548,0
6500,6501,Rajajinagar,60350,37150,23200,0.3844241922120961,1
6501,6502,Vasanth Nagar,28250,62460,-34210,-1.2109734513274337,1
6502,6503,Hebbal,437050,25920,411130,0.9406932845212218,-1
6503,6504,Marathahalli,204350,76350,128000,0.6263763151455836,0
6504,6505,Hoodi,336400,63490,272910,0.8112663495838288,-1
6505,6506,Indiranagar,445450,63890,381560,0.8565720058367943,-1
6506,6507,Jalahalli,384900,62760,322140,0.8369446609508964,-1
6507,6508,Kammanahalli,277200,49850,227350,0.8201659451659452,-1
6508,6509,Shivajinagar,38450,69290,-30840,-0.8020806241872562,1
6509,6510,Malleswaram,313950,8830,305120,0.971874502309285,-1
6510,6511,Rajajinagar,320000,47890,272110,0.85034375,-1
6511,6512,Shivajinagar,429050,75600,353450,0.8237967602843491,-1
6512,6513,Kalyan Nagar,272950,13640,259310,0.9500274775599927,-1
6513,6514,Shivajinagar,46850,68220,-21370,-0.456136606189968,1
6514,6515,HBR Layout,240050,77100,162950,0.6788169131430952,0
6515,6516,Krishnarajapuram,382300,88920,293380,0.7674077949254512,0
6516,6517,Hebbal,285750,29910,255840,0.8953280839895014,-1
6517,6518,Hebbal,313400,18090,295310,0.9422782386726228,-1
6518,6519,Banaswadi,78200,43490,34710,0.4438618925831202,1
6519,6520,Kammanahalli,376900,77870,299030,0.7933934730697798,0
6520,6521,Horamavu,128050,29720,98330,0.7679031628270206,0
6521,6522,Varthur,229800,6650,223150,0.9710617928633595,-1
6522,6523,Kalyan Nagar,269150,103690,165460,0.6147501393275125,0
6523,6524,HBR Layout,253700,29740,223960,0.8827749310208908,-1
6524,6525,Shivajinagar,105500,68410,37090,0.351563981042654,1
6525,6526,Jalahalli,105900,95570,10330,0.09754485363550519,1
6526,6527,Varthur,30150,73930,-43780,-1.4520729684908789,1
6527,6528,Kalyan Nagar,416450,60210,356240,0.8554208188257895,-1
6528,6529,Krishnarajapuram,65900,98850,-32950,-0.5,1
6529,6530,Mahadevapura,410500,9190,401310,0.9776126674786846,-1
6530,6531,Hebbal,409000,29120,379880,0.9288019559902201,-1
6531,6532,CV Raman Nagar,34000,114600,-80600,-2.3705882352941177,1
6532,6533,Hoodi,254650,32710,221940,0.8715491851560966,-1
6533,6534,Hebbal,345100,64260,280840,0.8137931034482758,-1
6534,6535,Mahadevapura,119100,34860,84240,0.7073047858942065,0
6535,6536,Banaswadi,176950,28730,148220,0.8376377507770557,-1
6536,6537,Indiranagar,293500,59900,233600,0.7959114139693356,0
6537,6538,Jalahalli,169050,35890,133160,0.7876959479443951,0
6538,6539,Varthur,333700,43610,290090,0.8693137548696434,-1
6539,6540,CV Raman Nagar,341000,46430,294570,0.863841642228739,-1
6540,6541,HBR Layout,266000,134780,131220,0.49330827067669175,1
6541,6542,Krishnarajapuram,391950,56790,335160,0.8551090700344431,-1
6542,6543,Rajajinagar,199400,116160,83240,0.41745235707121364,1
6543,6544,Indiranagar,47900,63250,-15350,-0.32045929018789143,1
6544,6545,Hebbal,400150,42050,358100,0.8949144070973385,-1
6545,6546,Jalahalli,268700,54890,213810,0.7957201339784146,0
6546,6547,Indiranagar,198100,50180,147920,0.7466935890964159,0
6547,6548,Indiranagar,62800,43670,19130,0.3046178343949045,1
6548,6549,Banaswadi,229150,102270,126880,0.5536984507964215,0
6549,6550,Mahadevapura,220650,89370,131280,0.5949694085656017,0
6550,6551,Hebbal,380450,56990,323460,0.8502037061374688,-1
6551,6552,Vasanth Nagar,356900,13050,343850,0.9634351358924068,-1
6552,6553,Krishnarajapuram,379850,35500,344350,0.9065420560747663,-1
6553,6554,Malleswaram,123600,26310,97290,0.7871359223300971,0
6554,6555,Shivajinagar,197950,38760,159190,0.8041929780247538,-1
6555,6556,Krishnarajapuram,425800,69400,356400,0.8370126820103335,-1
6556,6557,Kammanahalli,127500,92190,35310,0.27694117647058825,1
6557,6558,Shivajinagar,229100,72910,156190,0.6817546922741161,0
6558,6559,Indiranagar,173950,40290,133660,0.7683817188847369,0
6559,6560,Shivajinagar,368950,82070,286880,0.7775579346794959,0
6560,6561,Rajajinagar,61650,80170,-18520,-0.30040551500405516,1
6561,6562,Banaswadi,427350,45020,382330,0.8946530946530946,-1
6562,6563,Rajajinagar,426550,69510,357040,0.8370413785019342,-1
6563,6564,Jalahalli,75800,86830,-11030,-0.14551451187335093,1
6564,6565,HBR Layout,313600,47880,265720,0.8473214285714286,-1
6565,6566,Horamavu,350600,49020,301580,0.8601825442099258,-1
6566,6567,CV Raman Nagar,215150,77090,138060,0.6416918429003021,0
6567,6568,Marathahalli,205100,55810,149290,0.7278888347147733,0
6568,6569,Shivajinagar,295300,64690,230610,0.7809346427362005,0
6569,6570,Jalahalli,196900,43450,153450,0.7793296089385475,0
6570,6571,Vasanth Nagar,199100,36510,162590,0.816624811652436,-1
6571,6572,Whitefield,328700,54570,274130,0.8339823547307575,-1
6572,6573,Mahadevapura,228050,125190,102860,0.45104143828107873,1
6573,6574,HBR Layout,175800,13010,162790,0.925995449374289,-1
6574,6575,HBR Layout,175850,8210,167640,0.9533124822291726,-1
6575,6576,Malleswaram,172350,21770,150580,0.8736872642877865,-1
6576,6577,HBR Layout,358600,69930,288670,0.8049916341327384,-1
6577,6578,Hoodi,334800,32390,302410,0.9032556750298686,-1
6578,6579,Kalyan Nagar,248850,75580,173270,0.6962829013461925,0
6579,6580,Hebbal,272250,50070,222180,0.8160881542699725,-1
6580,6581,Hoodi,171100,100310,70790,0.41373465809468146,1
6581,6582,Horamavu,300950,86780,214170,0.7116464528991527,0
6582,6583,Krishnarajapuram,412300,67690,344610,0.8358234295415959,-1
6583,6584,Varthur,446050,70130,375920,0.8427754736016142,-1
6584,6585,Indiranagar,327150,73340,253810,0.7758214886137857,0
6585,6586,Kammanahalli,86200,103960,-17760,-0.2060324825986079,1
6586,6587,Indiranagar,283600,36210,247390,0.8723201692524682,-1
6587,6588,Shivajinagar,303500,41670,261830,0.8627018121911038,-1
6588,6589,Whitefield,281600,34070,247530,0.8790127840909091,-1
6589,6590,Banaswadi,108350,85280,23070,0.21292108906322105,1
6590,6591,Marathahalli,87300,36500,50800,0.581901489117984,0
6591,6592,Banaswadi,54050,21730,32320,0.5979648473635523,0
6592,6593,Krishnarajapuram,319150,32320,286830,0.8987310042299859,-1
6593,6594,Banaswadi,238500,138150,100350,0.4207547169811321,1
6594,6595,Hebbal,235950,72230,163720,0.6938758211485484,0
6595,6596,Kalyan Nagar,212800,84290,128510,0.6039003759398496,0
6596,6597,Kalyan Nagar,385150,40660,344490,0.8944307412696352,-1
6597,6598,Rajajinagar,206200,98970,107230,0.5200290979631426,0
6598,6599,Krishnarajapuram,376900,73550,303350,0.8048553993101618,-1
6599,6600,Hebbal,404750,59970,344780,0.85183446571958,-1
6600,6601,Indiranagar,76800,36330,40470,0.526953125,0
6601,6602,Rajajinagar,447650,35650,412000,0.9203618898693176,-1
6602,6603,Varthur,229000,1310,227690,0.9942794759825327,-1
6603,6604,Varthur,233100,105050,128050,0.5493350493350493,0
6604,6605,Varthur,419900,77890,342010,0.8145034532031437,-1
6605,6606,CV Raman Nagar,445350,35040,410310,0.9213203098686427,-1
6606,6607,Horamavu,92550,30140,62410,0.6743381955699622,0
6607,6608,Indiranagar,81900,19240,62660,0.765079365079365,0
6608,6609,Whitefield,395050,46160,348890,0.8831540311352993,-1
6609,6610,Vasanth Nagar,429600,171780,257820,0.6001396648044692,0
6610,6611,Rajajinagar,155100,79750,75350,0.4858156028368794,1
6611,6612,Kalyan Nagar,333850,12250,321600,0.9633068743447656,-1
6612,6613,Hoodi,236900,92930,143970,0.6077247783875053,0
6613,6614,Malleswaram,401100,69010,332090,0.8279481426078285,-1
6614,6615,Jalahalli,433900,23530,410370,0.9457709149573634,-1
6615,6616,Jalahalli,34950,23140,11810,0.33791130185979973,1
6616,6617,Hebbal,79250,47580,31670,0.39962145110410097,1
6617,6618,Malleswaram,360100,30170,329930,0.9162177173007497,-1
6618,6619,Vasanth Nagar,433100,85000,348100,0.8037404756407296,-1
6619,6620,Mahadevapura,270300,56510,213790,0.7909359970403256,0
6620,6621,Hoodi,57200,72810,-15610,-0.2729020979020979,1
6621,6622,Hoodi,281050,80970,200080,0.7119017968333037,0
6622,6623,Jalahalli,271450,70010,201440,0.7420887824645422,0
6623,6624,CV Raman Nagar,131850,105390,26460,0.2006825938566553,1
6624,6625,Hebbal,417750,92270,325480,0.7791262716935966,0
6625,6626,Kalyan Nagar,229250,67140,162110,0.7071319520174482,0
6626,6627,Hoodi,311500,34710,276790,0.8885714285714286,-1
6627,6628,Kammanahalli,95350,121770,-26420,-0.2770844257996854,1
6628,6629,Shivajinagar,372900,65910,306990,0.8232502011263073,-1
6629,6630,Marathahalli,281950,77830,204120,0.7239581486079092,0
6630,6631,Varthur,191100,45730,145370,0.7607012035583464,0
6631,6632,Horamavu,275500,153580,121920,0.44254083484573503,1
6632,6633,Hebbal,88000,23310,64690,0.7351136363636364,0
6633,6634,Jalahalli,356650,12080,344570,0.9661292583765596,-1
6634,6635,Hebbal,150050,83150,66900,0.44585138287237586,1
6635,6636,CV Raman Nagar,176350,75900,100450,0.5696058973631982,0
6636,6637,Varthur,238300,34830,203470,0.8538396978598405,-1
6637,6638,Kammanahalli,216050,55400,160650,0.7435778754917843,0
6638,6639,Indiranagar,422650,60010,362640,0.8580149059505501,-1
6639,6640,Indiranagar,143650,61820,81830,0.5696484510964149,0
6640,6641,Indiranagar,31750,56600,-24850,-0.7826771653543307,1
6641,6642,Kalyan Nagar,228350,41140,187210,0.8198379680315305,-1
6642,6643,Shivajinagar,124750,24500,100250,0.8036072144288577,-1
6643,6644,Jalahalli,211450,22080,189370,0.8955781508630882,-1
6644,6645,Marathahalli,281400,61760,219640,0.7805259417199716,0
6645,6646,Whitefield,162850,35280,127570,0.7833589192508443,0
6646,6647,CV Raman Nagar,240850,62860,177990,0.7390076811293336,0
6647,6648,Hoodi,87150,81980,5170,0.05932300631095812,1
6648,6649,Shivajinagar,108550,61780,46770,0.4308613542146476,1
6649,6650,Hebbal,113750,23940,89810,0.7895384615384615,0
6650,6651,Whitefield,365100,62840,302260,0.8278827718433306,-1
6651,6652,Krishnarajapuram,274950,92390,182560,0.6639752682305874,0
6652,6653,Hoodi,402900,55030,347870,0.8634152395135269,-1
6653,6654,HBR Layout,275450,65820,209630,0.7610455618079506,0
6654,6655,Hoodi,78100,21170,56930,0.7289372599231754,0
6655,6656,Vasanth Nagar,403850,68160,335690,0.8312244645289093,-1
6656,6657,Hoodi,349850,34520,315330,0.9013291410604545,-1
6657,6658,Mahadevapura,49200,25960,23240,0.47235772357723577,1
6658,6659,Banaswadi,282300,84210,198090,0.7017003188097768,0
6659,6660,Vasanth Nagar,63200,28020,35180,0.5566455696202531,0
6660,6661,Banaswadi,253750,84070,169680,0.6686896551724137,0
6661,6662,Vasanth Nagar,92050,56500,35550,0.3862031504617056,1
6662,6663,Varthur,57400,35840,21560,0.375609756097561,1
6663,6664,Hebbal,275500,70560,204940,0.7438838475499092,0
6664,6665,Shivajinagar,122300,24880,97420,0.7965658217497956,0
6665,6666,Whitefield,93450,51050,42400,0.4537185660781166,1
6666,6667,Marathahalli,260100,92290,167810,0.6451749327181853,0
6667,6668,Vasanth Nagar,259550,75670,183880,0.7084569447120015,0
6668,6669,Banaswadi,421200,28590,392610,0.9321225071225071,-1
6669,6670,Kalyan Nagar,387750,85660,302090,0.7790844616376531,0
6670,6671,Marathahalli,243000,45430,197570,0.813045267489712,-1
6671,6672,Vasanth Nagar,231600,74170,157430,0.6797495682210708,0
6672,6673,Mahadevapura,365550,111420,254130,0.6951990151826015,0
6673,6674,Varthur,339600,58910,280690,0.8265312131919906,-1
6674,6675,Kalyan Nagar,318550,43190,275360,0.86441688902841,-1
6675,6676,Kalyan Nagar,62500,81090,-18590,-0.29744,1
6676,6677,Shivajinagar,240250,17820,222430,0.9258272632674298,-1
6677,6678,Mahadevapura,148050,28890,119160,0.8048632218844984,-1
6678,6679,Kammanahalli,36550,64050,-27500,-0.7523939808481532,1
6679,6680,Vasanth Nagar,339350,59730,279620,0.8239870340356564,-1
6680,6681,Marathahalli,210450,51890,158560,0.7534331195058208,0
6681,6682,Krishnarajapuram,74300,82360,-8060,-0.10847913862718708,1
6682,6683,HBR Layout,441150,71740,369410,0.8373795761078998,-1
6683,6684,Horamavu,244150,70460,173690,0.7114069219741962,0
6684,6685,CV Raman Nagar,298600,71670,226930,0.759979906229069,0
6685,6686,Banaswadi,71250,0,71250,1.0,-1
6686,6687,Hebbal,305650,52500,253150,0.8282349092098806,-1
6687,6688,Hoodi,112850,45700,67150,0.5950376606114312,0
6688,6689,Mahadevapura,326850,47660,279190,0.8541838763959002,-1
6689,6690,Shivajinagar,124150,122670,1480,0.011921063229963754,1
6690,6691,Hebbal,449350,34290,415060,0.9236897741181707,-1
6691,6692,Indiranagar,128950,20850,108100,0.8383094222566886,-1
6692,6693,Whitefield,220750,100140,120610,0.5463646659116648,0
6693,6694,Vasanth Nagar,37700,67350,-29650,-0.786472148541114,1
6694,6695,Kalyan Nagar,255950,20740,235210,0.9189685485446376,-1
6695,6696,Whitefield,105900,32210,73690,0.6958451369216242,0
6696,6697,Mahadevapura,378650,70030,308620,0.8150534794665258,-1
6697,6698,CV Raman Nagar,420050,38460,381590,0.9084394714914891,-1
6698,6699,Shivajinagar,30100,78480,-48380,-1.6073089700996677,1
6699,6700,Kalyan Nagar,28200,66060,-37860,-1.3425531914893618,1
6700,6701,Malleswaram,437350,106650,330700,0.756144963987653,0
6701,6702,Indiranagar,104300,64190,40110,0.38456375838926177,1
6702,6703,Rajajinagar,404600,25910,378690,0.9359614434008897,-1
6703,6704,Whitefield,31600,40440,-8840,-0.27974683544303797,1
6704,6705,Banaswadi,318800,75510,243290,0.7631430363864492,0
6705,6706,HBR Layout,176650,28830,147820,0.8367959241437871,-1
6706,6707,Varthur,71700,97860,-26160,-0.36485355648535567,1
6707,6708,Shivajinagar,99600,106530,-6930,-0.06957831325301204,1
6708,6709,Krishnarajapuram,283950,29780,254170,0.8951223807008276,-1
6709,6710,Mahadevapura,170750,126670,44080,0.25815519765739386,1
6710,6711,Malleswaram,307300,139870,167430,0.5448421737715587,0
6711,6712,Shivajinagar,150750,62190,88560,0.5874626865671642,0
6712,6713,Rajajinagar,26500,76360,-49860,-1.8815094339622642,1
6713,6714,Indiranagar,299450,66610,232840,0.7775588579061613,0
6714,6715,Krishnarajapuram,406800,68700,338100,0.8311209439528023,-1
6715,6716,Marathahalli,203950,118480,85470,0.4190733022799706,1
6716,6717,Varthur,295900,31640,264260,0.8930719837783034,-1
6717,6718,Mahadevapura,67600,80860,-13260,-0.19615384615384615,1
6718,6719,Marathahalli,171400,47330,124070,0.7238623103850642,0
6719,6720,Hoodi,371450,62010,309440,0.8330596311751245,-1
6720,6721,Mahadevapura,309750,40110,269640,0.8705084745762712,-1
6721,6722,CV Raman Nagar,61550,58740,2810,0.045653939886271325,1
6722,6723,Marathahalli,324600,38270,286330,0.8821010474430068,-1
6723,6724,Horamavu,60350,66730,-6380,-0.10571665285832643,1
6724,6725,HBR Layout,405650,80840,324810,0.8007149020091212,-1
6725,6726,Rajajinagar,306100,0,306100,1.0,-1
6726,6727,Indiranagar,161400,48980,112420,0.6965303593556381,0
6727,6728,Mahadevapura,34300,96990,-62690,-1.8276967930029155,1
6728,6729,Varthur,320650,29890,290760,0.9067830968345548,-1
6729,6730,Shivajinagar,429850,13150,416700,0.9694079329998837,-1
6730,6731,Kammanahalli,417150,48130,369020,0.8846218386671462,-1
6731,6732,Hoodi,218050,28060,189990,0.8713139188259573,-1
6732,6733,HBR Layout,32000,102080,-70080,-2.19,1
6733,6734,Whitefield,324100,15930,308170,0.9508485035482875,-1
6734,6735,CV Raman Nagar,82550,44510,38040,0.4608116293155663,1
6735,6736,Banaswadi,47600,31290,16310,0.3426470588235294,1
6736,6737,Whitefield,47050,66710,-19660,-0.41785334750265674,1
6737,6738,Krishnarajapuram,409300,9120,400180,0.9777180552162228,-1
6738,6739,Hoodi,37700,89140,-51440,-1.3644562334217507,1
6739,6740,Kalyan Nagar,248650,30670,217980,0.8766539312286347,-1
6740,6741,Shivajinagar,270850,74610,196240,0.7245338748384714,0
6741,6742,Jalahalli,340450,72870,267580,0.7859597591423116,0
6742,6743,Mahadevapura,174250,10490,163760,0.9397991391678623,-1
6743,6744,Indiranagar,232500,91300,141200,0.6073118279569892,0
6744,6745,Mahadevapura,419050,43100,375950,0.8971483116573201,-1
6745,6746,Kammanahalli,132200,85000,47200,0.35703479576399394,1
6746,6747,Kalyan Nagar,150850,21480,129370,0.857606894265827,-1
6747,6748,Horamavu,109050,37750,71300,0.6538285190279688,0
6748,6749,HBR Layout,272650,43080,229570,0.841995231982395,-1
6749,6750,Whitefield,83400,7050,76350,0.9154676258992805,-1
6750,6751,Rajajinagar,72900,63290,9610,0.1318244170096022,1
6751,6752,Banaswadi,356750,123790,232960,0.6530063069376314,0
6752,6753,Malleswaram,152400,50060,102340,0.6715223097112861,0
6753,6754,Hebbal,184050,75680,108370,0.5888073892963869,0
6754,6755,Malleswaram,39150,11340,27810,0.7103448275862069,0
6755,6756,Malleswaram,286700,28830,257870,0.8994419253575165,-1
6756,6757,Jalahalli,422400,67500,354900,0.8401988636363636,-1
6757,6758,Shivajinagar,195050,95990,99060,0.5078697769802615,0
6758,6759,Varthur,327650,61370,266280,0.8126964748969937,-1
6759,6760,Kalyan Nagar,135100,41550,93550,0.6924500370096225,0
6760,6761,Banaswadi,249200,38230,210970,0.8465890850722312,-1
6761,6762,HBR Layout,148950,66280,82670,0.5550184625713327,0
6762,6763,Malleswaram,240200,84470,155730,0.6483347210657785,0
6763,6764,Kalyan Nagar,366050,84460,281590,0.7692664936484087,0
6764,6765,Rajajinagar,167550,146790,20760,0.12390331244404655,1
6765,6766,Hebbal,104500,120340,-15840,-0.15157894736842106,1
6766,6767,Horamavu,256800,66280,190520,0.7419003115264797,0
6767,6768,Banaswadi,64500,63100,1400,0.021705426356589147,1
6768,6769,Horamavu,418500,62870,355630,0.8497729988052569,-1
6769,6770,Kalyan Nagar,68950,90130,-21180,-0.3071791153009427,1
6770,6771,Malleswaram,94650,7360,87290,0.9222398309561542,-1
6771,6772,Banaswadi,122750,63350,59400,0.4839103869653768,1
6772,6773,Kammanahalli,271150,104570,166580,0.6143463027844367,0
6773,6774,Marathahalli,110350,67190,43160,0.3911191662890802,1
6774,6775,Kalyan Nagar,339500,18910,320590,0.944300441826215,-1
6775,6776,Mahadevapura,311100,94710,216390,0.6955641272902604,0
6776,6777,Jalahalli,53650,93280,-39630,-0.7386766076421248,1
6777,6778,Banaswadi,287700,20350,267350,0.9292665971498089,-1
6778,6779,Rajajinagar,126650,99170,27480,0.21697591788393208,1
6779,6780,Shivajinagar,342600,76420,266180,0.7769410391126679,0
6780,6781,Whitefield,290250,77410,212840,0.7332988802756245,0
6781,6782,Horamavu,380900,61720,319180,0.8379627198739826,-1
6782,6783,CV Raman Nagar,102500,52760,49740,0.4852682926829268,1
6783,6784,Shivajinagar,294400,30360,264040,0.896875,-1
6784,6785,Marathahalli,341550,44360,297190,0.8701215049041136,-1
6785,6786,Marathahalli,341350,54790,286560,0.8394902592646843,-1
6786,6787,Jalahalli,252500,4240,248260,0.9832079207920792,-1
6787,6788,Marathahalli,297450,101160,196290,0.6599092284417549,0
6788,6789,Horamavu,36950,22330,14620,0.3956698240866035,1
6789,6790,Malleswaram,318200,76480,241720,0.7596480201131364,0
6790,6791,CV Raman Nagar,67650,85980,-18330,-0.2709534368070953,1
6791,6792,Jalahalli,122850,13530,109320,0.8898656898656898,-1
6792,6793,Vasanth Nagar,150250,74100,76150,0.5068219633943427,0
6793,6794,Kammanahalli,84650,14960,69690,0.823272297696397,-1
6794,6795,Indiranagar,167150,77320,89830,0.5374214777146276,0
6795,6796,Rajajinagar,176300,30160,146140,0.8289279636982416,-1
6796,6797,Krishnarajapuram,378700,56420,322280,0.8510166358595194,-1
6797,6798,Hebbal,368150,9560,358590,0.9740323237810675,-1
6798,6799,Kammanahalli,262900,61960,200940,0.7643210346139216,0
6799,6800,HBR Layout,238850,22680,216170,0.9050450073267742,-1
6800,6801,Kammanahalli,169050,48390,120660,0.7137533274179237,0
6801,6802,Indiranagar,276850,66230,210620,0.7607729817590753,0
6802,6803,Indiranagar,166150,102740,63410,0.3816430935901294,1
6803,6804,Mahadevapura,279050,62190,216860,0.7771367138505644,0
6804,6805,Horamavu,319800,54810,264990,0.8286116322701689,-1
6805,6806,Rajajinagar,433100,34360,398740,0.9206649734472409,-1
6806,6807,Rajajinagar,313350,56250,257100,0.8204882719004308,-1
6807,6808,Kammanahalli,429800,76050,353750,0.8230572359236854,-1
6808,6809,Kalyan Nagar,131850,59110,72740,0.5516875237011756,0
6809,6810,Vasanth Nagar,402450,79620,322830,0.8021617592247484,-1
6810,6811,Marathahalli,393550,132590,260960,0.6630923643755559,0
6811,6812,Whitefield,102600,48160,54440,0.5306042884990253,0
6812,6813,Banaswadi,325450,61860,263590,0.809924719618989,-1
6813,6814,Marathahalli,84550,24140,60410,0.714488468361916,0
6814,6815,Jalahalli,206100,37510,168590,0.8180009704027171,-1
6815,6816,Malleswaram,401750,31930,369820,0.920522713130056,-1
6816,6817,Malleswaram,185650,27530,158120,0.8517102073794776,-1
6817,6818,CV Raman Nagar,30600,93940,-63340,-2.069934640522876,1
6818,6819,Mahadevapura,291100,81500,209600,0.7200274819649605,0
6819,6820,Malleswaram,236350,19830,216520,0.916099005711868,-1
6820,6821,Hoodi,143700,43490,100210,0.6973556019485039,0
6821,6822,Malleswaram,257950,77500,180450,0.6995541771661175,0
6822,6823,Hebbal,104650,111260,-6610,-0.06316292403248926,1
6823,6824,Banaswadi,141250,62350,78900,0.5585840707964602,0
6824,6825,Whitefield,198350,100100,98250,0.49533652634232417,1
6825,6826,HBR Layout,445250,63060,382190,0.8583717012914093,-1
6826,6827,Indiranagar,345900,37160,308740,0.8925701069673316,-1
6827,6828,Horamavu,279650,35720,243930,0.8722689075630252,-1
6828,6829,Whitefield,221750,56060,165690,0.7471927846674182,0
6829,6830,Mahadevapura,61100,141110,-80010,-1.30949263502455,1
6830,6831,Hoodi,210750,113780,96970,0.46011862396204034,1
6831,6832,Varthur,160500,74040,86460,0.5386915887850467,0
6832,6833,Whitefield,150350,75230,75120,0.49963418689723976,1
6833,6834,Hebbal,126350,41570,84780,0.6709932726553225,0
6834,6835,Shivajinagar,236450,81240,155210,0.6564178473250158,0
6835,6836,Marathahalli,249500,67330,182170,0.7301402805611222,0
6836,6837,Krishnarajapuram,258350,107890,150460,0.5823882330172246,0
6837,6838,Kalyan Nagar,187900,4860,183040,0.9741351782863226,-1
6838,6839,HBR Layout,151600,55500,96100,0.6339050131926122,0
6839,6840,Hoodi,419200,90770,328430,0.7834685114503817,0
6840,6841,CV Raman Nagar,416950,40890,376060,0.9019306871327497,-1
6841,6842,Varthur,264450,7500,256950,0.9716392512762337,-1
6842,6843,Jalahalli,371750,56880,314870,0.8469939475453934,-1
6843,6844,Marathahalli,145600,18300,127300,0.8743131868131868,-1
6844,6845,Rajajinagar,217550,100170,117380,0.5395541254883934,0
6845,6846,Kammanahalli,130100,78120,51980,0.3995388162951576,1
6846,6847,Jalahalli,437050,0,437050,1.0,-1
6847,6848,Hebbal,329250,47110,282140,0.8569172361427486,-1
6848,6849,Marathahalli,113250,48030,65220,0.5758940397350993,0
6849,6850,Jalahalli,197350,38260,159090,0.8061312389156321,-1
6850,6851,Kammanahalli,28900,103290,-74390,-2.5740484429065744,1
6851,6852,Whitefield,197300,59210,138090,0.6998986315255955,0
6852,6853,HBR Layout,143250,129970,13280,0.09270506108202443,1
6853,6854,Vasanth Nagar,145150,47380,97770,0.6735790561488115,0
6854,6855,Rajajinagar,225100,54950,170150,0.7558862727676589,0
6855,6856,Jalahalli,137150,79040,58110,0.42369668246445497,1
6856,6857,Whitefield,346050,134920,211130,0.6101141453547175,0
6857,6858,HBR Layout,198950,37720,161230,0.8104046242774566,-1
6858,6859,Indiranagar,279000,29590,249410,0.8939426523297491,-1
6859,6860,Horamavu,405050,32940,372110,0.9186767065794347,-1
6860,6861,CV Raman Nagar,216250,58990,157260,0.7272138728323699,0
6861,6862,CV Raman Nagar,162800,24130,138670,0.8517813267813268,-1
6862,6863,Marathahalli,185650,81710,103940,0.5598707244815513,0
6863,6864,Indiranagar,172650,44190,128460,0.7440486533449174,0
6864,6865,Horamavu,271700,67680,204020,0.7509017298490983,0
6865,6866,Vasanth Nagar,111950,62860,49090,0.43849933005806163,1
6866,6867,HBR Layout,224500,30190,194310,0.8655233853006682,-1
6867,6868,CV Raman Nagar,84400,44030,40370,0.4783175355450237,1
6868,6869,Marathahalli,139600,85020,54580,0.39097421203438393,1
6869,6870,Banaswadi,235650,117830,117820,0.49997878209208574,1
6870,6871,Hoodi,433850,94830,339020,0.78142215051285,0
6871,6872,Malleswaram,161050,74950,86100,0.5346165787022664,0
6872,6873,Krishnarajapuram,377950,115480,262470,0.6944569387485117,0
6873,6874,Rajajinagar,157850,50440,107410,0.680456129236617,0
6874,6875,Horamavu,316100,50020,266080,0.8417589370452389,-1
6875,6876,Malleswaram,431100,16840,414260,0.9609371375550916,-1
6876,6877,Vasanth Nagar,243000,65240,177760,0.7315226337448559,0
6877,6878,Varthur,313050,106180,206870,0.6608209551189905,0
6878,6879,Marathahalli,27300,36900,-9600,-0.3516483516483517,1
6879,6880,Kalyan Nagar,29450,8670,20780,0.7056027164685909,0
6880,6881,Indiranagar,260450,83720,176730,0.6785563447878672,0
6881,6882,Varthur,84800,11850,72950,0.8602594339622641,-1
6882,6883,Whitefield,300300,80100,220200,0.7332667332667333,0
6883,6884,Hebbal,28250,34480,-6230,-0.22053097345132744,1
6884,6885,Whitefield,248250,29180,219070,0.8824572004028197,-1
6885,6886,Mahadevapura,299800,85070,214730,0.7162441627751834,0
6886,6887,Kalyan Nagar,394500,86510,307990,0.7807097591888467,0
6887,6888,Hoodi,251100,41040,210060,0.8365591397849462,-1
6888,6889,HBR Layout,332500,67680,264820,0.7964511278195489,0
6889,6890,CV Raman Nagar,285100,62330,222770,0.7813749561557348,0
6890,6891,Kammanahalli,279850,37560,242290,0.8657852420939789,-1
6891,6892,Shivajinagar,324950,66800,258150,0.7944299122941991,0
6892,6893,CV Raman Nagar,100400,92550,7850,0.07818725099601594,1
6893,6894,Horamavu,245950,58560,187390,0.761902825777597,0
6894,6895,Hoodi,424300,80980,343320,0.8091444732500589,-1
6895,6896,Mahadevapura,418450,115450,303000,0.7241008483689808,0
6896,6897,Kalyan Nagar,78400,76560,1840,0.02346938775510204,1
6897,6898,Hebbal,448350,40630,407720,0.9093788335006133,-1
6898,6899,Vasanth Nagar,173200,63240,109960,0.6348729792147806,0
6899,6900,Kalyan Nagar,105350,114400,-9050,-0.08590412909349786,1
6900,6901,Hoodi,68750,39910,28840,0.4194909090909091,1
6901,6902,Jalahalli,296050,22660,273390,0.9234588751900017,-1
6902,6903,Varthur,211250,48490,162760,0.7704615384615384,0
6903,6904,Rajajinagar,113350,14370,98980,0.8732245258050286,-1
6904,6905,Hebbal,395000,67830,327170,0.8282784810126582,-1
6905,6906,Jalahalli,355400,130340,225060,0.6332583005064716,0
6906,6907,Kammanahalli,79650,57840,21810,0.27382297551789075,1
6907,6908,Hoodi,201950,70720,131230,0.6498143104728893,0
6908,6909,Varthur,431500,75980,355520,0.8239165701042873,-1
6909,6910,HBR Layout,164850,70290,94560,0.5736123748862603,0
6910,6911,CV Raman Nagar,251400,80710,170690,0.6789578361177406,0
6911,6912,Rajajinagar,364500,75310,289190,0.7933882030178326,0
6912,6913,Banaswadi,275800,27330,248470,0.9009064539521392,-1
6913,6914,Hoodi,319050,63920,255130,0.7996552264535339,0
6914,6915,Vasanth Nagar,40250,102470,-62220,-1.5458385093167701,1
6915,6916,Rajajinagar,233750,63980,169770,0.7262887700534759,0
6916,6917,CV Raman Nagar,105200,32690,72510,0.6892585551330799,0
6917,6918,Kammanahalli,336200,88170,248030,0.7377453896490185,0
6918,6919,Vasanth Nagar,318500,74700,243800,0.7654631083202512,0
6919,6920,Indiranagar,126500,83830,42670,0.33731225296442685,1
6920,6921,Varthur,250400,30840,219560,0.8768370607028754,-1
6921,6922,Marathahalli,410250,72050,338200,0.824375380865326,-1
6922,6923,CV Raman Nagar,422500,101810,320690,0.7590295857988165,0
6923,6924,Whitefield,412000,48360,363640,0.882621359223301,-1
6924,6925,Whitefield,212450,40620,171830,0.8088020710755471,-1
6925,6926,Banaswadi,69350,11480,57870,0.8344628695025235,-1
6926,6927,Banaswadi,90250,13660,76590,0.8486426592797784,-1
6927,6928,HBR Layout,377400,47570,329830,0.8739533651298357,-1
6928,6929,Malleswaram,383550,76450,307100,0.800677877721288,-1
6929,6930,HBR Layout,351950,53630,298320,0.8476204006250888,-1
6930,6931,Kammanahalli,49900,70370,-20470,-0.4102204408817635,1
6931,6932,Horamavu,280350,11900,268450,0.9575530586766542,-1
6932,6933,Jalahalli,326700,71200,255500,0.7820630547903276,0
6933,6934,Whitefield,187300,38110,149190,0.7965296316070475,0
6934,6935,Vasanth Nagar,445400,107510,337890,0.7586214638527167,0
6935,6936,Marathahalli,71900,91410,-19510,-0.2713490959666203,1
6936,6937,Shivajinagar,221250,47130,174120,0.7869830508474577,0
6937,6938,Hoodi,313550,65560,247990,0.790910540583639,0
6938,6939,Shivajinagar,43450,71900,-28450,-0.6547756041426928,1
6939,6940,Banaswadi,383750,14870,368880,0.9612508143322476,-1
6940,6941,Whitefield,356300,119670,236630,0.6641313499859669,0
6941,6942,Kammanahalli,364600,42700,321900,0.8828853538123972,-1
6942,6943,Shivajinagar,225000,83950,141050,0.6268888888888889,0
6943,6944,Jalahalli,371000,64150,306850,0.827088948787062,-1
6944,6945,Banaswadi,448750,57290,391460,0.8723342618384401,-1
6945,6946,Vasanth Nagar,204800,31440,173360,0.846484375,-1
6946,6947,Kalyan Nagar,144550,67640,76910,0.5320650294015912,0
6947,6948,Krishnarajapuram,148750,53770,94980,0.6385210084033613,0
6948,6949,HBR Layout,316950,42820,274130,0.8648998264710522,-1
6949,6950,Jalahalli,352900,35110,317790,0.9005100595069425,-1
6950,6951,Indiranagar,429500,22360,407140,0.9479394644935972,-1
6951,6952,CV Raman Nagar,57100,47320,9780,0.1712784588441331,1
6952,6953,Vasanth Nagar,70100,38330,31770,0.45320970042796005,1
6953,6954,CV Raman Nagar,129600,28240,101360,0.7820987654320988,0
6954,6955,Banaswadi,185350,70640,114710,0.6188831939573779,0
6955,6956,Marathahalli,345050,31400,313650,0.9089986958411824,-1
6956,6957,HBR Layout,274950,33660,241290,0.8775777414075286,-1
6957,6958,Kalyan Nagar,242150,25220,216930,0.895849679950444,-1
6958,6959,Vasanth Nagar,49850,48870,980,0.01965897693079238,1
6959,6960,Whitefield,308750,88190,220560,0.7143643724696356,0
6960,6961,Whitefield,112850,45510,67340,0.5967213114754099,0
6961,6962,Banaswadi,166750,89440,77310,0.46362818590704646,1
6962,6963,Jalahalli,449000,116950,332050,0.739532293986637,0
6963,6964,Mahadevapura,119500,86870,32630,0.27305439330543935,1
6964,6965,Hoodi,183050,47470,135580,0.7406719475553127,0
6965,6966,Jalahalli,378000,67010,310990,0.8227248677248677,-1
6966,6967,CV Raman Nagar,248600,45350,203250,0.8175784392598552,-1
6967,6968,Hebbal,386700,38310,348390,0.9009309542280838,-1
6968,6969,Rajajinagar,89000,38190,50810,0.5708988764044944,0
6969,6970,HBR Layout,68600,37190,31410,0.4578717201166181,1
6970,6971,Hebbal,112650,29600,83050,0.7372392365734576,0
6971,6972,Hebbal,30850,64700,-33850,-1.0972447325769854,1
6972,6973,CV Raman Nagar,442250,36480,405770,0.917512719050311,-1
6973,6974,Rajajinagar,125050,87270,37780,0.3021191523390644,1
6974,6975,Mahadevapura,236000,85740,150260,0.6366949152542373,0
6975,6976,Kammanahalli,294800,74950,219850,0.7457598371777476,0
6976,6977,Banaswadi,365350,51890,313460,0.857971807855481,-1
6977,6978,Hebbal,162600,90840,71760,0.44132841328413286,1
6978,6979,Mahadevapura,323500,53380,270120,0.8349922720247295,-1
6979,6980,Indiranagar,92100,30170,61930,0.6724212812160695,0
6980,6981,CV Raman Nagar,58100,54920,3180,0.054733218588640276,1
6981,6982,Kammanahalli,341900,48420,293480,0.8583796431705177,-1
6982,6983,Jalahalli,94500,59480,35020,0.37058201058201057,1
6983,6984,Kalyan Nagar,130850,13930,116920,0.8935422239205196,-1
6984,6985,Kammanahalli,145600,24880,120720,0.8291208791208792,-1
6985,6986,Malleswaram,302100,109700,192400,0.6368752068851373,0
6986,6987,Whitefield,93800,33160,60640,0.6464818763326226,0
6987,6988,Banaswadi,310500,63650,246850,0.7950080515297907,0
6988,6989,Whitefield,239950,74130,165820,0.6910606376328402,0
6989,6990,Whitefield,415500,55360,360140,0.86676293622142,-1
6990,6991,Mahadevapura,325200,102100,223100,0.6860393603936039,0
6991,6992,HBR Layout,210250,90550,119700,0.5693222354340072,0
6992,6993,Jalahalli,338850,96370,242480,0.7155968717721706,0
6993,6994,Banaswadi,342850,40000,302850,0.8833309027271401,-1
6994,6995,Horamavu,124100,19840,104260,0.8401289282836423,-1
6995,6996,Marathahalli,294850,46530,248320,0.8421909445480753,-1
6996,6997,Shivajinagar,64200,47330,16870,0.26277258566978196,1
6997,6998,Indiranagar,259400,49150,210250,0.8105242868157286,-1
6998,6999,Horamavu,201050,116900,84150,0.418552598856006,1
6999,7000,Kammanahalli,93000,42380,50620,0.5443010752688172,0
7000,7001,Rajajinagar,229600,117870,111730,0.4866289198606272,1
7001,7002,CV Raman Nagar,220700,56360,164340,0.7446307204349796,0
7002,7003,Banaswadi,329750,56350,273400,0.8291129643669447,-1
7003,7004,Marathahalli,406250,26530,379720,0.9346953846153846,-1
7004,7005,Rajajinagar,328100,35020,293080,0.8932642487046633,-1
7005,7006,Whitefield,333850,49070,284780,0.8530178223753182,-1
7006,7007,Shivajinagar,125900,35610,90290,0.7171564733915806,0
7007,7008,Whitefield,329650,71260,258390,0.7838313362657364,0
7008,7009,Indiranagar,187250,33100,154150,0.8232309746328438,-1
7009,7010,Whitefield,114050,105420,8630,0.07566856641823762,1
7010,7011,Varthur,436500,14880,421620,0.9659106529209622,-1
7011,7012,Hoodi,196250,0,196250,1.0,-1
7012,7013,Malleswaram,323600,80330,243270,0.7517614338689741,0
7013,7014,Malleswaram,403000,15620,387380,0.9612406947890819,-1
7014,7015,Malleswaram,246150,39770,206380,0.838431850497664,-1
7015,7016,Kalyan Nagar,143350,81450,61900,0.43181025462155564,1
7016,7017,Rajajinagar,53850,63220,-9370,-0.17400185701021356,1
7017,7018,Jalahalli,309250,71320,237930,0.7693775262732417,0
7018,7019,Indiranagar,107400,24400,83000,0.7728119180633147,0
7019,7020,Kammanahalli,411350,109670,301680,0.7333900571289657,0
7020,7021,Banaswadi,302800,87120,215680,0.7122853368560106,0
7021,7022,Whitefield,86400,56720,29680,0.3435185185185185,1
7022,7023,Malleswaram,305300,42690,262610,0.8601703242712087,-1
7023,7024,Horamavu,184850,90710,94140,0.509277792804977,0
7024,7025,Mahadevapura,235400,41360,194040,0.8242990654205608,-1
7025,7026,Shivajinagar,231350,92410,138940,0.6005619191700886,0
7026,7027,Krishnarajapuram,264250,33950,230300,0.871523178807947,-1
7027,7028,Whitefield,105500,71340,34160,0.3237914691943128,1
7028,7029,Kammanahalli,173100,45590,127510,0.7366262276140959,0
7029,7030,Banaswadi,76400,64840,11560,0.15130890052356022,1
7030,7031,HBR Layout,383700,23950,359750,0.9375814438363305,-1
7031,7032,Horamavu,255850,89910,165940,0.6485831541919094,0
7032,7033,Horamavu,443250,73310,369940,0.8346080090242527,-1
7033,7034,Hebbal,446300,80400,365900,0.819852117409814,-1
7034,7035,Varthur,346900,32870,314030,0.9052464687229749,-1
7035,7036,Varthur,414300,165420,248880,0.600724112961622,0
7036,7037,Shivajinagar,171450,98260,73190,0.4268883056284631,1
7037,7038,Hoodi,171900,72320,99580,0.5792902850494474,0
7038,7039,CV Raman Nagar,56650,35360,21290,0.3758164165931156,1
7039,7040,Krishnarajapuram,178750,49360,129390,0.7238601398601399,0
7040,7041,Shivajinagar,301400,16330,285070,0.9458195089581951,-1
7041,7042,Shivajinagar,352350,19700,332650,0.944089683553285,-1
7042,7043,HBR Layout,90700,7430,83270,0.9180815876515986,-1
7043,7044,Whitefield,275800,42780,233020,0.8448875997099348,-1
7044,7045,Shivajinagar,449650,39870,409780,0.9113310352496387,-1
7045,7046,HBR Layout,365000,39660,325340,0.8913424657534247,-1
7046,7047,Kammanahalli,32150,120700,-88550,-2.754276827371695,1
7047,7048,Kalyan Nagar,443450,67360,376090,0.8481001240275116,-1
7048,7049,Kammanahalli,341950,21170,320780,0.938090364088317,-1
7049,7050,Mahadevapura,141500,114980,26520,0.18742049469964664,1
7050,7051,Jalahalli,139350,124460,14890,0.10685324721923214,1
7051,7052,Rajajinagar,380950,39040,341910,0.8975193594959968,-1
7052,7053,Hebbal,164550,89120,75430,0.45840170161045274,1
7053,7054,CV Raman Nagar,416300,56480,359820,0.8643286091760749,-1
7054,7055,Indiranagar,84800,35630,49170,0.5798349056603773,0
7055,7056,Varthur,142500,28190,114310,0.8021754385964912,-1
7056,7057,Vasanth Nagar,370200,44730,325470,0.8791734197730956,-1
7057,7058,Banaswadi,104500,64660,39840,0.381244019138756,1
7058,7059,Hoodi,160750,70370,90380,0.5622395023328149,0
7059,7060,Hoodi,274850,76670,198180,0.7210478442786975,0
7060,7061,Malleswaram,371800,87220,284580,0.7654115115653577,0
7061,7062,Varthur,192800,30620,162180,0.8411825726141079,-1
7062,7063,Kalyan Nagar,356900,42660,314240,0.880470720089661,-1
7063,7064,Krishnarajapuram,196500,40670,155830,0.7930279898218829,0
7064,7065,Whitefield,444250,60920,383330,0.862870005627462,-1
7065,7066,Jalahalli,161300,88230,73070,0.45300681959082456,1
7066,7067,Vasanth Nagar,46150,92310,-46160,-1.000216684723727,1
7067,7068,Shivajinagar,211950,89160,122790,0.5793347487615004,0
7068,7069,Vasanth Nagar,388800,38400,350400,0.9012345679012346,-1
7069,7070,Hebbal,81400,64380,17020,0.20909090909090908,1
7070,7071,Malleswaram,225350,80390,144960,0.6432660306190371,0
7071,7072,Jalahalli,150200,122120,28080,0.18695073235685752,1
7072,7073,Marathahalli,294300,79040,215260,0.7314305130818892,0
7073,7074,Mahadevapura,237900,113860,124040,0.521395544346364,0
7074,7075,Marathahalli,432800,58120,374680,0.8657116451016635,-1
7075,7076,Varthur,29150,38670,-9520,-0.3265866209262436,1
7076,7077,HBR Layout,259050,85300,173750,0.6707199382358618,0
7077,7078,Hebbal,402300,44320,357980,0.8898334576186925,-1
7078,7079,Hebbal,96250,51390,44860,0.4660779220779221,1
7079,7080,Varthur,286300,104120,182180,0.636325532658051,0
7080,7081,Shivajinagar,300500,67860,232640,0.7741763727121465,0
7081,7082,Hebbal,406150,39650,366500,0.9023759694694079,-1
7082,7083,Rajajinagar,375350,81370,293980,0.7832156653789796,0
7083,7084,Vasanth Nagar,185950,89540,96410,0.5184727077171283,0
7084,7085,Horamavu,102100,50830,51270,0.502154750244858,0
7085,7086,Vasanth Nagar,186000,63820,122180,0.6568817204301075,0
7086,7087,Marathahalli,32700,103580,-70880,-2.167584097859327,1
7087,7088,Banaswadi,338500,48340,290160,0.8571935007385524,-1
7088,7089,Horamavu,110350,48220,62130,0.5630267331218849,0
7089,7090,Rajajinagar,265000,34110,230890,0.8712830188679245,-1
7090,7091,Shivajinagar,195200,15410,179790,0.9210553278688525,-1
7091,7092,Horamavu,110500,153480,-42980,-0.38895927601809954,1
7092,7093,Kalyan Nagar,89850,58910,30940,0.34435169727323317,1
7093,7094,HBR Layout,404250,80330,323920,0.8012863327149041,-1
7094,7095,Rajajinagar,326350,86740,239610,0.7342117358664011,0
7095,7096,Jalahalli,27700,83290,-55590,-2.0068592057761734,1
7096,7097,Rajajinagar,378300,58010,320290,0.8466560930478456,-1
7097,7098,Krishnarajapuram,370600,11860,358740,0.9679978413383702,-1
7098,7099,Kammanahalli,321100,62760,258340,0.8045468701339147,-1
7099,7100,Kammanahalli,196700,34200,162500,0.826131164209456,-1
7100,7101,Shivajinagar,324400,56810,267590,0.8248766954377312,-1
7101,7102,Rajajinagar,84400,127160,-42760,-0.5066350710900474,1
7102,7103,Krishnarajapuram,200300,113760,86540,0.43205192211682475,1
7103,7104,Hebbal,157350,56160,101190,0.6430886558627265,0
7104,7105,Kalyan Nagar,107700,104350,3350,0.031104921077065924,1
7105,7106,CV Raman Nagar,127700,74550,53150,0.41620986687548944,1
7106,7107,CV Raman Nagar,46800,0,46800,1.0,-1
7107,7108,Hebbal,121850,117360,4490,0.03684858432498974,1
7108,7109,Varthur,137000,59680,77320,0.5643795620437956,0
7109,7110,Rajajinagar,49200,61580,-12380,-0.2516260162601626,1
7110,7111,Jalahalli,312500,157860,154640,0.494848,1
7111,7112,Mahadevapura,152750,42080,110670,0.7245171849427169,0
7112,7113,Jalahalli,325550,34000,291550,0.8955613577023499,-1
7113,7114,Shivajinagar,204350,117130,87220,0.4268167359921703,1
7114,7115,Marathahalli,31000,6240,24760,0.7987096774193548,0
7115,7116,Mahadevapura,63400,71300,-7900,-0.12460567823343849,1
7116,7117,Shivajinagar,152150,23210,128940,0.8474531712126191,-1
7117,7118,Kammanahalli,149050,97480,51570,0.3459912780945991,1
7118,7119,Malleswaram,268950,107180,161770,0.6014872652909463,0
7119,7120,Marathahalli,38550,30310,8240,0.21374837872892347,1
7120,7121,Horamavu,153650,112420,41230,0.2683371298405467,1
7121,7122,HBR Layout,41200,118430,-77230,-1.874514563106796,1
7122,7123,Vasanth Nagar,335100,18550,316550,0.944643390032826,-1
7123,7124,Marathahalli,325300,25190,300110,0.9225637872732863,-1
7124,7125,Mahadevapura,279400,21480,257920,0.9231209735146743,-1
7125,7126,Shivajinagar,164400,6820,157580,0.9585158150851582,-1
7126,7127,CV Raman Nagar,77150,39570,37580,0.4871030460142579,1
7127,7128,Kalyan Nagar,199800,46110,153690,0.7692192192192192,0
7128,7129,Marathahalli,275100,71550,203550,0.7399127589967285,0
7129,7130,CV Raman Nagar,125100,121430,3670,0.029336530775379697,1
7130,7131,Shivajinagar,359700,29360,330340,0.9183764247984432,-1
7131,7132,Kalyan Nagar,399250,32170,367080,0.9194239198497183,-1
7132,7133,Marathahalli,280200,28740,251460,0.8974304068522484,-1
7133,7134,Whitefield,64100,32550,31550,0.4921996879875195,1
7134,7135,Varthur,216050,78180,137870,0.638139319601944,0
7135,7136,Kalyan Nagar,105950,61650,44300,0.4181217555450684,1
7136,7137,Kalyan Nagar,351950,44150,307800,0.8745560448927404,-1
7137,7138,Hebbal,354250,135380,218870,0.6178405081157374,0
7138,7139,Vasanth Nagar,71300,22020,49280,0.691164095371669,0
7139,7140,Indiranagar,155550,47260,108290,0.6961748633879782,0
7140,7141,Krishnarajapuram,188650,36870,151780,0.8045587065995229,-1
7141,7142,CV Raman Nagar,207750,27760,179990,0.8663778580024067,-1
7142,7143,Horamavu,114250,35330,78920,0.6907658643326039,0
7143,7144,CV Raman Nagar,142700,19060,123640,0.8664330763840224,-1
7144,7145,Horamavu,125800,93430,32370,0.2573131955484897,1
7145,7146,Hebbal,80000,111910,-31910,-0.398875,1
7146,7147,Kalyan Nagar,157400,83810,73590,0.46753494282083863,1
7147,7148,Rajajinagar,428950,38530,390420,0.9101760111901154,-1
7148,7149,Kalyan Nagar,303450,29570,273880,0.9025539627615752,-1
7149,7150,Whitefield,377550,105870,271680,0.7195868096940803,0
7150,7151,Krishnarajapuram,433950,64360,369590,0.8516879824864616,-1
7151,7152,CV Raman Nagar,213600,83360,130240,0.6097378277153558,0
7152,7153,Banaswadi,397300,31070,366230,0.9217971306317644,-1
7153,7154,Whitefield,287800,108310,179490,0.6236622654621264,0
7154,7155,Rajajinagar,295750,25900,269850,0.9124260355029585,-1
7155,7156,HBR Layout,243800,42250,201550,0.8267022149302707,-1
7156,7157,Rajajinagar,286900,58880,228020,0.7947716974555594,0
7157,7158,Mahadevapura,434750,19130,415620,0.9559976998274871,-1
7158,7159,Horamavu,124500,95290,29210,0.23461847389558232,1
7159,7160,Krishnarajapuram,367300,100470,266830,0.7264633814320719,0
7160,7161,Hebbal,29650,62870,-33220,-1.1204047217537942,1
7161,7162,Hoodi,232950,68690,164260,0.7051298561923159,0
7162,7163,Horamavu,227300,111940,115360,0.5075230972283326,0
7163,7164,Jalahalli,302850,70700,232150,0.7665510979032525,0
7164,7165,Hebbal,131700,158080,-26380,-0.2003037205770691,1
7165,7166,Marathahalli,196300,43120,153180,0.7803362200713194,0
7166,7167,Indiranagar,322450,111930,210520,0.6528764149480539,0
7167,7168,Malleswaram,162200,0,162200,1.0,-1
7168,7169,Jalahalli,399000,41520,357480,0.8959398496240601,-1
7169,7170,Shivajinagar,89300,26870,62430,0.699104143337066,0
7170,7171,Banaswadi,318350,13430,304920,0.9578137270299985,-1
7171,7172,Varthur,169700,88990,80710,0.4756040070713023,1
7172,7173,Mahadevapura,432100,43570,388530,0.8991668595232585,-1
7173,7174,Rajajinagar,435000,99890,335110,0.770367816091954,0
7174,7175,Krishnarajapuram,407550,15010,392540,0.9631701631701631,-1
7175,7176,Shivajinagar,310500,115260,195240,0.628792270531401,0
7176,7177,Marathahalli,177550,60780,116770,0.6576738946775557,0
7177,7178,Mahadevapura,135450,46440,89010,0.6571428571428571,0
7178,7179,Banaswadi,211950,54310,157640,0.7437603208303846,0
7179,7180,Rajajinagar,116600,29440,87160,0.7475128644939966,0
7180,7181,Jalahalli,334950,86700,248250,0.7411553963278101,0
7181,7182,Varthur,253700,85350,168350,0.663579030350808,0
7182,7183,Kalyan Nagar,47400,83790,-36390,-0.7677215189873418,1
7183,7184,Kalyan Nagar,91200,83680,7520,0.0824561403508772,1
7184,7185,Whitefield,127550,100760,26790,0.21003528028224225,1
7185,7186,Shivajinagar,429900,140300,289600,0.6736450337287742,0
7186,7187,Hoodi,38900,47390,-8490,-0.21825192802056556,1
7187,7188,Shivajinagar,324050,29210,294840,0.9098595895695109,-1
7188,7189,Krishnarajapuram,138050,58480,79570,0.5763853676204274,0
7189,7190,HBR Layout,229000,7170,221830,0.9686899563318777,-1
7190,7191,Kalyan Nagar,299000,58530,240470,0.8042474916387959,-1
7191,7192,Hoodi,402450,32830,369620,0.9184246490247235,-1
7192,7193,Malleswaram,44500,105990,-61490,-1.3817977528089889,1
7193,7194,CV Raman Nagar,28000,53990,-25990,-0.9282142857142858,1
7194,7195,Rajajinagar,344650,78000,266650,0.7736834469751922,0
7195,7196,Rajajinagar,280600,64710,215890,0.7693870277975766,0
7196,7197,Mahadevapura,437250,28520,408730,0.9347741566609491,-1
7197,7198,Horamavu,438000,19990,418010,0.9543607305936073,-1
7198,7199,Kalyan Nagar,422700,39950,382750,0.9054885261414715,-1
7199,7200,HBR Layout,111200,42310,68890,0.6195143884892086,0
7200,7201,Krishnarajapuram,197850,63960,133890,0.6767247915087188,0
7201,7202,Hebbal,74800,66210,8590,0.11483957219251337,1
7202,7203,Horamavu,75850,95770,-19920,-0.26262359920896505,1
7203,7204,Kalyan Nagar,418550,34000,384550,0.9187671723808386,-1
7204,7205,CV Raman Nagar,151850,74900,76950,0.506750082318077,0
7205,7206,Rajajinagar,356600,59120,297480,0.83421200224341,-1
7206,7207,Shivajinagar,233800,55610,178190,0.7621471343028229,0
7207,7208,HBR Layout,39650,96360,-56710,-1.4302648171500632,1
7208,7209,Krishnarajapuram,55950,71140,-15190,-0.27149240393208224,1
7209,7210,Whitefield,444700,128960,315740,0.7100067461209805,0
7210,7211,Jalahalli,202700,56370,146330,0.7219042920572274,0
7211,7212,Indiranagar,441900,18580,423320,0.9579542883005204,-1
7212,7213,Indiranagar,362150,162530,199620,0.5512080629573382,0
7213,7214,Horamavu,183300,28870,154430,0.8424986361156573,-1
7214,7215,Hoodi,387000,23910,363090,0.9382170542635659,-1
7215,7216,HBR Layout,70150,81400,-11250,-0.16037063435495366,1
7216,7217,Rajajinagar,330450,40570,289880,0.8772280223937056,-1
7217,7218,Whitefield,190550,50760,139790,0.7336132248753608,0
7218,7219,Shivajinagar,387300,16790,370510,0.9566485928221017,-1
7219,7220,Banaswadi,133400,62230,71170,0.5335082458770615,0
7220,7221,Mahadevapura,34000,135660,-101660,-2.99,1
7221,7222,Mahadevapura,127150,81190,45960,0.361462839166339,1
7222,7223,Vasanth Nagar,316350,11520,304830,0.9635846372688478,-1
7223,7224,Shivajinagar,353150,34440,318710,0.9024777006937562,-1
7224,7225,HBR Layout,330250,50600,279650,0.8467827403482211,-1
7225,7226,Marathahalli,114800,39940,74860,0.6520905923344947,0
7226,7227,Varthur,415200,52540,362660,0.8734585741811175,-1
7227,7228,CV Raman Nagar,246900,68680,178220,0.7218307006885378,0
7228,7229,Krishnarajapuram,198150,53880,144270,0.7280847842543527,0
7229,7230,CV Raman Nagar,198950,83030,115920,0.5826589595375723,0
7230,7231,Indiranagar,66200,97330,-31130,-0.4702416918429003,1
7231,7232,Rajajinagar,40100,58730,-18630,-0.46458852867830425,1
7232,7233,HBR Layout,342550,118470,224080,0.6541526784411035,0
7233,7234,HBR Layout,240250,19560,220690,0.9185848074921956,-1
7234,7235,Vasanth Nagar,397400,75930,321470,0.8089330649219929,-1
7235,7236,Mahadevapura,375800,56360,319440,0.8500266098988823,-1
7236,7237,Horamavu,38650,34850,3800,0.09831824062095731,1
7237,7238,Hoodi,247650,56550,191100,0.7716535433070866,0
7238,7239,CV Raman Nagar,208350,113410,94940,0.4556755459563235,1
7239,7240,Kalyan Nagar,235200,71140,164060,0.6975340136054422,0
7240,7241,Banaswadi,134350,9410,124940,0.9299590621510979,-1
7241,7242,HBR Layout,429650,71410,358240,0.8337949493774002,-1
7242,7243,HBR Layout,57400,68690,-11290,-0.19668989547038326,1
7243,7244,Jalahalli,392800,72570,320230,0.8152494908350305,-1
7244,7245,CV Raman Nagar,107450,113020,-5570,-0.05183806421591438,1
7245,7246,Mahadevapura,184950,48550,136400,0.7374966207082996,0
7246,7247,Krishnarajapuram,27300,57090,-29790,-1.091208791208791,1
7247,7248,Whitefield,302850,42710,260140,0.8589730889879478,-1
7248,7249,Varthur,57500,96550,-39050,-0.6791304347826087,1
7249,7250,Vasanth Nagar,33650,15780,17870,0.5310549777117385,0
7250,7251,CV Raman Nagar,42900,93790,-50890,-1.1862470862470862,1
7251,7252,Hebbal,50550,55470,-4920,-0.0973293768545994,1
7252,7253,Varthur,446450,16530,429920,0.9629745772202934,-1
7253,7254,Rajajinagar,435500,75390,360110,0.8268886337543054,-1
7254,7255,Hebbal,257300,67410,189890,0.7380101049358725,0
7255,7256,Horamavu,71000,47950,23050,0.3246478873239437,1
7256,7257,Kammanahalli,292550,26690,265860,0.908767732011622,-1
7257,7258,Malleswaram,114500,35760,78740,0.6876855895196506,0
7258,7259,Horamavu,428600,82580,346020,0.807326178254783,-1
7259,7260,Kammanahalli,220900,73950,146950,0.6652331371661385,0
7260,7261,Horamavu,425500,151270,274230,0.6444888366627497,0
7261,7262,Whitefield,346750,93390,253360,0.7306705118961788,0
7262,7263,Hebbal,229850,136100,93750,0.407874700891886,1
7263,7264,Krishnarajapuram,63650,82370,-18720,-0.2941084053417125,1
7264,7265,Indiranagar,312000,41240,270760,0.8678205128205129,-1
7265,7266,Shivajinagar,144450,46320,98130,0.6793354101765317,0
7266,7267,Hoodi,297250,26780,270470,0.9099074852817494,-1
7267,7268,Kalyan Nagar,270250,54090,216160,0.7998519888991674,0
7268,7269,Indiranagar,170150,98820,71330,0.41921833676168085,1
7269,7270,Krishnarajapuram,86200,87020,-820,-0.009512761020881671,1
7270,7271,Whitefield,49550,47450,2100,0.04238143289606458,1
7271,7272,Horamavu,322150,48080,274070,0.8507527549278286,-1
7272,7273,Hoodi,225650,59190,166460,0.7376911145579437,0
7273,7274,Horamavu,364550,16340,348210,0.9551776162391991,-1
7274,7275,Marathahalli,184450,111670,72780,0.3945784765519111,1
7275,7276,Kalyan Nagar,259950,83290,176660,0.6795922292748605,0
7276,7277,Whitefield,229100,122140,106960,0.46687036228721085,1
7277,7278,Indiranagar,118350,54470,63880,0.5397549640895648,0
7278,7279,Whitefield,84200,82760,1440,0.0171021377672209,1
7279,7280,Rajajinagar,145350,56400,88950,0.6119711042311662,0
7280,7281,Krishnarajapuram,350200,71420,278780,0.7960593946316391,0
7281,7282,Kalyan Nagar,197750,147460,50290,0.2543109987357775,1
7282,7283,Whitefield,141950,68460,73490,0.5177175061641422,0
7283,7284,Malleswaram,133150,44180,88970,0.6681937664288397,0
7284,7285,Hoodi,181050,25440,155610,0.8594863297431649,-1
7285,7286,HBR Layout,147550,79840,67710,0.45889528973229415,1
7286,7287,Varthur,233550,46240,187310,0.8020124170413188,-1
7287,7288,Mahadevapura,31950,0,31950,1.0,-1
7288,7289,Mahadevapura,283850,142300,141550,0.4986788796899771,1
7289,7290,Horamavu,249300,38770,210530,0.844484556758925,-1
7290,7291,Kalyan Nagar,299800,91310,208490,0.6954302868579053,0
7291,7292,Shivajinagar,264650,84050,180600,0.6824107311543548,0
7292,7293,CV Raman Nagar,58800,62540,-3740,-0.06360544217687075,1
7293,7294,Kammanahalli,70050,66270,3780,0.053961456102783724,1
7294,7295,Mahadevapura,74850,93200,-18350,-0.24515698062792252,1
7295,7296,Indiranagar,140200,46520,93680,0.668188302425107,0
7296,7297,Rajajinagar,104350,75690,28660,0.2746526114039291,1
7297,7298,Mahadevapura,74850,75730,-880,-0.01175684702738811,1
7298,7299,Whitefield,351050,30530,320520,0.9130323315766985,-1
7299,7300,Banaswadi,88700,90220,-1520,-0.01713641488162345,1
7300,7301,Varthur,254800,27330,227470,0.8927394034536892,-1
7301,7302,Mahadevapura,318700,93140,225560,0.7077502353310323,0
7302,7303,Indiranagar,420750,35190,385560,0.9163636363636364,-1
7303,7304,Kalyan Nagar,38050,31290,6760,0.1776609724047306,1
7304,7305,Whitefield,53950,46240,7710,0.14291010194624654,1
7305,7306,Whitefield,432650,33790,398860,0.9218999191032012,-1
7306,7307,Jalahalli,370950,123370,247580,0.6674214853753875,0
7307,7308,HBR Layout,279850,54890,224960,0.8038592102912274,-1
7308,7309,Malleswaram,253000,48580,204420,0.8079841897233202,-1
7309,7310,Horamavu,305900,48530,257370,0.8413533834586466,-1
7310,7311,Banaswadi,358500,73500,285000,0.7949790794979079,0
7311,7312,Vasanth Nagar,426650,45240,381410,0.8939646079924997,-1
7312,7313,Malleswaram,130200,132190,-1990,-0.015284178187403994,1
7313,7314,Malleswaram,88350,45150,43200,0.48896434634974534,1
7314,7315,Varthur,299550,24710,274840,0.9175095977299282,-1
7315,7316,Malleswaram,212900,47330,165570,0.7776890558947863,0
7316,7317,Rajajinagar,389700,62810,326890,0.8388247369771619,-1
7317,7318,Malleswaram,149500,76300,73200,0.48963210702341137,1
7318,7319,Varthur,206300,87750,118550,0.5746485700436258,0
7319,7320,Rajajinagar,345400,93730,251670,0.7286334684423856,0
7320,7321,Marathahalli,179300,28620,150680,0.8403792526491913,-1
7321,7322,Shivajinagar,221550,35510,186040,0.8397201534642293,-1
7322,7323,Jalahalli,156650,70120,86530,0.5523779125438877,0
7323,7324,Jalahalli,202550,98900,103650,0.5117254998765737,0
7324,7325,Kalyan Nagar,29800,41930,-12130,-0.4070469798657718,1
7325,7326,CV Raman Nagar,389550,69480,320070,0.8216403542549096,-1
7326,7327,Horamavu,278400,52920,225480,0.8099137931034482,-1
7327,7328,Kalyan Nagar,203450,101620,101830,0.5005160973212092,0
7328,7329,Kalyan Nagar,113150,80500,32650,0.28855501546619533,1
7329,7330,Kalyan Nagar,431900,121800,310100,0.7179902755267423,0
7330,7331,Banaswadi,124650,99310,25340,0.20328920978740472,1
7331,7332,Mahadevapura,283250,128350,154900,0.5468667255075023,0
7332,7333,Hoodi,86600,102960,-16360,-0.18891454965357968,1
7333,7334,CV Raman Nagar,127600,39690,87910,0.688949843260188,0
7334,7335,Jalahalli,348600,44190,304410,0.8732358003442341,-1
7335,7336,Mahadevapura,216700,60720,155980,0.7197969543147208,0
7336,7337,Vasanth Nagar,263150,59100,204050,0.7754132623978719,0
7337,7338,Mahadevapura,186500,40950,145550,0.7804289544235925,0
7338,7339,CV Raman Nagar,127750,59000,68750,0.538160469667319,0
7339,7340,Vasanth Nagar,256500,136060,120440,0.469551656920078,1
7340,7341,Hebbal,251750,43400,208350,0.8276067527308838,-1
7341,7342,Mahadevapura,60950,29090,31860,0.5227235438884331,0
7342,7343,Shivajinagar,201000,42430,158570,0.7889054726368159,0
7343,7344,Hebbal,444750,140680,304070,0.6836874648679033,0
7344,7345,Marathahalli,352150,47730,304420,0.8644611671162856,-1
7345,7346,CV Raman Nagar,328600,49000,279600,0.8508825319537432,-1
7346,7347,Varthur,387050,52110,334940,0.8653662317530035,-1
7347,7348,Whitefield,57150,49760,7390,0.12930883639545057,1
7348,7349,Shivajinagar,305150,92090,213060,0.6982139931181386,0
7349,7350,Rajajinagar,324200,99430,224770,0.6933066008636644,0
7350,7351,Kalyan Nagar,396250,68150,328100,0.82801261829653,-1
7351,7352,HBR Layout,372800,54660,318140,0.8533798283261803,-1
7352,7353,Banaswadi,98350,44760,53590,0.54489069649212,0
7353,7354,Varthur,280200,33230,246970,0.8814061384725196,-1
7354,7355,Kammanahalli,195600,60200,135400,0.6922290388548057,0
7355,7356,Hebbal,93650,31510,62140,0.6635344367325147,0
7356,7357,Marathahalli,274700,79800,194900,0.7095012741172187,0
7357,7358,Kalyan Nagar,119800,108750,11050,0.09223706176961603,1
7358,7359,Mahadevapura,290800,177930,112870,0.38813617606602474,1
7359,7360,Krishnarajapuram,233250,47630,185620,0.7957984994640943,0
7360,7361,Kalyan Nagar,40750,115970,-75220,-1.8458895705521472,1
7361,7362,Malleswaram,347150,55940,291210,0.838859282730808,-1
7362,7363,Kammanahalli,372200,122730,249470,0.6702579258463192,0
7363,7364,Kalyan Nagar,83900,28260,55640,0.6631704410011919,0
7364,7365,Jalahalli,429850,18800,411050,0.9562638129580086,-1
7365,7366,Kalyan Nagar,305850,82450,223400,0.7304234101683832,0
7366,7367,Varthur,167700,23500,144200,0.8598688133571855,-1
7367,7368,Marathahalli,233950,113540,120410,0.5146826244924129,0
7368,7369,HBR Layout,412900,35040,377860,0.9151368370065391,-1
7369,7370,Jalahalli,396750,27170,369580,0.931518588531821,-1
7370,7371,Hebbal,416900,42110,374790,0.8989925641640681,-1
7371,7372,Krishnarajapuram,370600,98960,271640,0.732973556395035,0
7372,7373,Marathahalli,403250,103980,299270,0.7421450712957223,0
7373,7374,Marathahalli,412850,16180,396670,0.9608090105365145,-1
7374,7375,Kammanahalli,447700,31160,416540,0.9303998213089122,-1
7375,7376,Banaswadi,332400,69820,262580,0.7899518652226234,0
7376,7377,HBR Layout,142000,22410,119590,0.8421830985915493,-1
7377,7378,Marathahalli,262900,127200,135700,0.5161658425256752,0
7378,7379,Krishnarajapuram,68500,84180,-15680,-0.2289051094890511,1
7379,7380,Rajajinagar,368250,24370,343880,0.9338221317040054,-1
7380,7381,Kalyan Nagar,140750,79680,61070,0.4338898756660746,1
7381,7382,Vasanth Nagar,398750,33830,364920,0.9151598746081505,-1
7382,7383,Banaswadi,312450,87640,224810,0.7195071211393823,0
7383,7384,Marathahalli,278300,32100,246200,0.8846568451311534,-1
7384,7385,HBR Layout,103000,81630,21370,0.2074757281553398,1
7385,7386,Banaswadi,360800,73980,286820,0.7949556541019955,0
7386,7387,Jalahalli,158400,135060,23340,0.14734848484848484,1
7387,7388,Krishnarajapuram,76200,68590,7610,0.09986876640419948,1
7388,7389,Whitefield,377450,64230,313220,0.8298317657967943,-1
7389,7390,Varthur,304100,34230,269870,0.887438342650444,-1
7390,7391,Vasanth Nagar,71400,72590,-1190,-0.016666666666666666,1
7391,7392,Kalyan Nagar,308200,26140,282060,0.9151849448410123,-1
7392,7393,CV Raman Nagar,300700,88450,212250,0.7058530096441636,0
7393,7394,Krishnarajapuram,323600,75890,247710,0.7654820766378245,0
7394,7395,CV Raman Nagar,30450,85230,-54780,-1.7990147783251231,1
7395,7396,Varthur,423900,70000,353900,0.8348667138476056,-1
7396,7397,HBR Layout,409300,45510,363790,0.8888101636941119,-1
7397,7398,Hebbal,302600,44880,257720,0.851685393258427,-1
7398,7399,Rajajinagar,31250,122090,-90840,-2.90688,1
7399,7400,HBR Layout,161550,35550,126000,0.7799442896935933,0
7400,7401,Krishnarajapuram,319400,121130,198270,0.6207576706324358,0
7401,7402,Shivajinagar,427350,102260,325090,0.7607113607113607,0
7402,7403,Kalyan Nagar,412600,59680,352920,0.8553562772661173,-1
7403,7404,HBR Layout,102450,120060,-17610,-0.1718887262079063,1
7404,7405,Hebbal,95050,54030,41020,0.43156233561283536,1
7405,7406,Marathahalli,168950,30210,138740,0.8211897010949986,-1
7406,7407,Banaswadi,276600,80290,196310,0.7097252349963846,0
7407,7408,Indiranagar,171800,74860,96940,0.5642607683352736,0
7408,7409,Hebbal,337150,70880,266270,0.789767165949874,0
7409,7410,Marathahalli,91250,31250,60000,0.6575342465753424,0
7410,7411,Kammanahalli,367600,64660,302940,0.8241022850924918,-1
7411,7412,Jalahalli,409000,70530,338470,0.8275550122249389,-1
7412,7413,Malleswaram,87050,750,86300,0.9913842619184376,-1
7413,7414,Jalahalli,190200,60080,130120,0.6841219768664564,0
7414,7415,Marathahalli,330850,45710,285140,0.8618407133141908,-1
7415,7416,Marathahalli,391950,90420,301530,0.7693073096058171,0
7416,7417,Malleswaram,397050,42730,354320,0.8923813121773077,-1
7417,7418,Marathahalli,172300,58330,113970,0.6614625652930934,0
7418,7419,Kalyan Nagar,298750,93520,205230,0.6869623430962343,0
7419,7420,Krishnarajapuram,277150,106360,170790,0.616236694930543,0
7420,7421,Hebbal,316650,121370,195280,0.6167061424285488,0
7421,7422,Vasanth Nagar,129800,68670,61130,0.4709553158705701,1
7422,7423,Jalahalli,57900,49290,8610,0.14870466321243522,1
7423,7424,Krishnarajapuram,222950,63780,159170,0.7139268894370935,0
7424,7425,Shivajinagar,51300,80230,-28930,-0.5639376218323586,1
7425,7426,Mahadevapura,215800,23080,192720,0.8930491195551437,-1
7426,7427,Whitefield,414100,96370,317730,0.7672784351605892,0
7427,7428,Hebbal,371000,53680,317320,0.8553099730458221,-1
7428,7429,Jalahalli,303200,58000,245200,0.8087071240105541,-1
7429,7430,Kalyan Nagar,252450,115720,136730,0.5416122004357299,0
7430,7431,Horamavu,139700,73660,66040,0.4727272727272727,1
7431,7432,Marathahalli,26750,128590,-101840,-3.8071028037383177,1
7432,7433,Jalahalli,383450,99120,284330,0.7415047594210458,0
7433,7434,Hebbal,279250,55330,223920,0.8018621307072515,-1
7434,7435,Banaswadi,260400,19980,240420,0.9232718894009216,-1
7435,7436,Marathahalli,225250,15290,209960,0.9321198668146504,-1
7436,7437,HBR Layout,75650,0,75650,1.0,-1
7437,7438,Marathahalli,334650,53470,281180,0.840221126550127,-1
7438,7439,Vasanth Nagar,243900,40790,203110,0.832759327593276,-1
7439,7440,Jalahalli,278700,107320,171380,0.6149264442052386,0
7440,7441,CV Raman Nagar,197800,101810,95990,0.4852881698685541,1
7441,7442,Jalahalli,254750,85540,169210,0.6642198233562316,0
7442,7443,Shivajinagar,159650,109350,50300,0.3150642029439399,1
7443,7444,Jalahalli,217500,64450,153050,0.7036781609195403,0
7444,7445,Vasanth Nagar,195350,72820,122530,0.6272331712311237,0
7445,7446,Krishnarajapuram,45600,129000,-83400,-1.8289473684210527,1
7446,7447,Marathahalli,253050,42550,210500,0.8318514127642759,-1
7447,7448,Horamavu,146700,47360,99340,0.6771642808452625,0
7448,7449,Hebbal,40100,46270,-6170,-0.1538653366583541,1
7449,7450,Shivajinagar,38800,131310,-92510,-2.384278350515464,1
7450,7451,Indiranagar,171350,80970,90380,0.5274584184417859,0
7451,7452,Varthur,247900,42820,205080,0.827269060104881,-1
7452,7453,Hoodi,302350,28770,273580,0.9048453778733256,-1
7453,7454,Jalahalli,55350,43800,11550,0.2086720867208672,1
7454,7455,Hoodi,357000,80180,276820,0.775406162464986,0
7455,7456,Rajajinagar,134750,63980,70770,0.5251948051948052,0
7456,7457,Hoodi,48050,49860,-1810,-0.03766909469302809,1
7457,7458,Mahadevapura,164850,76290,88560,0.5372156505914468,0
7458,7459,HBR Layout,410550,41770,368780,0.898258433808306,-1
7459,7460,Jalahalli,288000,64990,223010,0.7743402777777778,0
7460,7461,Vasanth Nagar,180500,64310,116190,0.6437119113573407,0
7461,7462,HBR Layout,337250,60280,276970,0.8212601927353596,-1
7462,7463,Varthur,70600,23140,47460,0.6722379603399433,0
7463,7464,Vasanth Nagar,406400,18390,388010,0.9547490157480315,-1
7464,7465,Kalyan Nagar,72450,15210,57240,0.7900621118012422,0
7465,7466,Horamavu,438000,66150,371850,0.8489726027397261,-1
7466,7467,Hoodi,400750,90590,310160,0.7739488459139114,0
7467,7468,Mahadevapura,181550,39500,142050,0.7824290828972735,0
7468,7469,CV Raman Nagar,239200,91970,147230,0.615510033444816,0
7469,7470,Krishnarajapuram,199750,52240,147510,0.7384730913642052,0
7470,7471,Malleswaram,289300,57250,232050,0.8021085378499827,-1
7471,7472,Krishnarajapuram,392500,99990,292510,0.7452484076433121,0
7472,7473,Indiranagar,152300,48730,103570,0.6800393959290874,0
7473,7474,Marathahalli,407950,92830,315120,0.7724476038730237,0
7474,7475,Jalahalli,252750,64160,188590,0.7461523244312562,0
7475,7476,Hebbal,448000,13690,434310,0.9694419642857143,-1
7476,7477,Jalahalli,221050,25940,195110,0.882650983940285,-1
7477,7478,Vasanth Nagar,393850,93840,300010,0.7617367017900216,0
7478,7479,Mahadevapura,449800,49130,400670,0.8907736771898621,-1
7479,7480,Vasanth Nagar,415850,19850,396000,0.9522664422267645,-1
7480,7481,Whitefield,380800,82010,298790,0.7846376050420169,0
7481,7482,Hebbal,150750,4020,146730,0.9733333333333334,-1
7482,7483,Banaswadi,46400,86620,-40220,-0.8668103448275862,1
7483,7484,Vasanth Nagar,240350,71230,169120,0.70364052423549,0
7484,7485,Indiranagar,365400,39460,325940,0.892008757525999,-1
7485,7486,Kalyan Nagar,263450,39450,224000,0.8502562156006832,-1
7486,7487,Banaswadi,432750,124910,307840,0.7113575967648758,0
7487,7488,Hebbal,346550,58480,288070,0.8312509017457799,-1
7488,7489,Indiranagar,441950,41300,400650,0.9065505147641136,-1
7489,7490,Banaswadi,157050,79960,77090,0.490862782553327,1
7490,7491,Vasanth Nagar,361600,86120,275480,0.7618362831858407,0
7491,7492,Varthur,44900,83730,-38830,-0.8648106904231626,1
7492,7493,Horamavu,275250,44130,231120,0.8396730245231607,-1
7493,7494,Malleswaram,38850,150440,-111590,-2.872329472329472,1
7494,7495,Malleswaram,223950,47270,176680,0.7889260995757982,0
7495,7496,Rajajinagar,440450,43110,397340,0.9021228289249631,-1
7496,7497,Kalyan Nagar,427150,61410,365740,0.8562331733583051,-1
7497,7498,Krishnarajapuram,443050,63330,379720,0.8570590226836701,-1
7498,7499,Whitefield,55600,20930,34670,0.6235611510791367,0
7499,7500,Krishnarajapuram,410250,80490,329760,0.8038025594149909,-1
7500,7501,Banaswadi,421700,16370,405330,0.961180934313493,-1
7501,7502,Hoodi,120400,19660,100740,0.8367109634551495,-1
7502,7503,Krishnarajapuram,370650,64990,305660,0.8246593821664643,-1
7503,7504,Krishnarajapuram,105350,92420,12930,0.12273374466065495,1
7504,7505,Malleswaram,44100,56600,-12500,-0.2834467120181406,1
7505,7506,Indiranagar,36250,24520,11730,0.3235862068965517,1
7506,7507,Krishnarajapuram,113800,40420,73380,0.6448154657293498,0
7507,7508,Shivajinagar,169650,20780,148870,0.8775125257883879,-1
7508,7509,Marathahalli,376750,67900,308850,0.8197743861977439,-1
7509,7510,Whitefield,92050,45380,46670,0.507007061379685,0
7510,7511,HBR Layout,449300,76170,373130,0.8304696194079679,-1
7511,7512,Kammanahalli,110300,56100,54200,0.4913871260199456,1
7512,7513,HBR Layout,40550,104480,-63930,-1.5765721331689273,1
7513,7514,Marathahalli,380550,75830,304720,0.8007357771646302,-1
7514,7515,Whitefield,447550,100190,347360,0.7761367444978214,0
7515,7516,Mahadevapura,94300,17140,77160,0.8182396606574761,-1
7516,7517,Mahadevapura,411550,45350,366200,0.8898068278459482,-1
7517,7518,Krishnarajapuram,189500,115420,74080,0.3909234828496042,1
7518,7519,Malleswaram,99950,61960,37990,0.38009004502251126,1
7519,7520,Rajajinagar,52150,55110,-2960,-0.05675934803451582,1
7520,7521,Krishnarajapuram,343050,77830,265220,0.7731234513919254,0
7521,7522,Horamavu,374700,34730,339970,0.9073125166800107,-1
7522,7523,Indiranagar,279500,56220,223280,0.7988550983899821,0
7523,7524,Mahadevapura,215500,123380,92120,0.4274709976798144,1
7524,7525,HBR Layout,384400,60790,323610,0.8418574401664932,-1
7525,7526,Krishnarajapuram,245250,61200,184050,0.7504587155963303,0
7526,7527,Krishnarajapuram,223150,55620,167530,0.7507506161774591,0
7527,7528,Krishnarajapuram,401800,36680,365120,0.9087108013937282,-1
7528,7529,Varthur,45550,95260,-49710,-1.0913282107574094,1
7529,7530,Malleswaram,300950,63410,237540,0.7893005482638312,0
7530,7531,Horamavu,422650,44060,378590,0.8957529871051697,-1
7531,7532,Kalyan Nagar,377050,82440,294610,0.7813552579233524,0
7532,7533,Mahadevapura,160700,28560,132140,0.8222775357809583,-1
7533,7534,Mahadevapura,438900,56530,382370,0.871200729095466,-1
7534,7535,HBR Layout,160050,102290,57760,0.36088722274289287,1
7535,7536,Shivajinagar,393900,80570,313330,0.7954556994160955,0
7536,7537,Malleswaram,353250,41950,311300,0.881245576786978,-1
7537,7538,Varthur,365650,47250,318400,0.8707780664569944,-1
7538,7539,Whitefield,403950,77090,326860,0.8091595494491892,-1
7539,7540,Kammanahalli,322900,85490,237410,0.7352431093217714,0
7540,7541,HBR Layout,138600,44070,94530,0.682034632034632,0
7541,7542,CV Raman Nagar,409800,80460,329340,0.8036603221083455,-1
7542,7543,Krishnarajapuram,301000,94550,206450,0.6858803986710963,0
7543,7544,Vasanth Nagar,308250,19090,289160,0.9380697485806975,-1
7544,7545,Banaswadi,447300,82190,365110,0.8162530739995528,-1
7545,7546,Marathahalli,433550,72190,361360,0.8334909468342752,-1
7546,7547,Whitefield,379200,99390,279810,0.7378955696202532,0
7547,7548,Kammanahalli,198700,53760,144940,0.729441368897836,0
7548,7549,Indiranagar,51850,143990,-92140,-1.777049180327869,1
7549,7550,Kammanahalli,178950,50000,128950,0.7205923442302319,0
7550,7551,Banaswadi,32500,56310,-23810,-0.7326153846153847,1
7551,7552,Banaswadi,25500,20960,4540,0.1780392156862745,1
7552,7553,Whitefield,82800,43040,39760,0.4801932367149758,1
7553,7554,Hebbal,288450,68310,220140,0.763182527301092,0
7554,7555,Kammanahalli,223100,3890,219210,0.9825638727028239,-1
7555,7556,Kalyan Nagar,163050,101490,61560,0.37755289788408464,1
7556,7557,Hoodi,31100,137000,-105900,-3.405144694533762,1
7557,7558,Hebbal,27450,45680,-18230,-0.6641165755919854,1
7558,7559,Banaswadi,421750,58300,363450,0.8617664493183166,-1
7559,7560,Whitefield,338700,63030,275670,0.8139061116031887,-1
7560,7561,Banaswadi,29100,92260,-63160,-2.170446735395189,1
7561,7562,Kalyan Nagar,228100,164410,63690,0.27921964050854886,1
7562,7563,Indiranagar,305650,146880,158770,0.5194503517094716,0
7563,7564,HBR Layout,127250,115550,11700,0.09194499017681729,1
7564,7565,Vasanth Nagar,61200,92210,-31010,-0.5066993464052287,1
7565,7566,Hebbal,253350,113140,140210,0.5534241168344188,0
7566,7567,HBR Layout,34250,79490,-45240,-1.3208759124087592,1
7567,7568,Rajajinagar,62800,43220,19580,0.31178343949044585,1
7568,7569,CV Raman Nagar,182200,10040,172160,0.9448957189901207,-1
7569,7570,Hebbal,440150,62480,377670,0.858048392593434,-1
7570,7571,Marathahalli,369750,76690,293060,0.7925895875591616,0
7571,7572,Malleswaram,118700,56560,62140,0.5235046335299073,0
7572,7573,CV Raman Nagar,72150,43980,28170,0.39043659043659046,1
7573,7574,Krishnarajapuram,173100,57480,115620,0.6679376083188908,0
7574,7575,CV Raman Nagar,202850,74160,128690,0.6344096623120532,0
7575,7576,Jalahalli,312650,44420,268230,0.8579241963857348,-1
7576,7577,Kammanahalli,181800,63900,117900,0.6485148514851485,0
7577,7578,Hebbal,123800,71510,52290,0.42237479806138933,1
7578,7579,Rajajinagar,77700,36060,41640,0.5359073359073359,0
7579,7580,Rajajinagar,311450,62090,249360,0.800642157649703,-1
7580,7581,Rajajinagar,385850,115030,270820,0.7018789685110794,0
7581,7582,Kalyan Nagar,133850,105910,27940,0.20874112812850207,1
7582,7583,Varthur,30600,96520,-65920,-2.154248366013072,1
7583,7584,Krishnarajapuram,93900,105420,-11520,-0.12268370607028754,1
7584,7585,Malleswaram,370150,115490,254660,0.6879913548561394,0
7585,7586,Whitefield,209150,38460,170690,0.8161128376763088,-1
7586,7587,Mahadevapura,86400,94350,-7950,-0.0920138888888889,1
7587,7588,Hoodi,174250,62720,111530,0.6400573888091822,0
7588,7589,Mahadevapura,269000,46760,222240,0.8261710037174721,-1
7589,7590,Banaswadi,383950,98090,285860,0.7445240265659591,0
7590,7591,Varthur,137550,56260,81290,0.5909850963286077,0
7591,7592,Shivajinagar,116300,86550,29750,0.25580395528804817,1
7592,7593,CV Raman Nagar,243800,46280,197520,0.8101722723543888,-1
7593,7594,Shivajinagar,186900,27280,159620,0.8540395933654361,-1
7594,7595,Banaswadi,102500,101170,1330,0.01297560975609756,1
7595,7596,Indiranagar,265150,79040,186110,0.7019045823118989,0
7596,7597,Kalyan Nagar,340000,148750,191250,0.5625,0
7597,7598,HBR Layout,37750,66750,-29000,-0.7682119205298014,1
7598,7599,Rajajinagar,151700,29930,121770,0.8027027027027027,-1
7599,7600,Krishnarajapuram,301900,61810,240090,0.795263332229215,0
7600,7601,Rajajinagar,136900,38870,98030,0.7160701241782322,0
7601,7602,Hebbal,51050,159470,-108420,-2.123800195886386,1
7602,7603,Shivajinagar,244150,60680,183470,0.7514642637722712,0
7603,7604,Jalahalli,157300,8550,148750,0.945645263827082,-1
7604,7605,Jalahalli,329250,23380,305870,0.9289901290812452,-1
7605,7606,CV Raman Nagar,308850,77130,231720,0.7502671199611461,0
7606,7607,Jalahalli,66600,60280,6320,0.0948948948948949,1
7607,7608,Vasanth Nagar,87850,46280,41570,0.4731929425156517,1
7608,7609,Rajajinagar,45150,60350,-15200,-0.33665559246954596,1
7609,7610,Hoodi,88000,58650,29350,0.33352272727272725,1
7610,7611,Vasanth Nagar,257750,81300,176450,0.6845780795344326,0
7611,7612,Shivajinagar,317750,116210,201540,0.6342722265932337,0
7612,7613,Kalyan Nagar,440500,40110,400390,0.9089443813847901,-1
7613,7614,Marathahalli,263450,104160,159290,0.6046308597456823,0
7614,7615,Malleswaram,357150,37580,319570,0.8947781044379113,-1
7615,7616,Malleswaram,205000,64970,140030,0.6830731707317074,0
7616,7617,Marathahalli,301950,98260,203690,0.67458188441795,0
7617,7618,Shivajinagar,165600,34330,131270,0.7926932367149758,0
7618,7619,CV Raman Nagar,161700,49200,112500,0.6957328385899815,0
7619,7620,Horamavu,344350,67770,276580,0.8031944242776246,-1
7620,7621,Vasanth Nagar,267800,27730,240070,0.8964525765496639,-1
7621,7622,Hoodi,432450,33590,398860,0.9223262804948549,-1
7622,7623,Indiranagar,203950,64310,139640,0.6846776170630057,0
7623,7624,Kalyan Nagar,52800,49450,3350,0.0634469696969697,1
7624,7625,HBR Layout,257250,94100,163150,0.6342079689018465,0
7625,7626,Hebbal,208850,55160,153690,0.7358870002394062,0
7626,7627,Kalyan Nagar,411750,45290,366460,0.8900060716454159,-1
7627,7628,Kammanahalli,396950,65080,331870,0.836049880337574,-1
7628,7629,Jalahalli,437500,47280,390220,0.8919314285714286,-1
7629,7630,Horamavu,303600,61050,242550,0.7989130434782609,0
7630,7631,Hoodi,227400,99680,127720,0.5616534740545295,0
7631,7632,Hoodi,420200,101860,318340,0.7575916230366492,0
7632,7633,CV Raman Nagar,231450,98860,132590,0.5728667098725426,0
7633,7634,Mahadevapura,274900,13220,261680,0.9519097853765005,-1
7634,7635,CV Raman Nagar,310250,72980,237270,0.7647703464947623,0
7635,7636,Malleswaram,246000,108590,137410,0.5585772357723577,0
7636,7637,Indiranagar,35500,48700,-13200,-0.37183098591549296,1
7637,7638,Rajajinagar,27350,71180,-43830,-1.6025594149908593,1
7638,7639,Malleswaram,51150,68790,-17640,-0.3448680351906158,1
7639,7640,Kalyan Nagar,256950,63060,193890,0.7545826036193812,0
7640,7641,Kammanahalli,433250,73820,359430,0.8296133871898442,-1
7641,7642,Varthur,227650,31800,195850,0.8603118822754228,-1
7642,7643,Indiranagar,408250,53930,354320,0.86789957134109,-1
7643,7644,Mahadevapura,41250,53140,-11890,-0.28824242424242424,1
7644,7645,CV Raman Nagar,206700,38920,167780,0.8117077890662796,-1
7645,7646,Kammanahalli,353200,115800,237400,0.6721404303510758,0
7646,7647,Shivajinagar,240900,56240,184660,0.7665421336654213,0
7647,7648,Vasanth Nagar,309750,57010,252740,0.8159483454398708,-1
7648,7649,Malleswaram,272200,54090,218110,0.8012858192505511,-1
7649,7650,CV Raman Nagar,152100,79070,73030,0.4801446416831032,1
7650,7651,Shivajinagar,167900,73340,94560,0.5631923764145325,0
7651,7652,Varthur,152300,85130,67170,0.44103742613263297,1
7652,7653,Hoodi,56450,71720,-15270,-0.2705048715677591,1
7653,7654,Malleswaram,333650,114510,219140,0.6567960437584295,0
7654,7655,Horamavu,106450,35840,70610,0.6633161108501644,0
7655,7656,Horamavu,84400,81110,3290,0.038981042654028436,1
7656,7657,Varthur,148500,115020,33480,0.22545454545454546,1
7657,7658,Hoodi,70750,82640,-11890,-0.1680565371024735,1
7658,7659,Jalahalli,262550,75950,186600,0.7107217672824224,0
7659,7660,Horamavu,244100,48250,195850,0.8023351085620647,-1
7660,7661,Varthur,289550,113310,176240,0.6086686237264721,0
7661,7662,Indiranagar,100500,54890,45610,0.4538308457711443,1
7662,7663,Kammanahalli,297100,93020,204080,0.6869067653988556,0
7663,7664,Horamavu,289650,81150,208500,0.7198342827550492,0
7664,7665,Mahadevapura,264200,66040,198160,0.7500378501135503,0
7665,7666,Shivajinagar,396800,73130,323670,0.8157006048387097,-1
7666,7667,CV Raman Nagar,143600,58600,85000,0.5919220055710307,0
7667,7668,Malleswaram,41600,43430,-1830,-0.04399038461538462,1
7668,7669,CV Raman Nagar,316850,24620,292230,0.9222976171690074,-1
7669,7670,Horamavu,276500,69780,206720,0.747631103074141,0
7670,7671,Varthur,336400,88640,247760,0.7365041617122473,0
7671,7672,HBR Layout,191650,39560,152090,0.7935820506130968,0
7672,7673,Kammanahalli,393800,24440,369360,0.9379380396140172,-1
7673,7674,Hoodi,390700,42100,348600,0.8922446890197082,-1
7674,7675,Whitefield,175800,46970,128830,0.7328213879408418,0
7675,7676,Kalyan Nagar,172900,88720,84180,0.48687102371312896,1
7676,7677,Vasanth Nagar,41300,43970,-2670,-0.06464891041162228,1
7677,7678,Kammanahalli,380450,4380,376070,0.9884873176501512,-1
7678,7679,Hoodi,309250,32760,276490,0.8940662894098625,-1
7679,7680,Rajajinagar,252450,67450,185000,0.7328183798772034,0
7680,7681,Banaswadi,141450,90130,51320,0.36281371509367266,1
7681,7682,Hoodi,201950,41920,160030,0.7924238672938846,0
7682,7683,Banaswadi,267650,166870,100780,0.376536521576686,1
7683,7684,Varthur,372850,35880,336970,0.9037682714228242,-1
7684,7685,Banaswadi,73100,71620,1480,0.02024623803009576,1
7685,7686,Shivajinagar,291350,52700,238650,0.8191178994336709,-1
7686,7687,Rajajinagar,169050,36380,132670,0.7847973972197575,0
7687,7688,Vasanth Nagar,31850,76450,-44600,-1.4003139717425432,1
7688,7689,Banaswadi,147650,96670,50980,0.3452759905181172,1
7689,7690,Jalahalli,240800,95950,144850,0.6015365448504983,0
7690,7691,CV Raman Nagar,74150,92250,-18100,-0.24409979770734996,1
7691,7692,Kammanahalli,280700,17160,263540,0.938867117919487,-1
7692,7693,Malleswaram,60100,0,60100,1.0,-1
7693,7694,Krishnarajapuram,233800,38410,195390,0.8357142857142857,-1
7694,7695,Banaswadi,133550,70210,63340,0.4742792961437664,1
7695,7696,Hoodi,231950,94460,137490,0.5927570597111447,0
7696,7697,Mahadevapura,357400,81550,275850,0.7718242865137102,0
7697,7698,Varthur,66850,18600,48250,0.7217651458489155,0
7698,7699,Kammanahalli,293300,51590,241710,0.8241050119331742,-1
7699,7700,Kammanahalli,189900,43230,146670,0.7723538704581359,0
7700,7701,Mahadevapura,222450,32160,190290,0.855428186109238,-1
7701,7702,Whitefield,167300,46200,121100,0.7238493723849372,0
7702,7703,Vasanth Nagar,407300,24210,383090,0.9405597839430395,-1
7703,7704,Krishnarajapuram,144500,29170,115330,0.7981314878892733,0
7704,7705,Malleswaram,133600,53780,79820,0.5974550898203593,0
7705,7706,Vasanth Nagar,74600,45210,29390,0.3939678284182306,1
7706,7707,Hoodi,55100,27890,27210,0.4938294010889292,1
7707,7708,CV Raman Nagar,350200,90540,259660,0.7414620217018847,0
7708,7709,Shivajinagar,194200,41730,152470,0.7851184346035015,0
7709,7710,Whitefield,290700,64390,226310,0.778500171998624,0
7710,7711,Kammanahalli,178100,0,178100,1.0,-1
7711,7712,Varthur,425150,23510,401640,0.9447018699282607,-1
7712,7713,Kammanahalli,429300,82190,347110,0.8085488003726997,-1
7713,7714,Marathahalli,62600,90970,-28370,-0.45319488817891374,1
7714,7715,Malleswaram,354800,17600,337200,0.9503945885005637,-1
7715,7716,Rajajinagar,75350,44580,30770,0.4083609820836098,1
7716,7717,Hebbal,381300,98600,282700,0.7414109624967218,0
7717,7718,Banaswadi,163700,60580,103120,0.6299328039095907,0
7718,7719,Indiranagar,422550,88600,333950,0.7903206721098095,0
7719,7720,Hoodi,156400,81300,75100,0.48017902813299235,1
7720,7721,Hoodi,244100,106890,137210,0.5621056943875461,0
7721,7722,Horamavu,106950,53230,53720,0.5022907900888266,0
7722,7723,Rajajinagar,210250,64500,145750,0.6932223543400713,0
7723,7724,Horamavu,139900,28820,111080,0.7939957112223016,0
7724,7725,CV Raman Nagar,26500,48350,-21850,-0.8245283018867925,1
7725,7726,Malleswaram,274150,107220,166930,0.60890023709648,0
7726,7727,Whitefield,358250,22280,335970,0.9378087927424983,-1
7727,7728,Kammanahalli,169950,75100,94850,0.5581053250956164,0
7728,7729,Horamavu,335700,35700,300000,0.8936550491510277,-1
7729,7730,Banaswadi,258550,84070,174480,0.6748404563914137,0
7730,7731,Rajajinagar,140600,104370,36230,0.25768136557610244,1
7731,7732,Malleswaram,379500,107650,271850,0.7163372859025033,0
7732,7733,Jalahalli,406650,2630,404020,0.9935325218246649,-1
7733,7734,Krishnarajapuram,150500,14370,136130,0.9045182724252492,-1
7734,7735,Kammanahalli,350150,97280,252870,0.7221762101956305,0
7735,7736,Whitefield,290650,84080,206570,0.710717357646654,0
7736,7737,Malleswaram,243550,55220,188330,0.7732703756928762,0
7737,7738,Horamavu,110150,11240,98910,0.8979573309123922,-1
7738,7739,Whitefield,403000,46830,356170,0.8837965260545906,-1
7739,7740,Mahadevapura,229450,49450,180000,0.7844846371758553,0
7740,7741,HBR Layout,85500,40460,45040,0.5267836257309941,0
7741,7742,Mahadevapura,139500,60900,78600,0.5634408602150538,0
7742,7743,HBR Layout,110750,40770,69980,0.6318735891647855,0
7743,7744,Whitefield,434900,90940,343960,0.790894458496206,0
7744,7745,CV Raman Nagar,209050,90480,118570,0.5671848839990433,0
7745,7746,Horamavu,255750,68840,186910,0.730830889540567,0
7746,7747,Krishnarajapuram,301050,39740,261310,0.8679953496096994,-1
7747,7748,Mahadevapura,384850,14470,370380,0.9624009354293881,-1
7748,7749,Indiranagar,378000,95540,282460,0.7472486772486773,0
7749,7750,Varthur,263950,26210,237740,0.9007008903201363,-1
7750,7751,Hoodi,218900,22290,196610,0.898172681589767,-1
7751,7752,Indiranagar,274700,20020,254680,0.9271204950855478,-1
7752,7753,Rajajinagar,216550,57620,158930,0.7339182636804433,0
7753,7754,Krishnarajapuram,82550,71230,11320,0.1371290127195639,1
7754,7755,CV Raman Nagar,327150,17640,309510,0.946079779917469,-1
7755,7756,Marathahalli,415650,29430,386220,0.9291952363767593,-1
7756,7757,Banaswadi,130600,55030,75570,0.5786370597243492,0
7757,7758,Rajajinagar,140150,108640,31510,0.22483053870852657,1
7758,7759,Vasanth Nagar,444250,48260,395990,0.8913674732695555,-1
7759,7760,Kalyan Nagar,346200,48590,297610,0.8596476025418833,-1
7760,7761,Horamavu,304550,66280,238270,0.7823674273518306,0
7761,7762,Jalahalli,178150,61950,116200,0.6522593320235757,0
7762,7763,Hoodi,293000,76730,216270,0.7381228668941979,0
7763,7764,Jalahalli,163650,100120,63530,0.3882065383440269,1
7764,7765,Whitefield,222450,44810,177640,0.7985614744886491,0
7765,7766,Shivajinagar,359000,58060,300940,0.8382729805013928,-1
7766,7767,Shivajinagar,346850,20370,326480,0.9412714429868819,-1
7767,7768,Hebbal,285800,28300,257500,0.9009797060881736,-1
7768,7769,Rajajinagar,85900,37770,48130,0.560302677532014,0
7769,7770,Banaswadi,92950,72220,20730,0.22302313071543842,1
7770,7771,Marathahalli,308700,12340,296360,0.960025915127956,-1
7771,7772,Varthur,369150,50870,318280,0.8621969389137207,-1
7772,7773,Malleswaram,28200,146210,-118010,-4.184751773049645,1
7773,7774,Shivajinagar,219900,84190,135710,0.6171441564347431,0
7774,7775,HBR Layout,321950,48430,273520,0.8495729150489206,-1
7775,7776,Malleswaram,306800,25570,281230,0.9166558018252934,-1
7776,7777,Kalyan Nagar,268100,104630,163470,0.6097351734427452,0
7777,7778,Malleswaram,174050,30240,143810,0.8262568227520828,-1
7778,7779,Banaswadi,95200,23160,72040,0.7567226890756302,0
7779,7780,Jalahalli,166900,59180,107720,0.6454164170161774,0
7780,7781,Malleswaram,241500,75060,166440,0.689192546583851,0
7781,7782,Kammanahalli,238800,67810,170990,0.7160385259631491,0
7782,7783,Kammanahalli,344900,47950,296950,0.860974195418962,-1
7783,7784,Shivajinagar,232550,91790,140760,0.6052891851214792,0
7784,7785,CV Raman Nagar,158350,80250,78100,0.4932112409220082,1
7785,7786,Malleswaram,72400,64500,7900,0.10911602209944751,1
7786,7787,Marathahalli,279600,54260,225340,0.8059370529327611,-1
7787,7788,Hoodi,276800,101600,175200,0.6329479768786127,0
7788,7789,Hoodi,330200,55870,274330,0.8307995154451847,-1
7789,7790,Kalyan Nagar,284100,34230,249870,0.8795142555438226,-1
7790,7791,Mahadevapura,395300,106960,288340,0.7294206931444472,0
7791,7792,Hebbal,441250,60570,380680,0.8627308781869688,-1
7792,7793,Varthur,276550,24390,252160,0.91180618333032,-1
7793,7794,Hoodi,411000,37090,373910,0.909756690997567,-1
7794,7795,Hoodi,287050,36870,250180,0.8715554781396969,-1
7795,7796,Varthur,280150,114420,165730,0.5915759414599322,0
7796,7797,Jalahalli,342700,67450,275250,0.8031806244528742,-1
7797,7798,Vasanth Nagar,277450,77110,200340,0.7220760497386917,0
7798,7799,Whitefield,285450,25530,259920,0.9105622700998424,-1
7799,7800,Vasanth Nagar,414350,55270,359080,0.8666103535658259,-1
7800,7801,Hebbal,147100,40460,106640,0.7249490142760027,0
7801,7802,Jalahalli,420900,97810,323090,0.7676170111665479,0
7802,7803,Whitefield,133750,62940,70810,0.5294205607476635,0
7803,7804,Jalahalli,72800,91440,-18640,-0.256043956043956,1
7804,7805,Varthur,209800,24270,185530,0.8843183984747378,-1
7805,7806,Mahadevapura,146100,50060,96040,0.6573579739904175,0
7806,7807,Hoodi,123050,58050,65000,0.5282405526208859,0
7807,7808,Hoodi,169750,59410,110340,0.6500147275405007,0
7808,7809,Marathahalli,209000,46240,162760,0.778755980861244,0
7809,7810,HBR Layout,341950,156350,185600,0.5427694107325632,0
7810,7811,CV Raman Nagar,448750,77140,371610,0.828100278551532,-1
7811,7812,Horamavu,384250,97750,286500,0.745608327911516,0
7812,7813,Indiranagar,445600,58650,386950,0.8683797127468582,-1
7813,7814,Kammanahalli,130850,28980,101870,0.7785250286587696,0
7814,7815,Rajajinagar,233950,35320,198630,0.8490275699935884,-1
7815,7816,Mahadevapura,88900,72520,16380,0.18425196850393702,1
7816,7817,Kalyan Nagar,28800,49610,-20810,-0.7225694444444445,1
7817,7818,Vasanth Nagar,191850,69010,122840,0.6402918947094084,0
7818,7819,Jalahalli,343600,38440,305160,0.8881257275902212,-1
7819,7820,Kalyan Nagar,412450,28950,383500,0.9298096738998667,-1
7820,7821,Kammanahalli,193400,55770,137630,0.7116339193381592,0
7821,7822,Kammanahalli,153200,109540,43660,0.2849869451697128,1
7822,7823,Kalyan Nagar,117100,68880,48220,0.4117847993168232,1
7823,7824,Horamavu,326050,22630,303420,0.9305934672596228,-1
7824,7825,Hoodi,199950,85240,114710,0.573693423355839,0
7825,7826,CV Raman Nagar,98350,50930,47420,0.48215556685307576,1
7826,7827,Horamavu,124300,66260,58040,0.466934835076428,1
7827,7828,Shivajinagar,159200,95540,63660,0.3998743718592965,1
7828,7829,Shivajinagar,77300,46350,30950,0.4003880983182406,1
7829,7830,Jalahalli,106000,109850,-3850,-0.03632075471698113,1
7830,7831,Hoodi,364800,34270,330530,0.9060581140350877,-1
7831,7832,Marathahalli,268700,144260,124440,0.4631187197618162,1
7832,7833,Malleswaram,26450,72010,-45560,-1.7224952741020794,1
7833,7834,Hoodi,256300,111920,144380,0.56332422941865,0
7834,7835,Rajajinagar,127000,82040,44960,0.35401574803149605,1
7835,7836,Marathahalli,288550,55400,233150,0.8080055449662104,-1
7836,7837,Indiranagar,98050,91230,6820,0.06955634880163182,1
7837,7838,Malleswaram,185250,66610,118640,0.6404318488529015,0
7838,7839,Whitefield,279950,57480,222470,0.7946776210037507,0
7839,7840,Indiranagar,233600,37540,196060,0.8392979452054794,-1
7840,7841,Jalahalli,282350,26120,256230,0.9074907030281566,-1
7841,7842,Kammanahalli,355950,53620,302330,0.8493608652900688,-1
7842,7843,Varthur,137650,133230,4420,0.032110424990919,1
7843,7844,Horamavu,82700,78920,3780,0.045707376058041115,1
7844,7845,Kammanahalli,342650,24090,318560,0.9296950240770465,-1
7845,7846,Hebbal,252950,67040,185910,0.7349673848586677,0
7846,7847,Rajajinagar,80700,25620,55080,0.6825278810408922,0
7847,7848,Horamavu,411700,79610,332090,0.806631042020889,-1
7848,7849,Malleswaram,443750,91570,352180,0.7936450704225352,0
7849,7850,Horamavu,302900,50130,252770,0.8344998349290195,-1
7850,7851,Marathahalli,58000,116010,-58010,-1.0001724137931034,1
7851,7852,Kammanahalli,83600,51220,32380,0.3873205741626794,1
7852,7853,Banaswadi,47250,69740,-22490,-0.475978835978836,1
7853,7854,Shivajinagar,49150,165770,-116620,-2.372736520854527,1
7854,7855,Marathahalli,406350,45040,361310,0.8891595914851729,-1
7855,7856,Whitefield,196700,47800,148900,0.7569903406202338,0
7856,7857,Kalyan Nagar,185750,97780,87970,0.4735935397039031,1
7857,7858,CV Raman Nagar,302550,63170,239380,0.7912080647826806,0
7858,7859,Jalahalli,432400,53200,379200,0.8769657724329325,-1
7859,7860,Krishnarajapuram,418050,61100,356950,0.8538452338237053,-1
7860,7861,Rajajinagar,159550,83430,76120,0.4770918207458477,1
7861,7862,HBR Layout,263250,23460,239790,0.9108831908831909,-1
7862,7863,Banaswadi,339650,33180,306470,0.9023112027086707,-1
7863,7864,Hebbal,72550,50430,22120,0.30489317711922814,1
7864,7865,Malleswaram,375300,95180,280120,0.7463895550226486,0
7865,7866,Varthur,224950,61310,163640,0.727450544565459,0
7866,7867,CV Raman Nagar,160250,76070,84180,0.5253042121684868,0
7867,7868,Horamavu,78950,57380,21570,0.2732108929702343,1
7868,7869,Horamavu,207250,79050,128200,0.6185765983112184,0
7869,7870,Horamavu,386600,112270,274330,0.7095964821520951,0
7870,7871,HBR Layout,268400,83480,184920,0.6889716840536513,0
7871,7872,Kalyan Nagar,314700,77520,237180,0.7536701620591039,0
7872,7873,HBR Layout,124000,77560,46440,0.37451612903225806,1
7873,7874,Jalahalli,254250,78130,176120,0.6927040314650934,0
7874,7875,Kalyan Nagar,400900,120190,280710,0.700199551010227,0
7875,7876,Shivajinagar,178850,96670,82180,0.4594911937377691,1
7876,7877,HBR Layout,151850,72690,79160,0.5213039183404675,0
7877,7878,Rajajinagar,154550,67050,87500,0.566159818828858,0
7878,7879,Banaswadi,220500,34650,185850,0.8428571428571429,-1
7879,7880,Marathahalli,430950,39020,391930,0.9094558533472561,-1
7880,7881,Horamavu,143900,74250,69650,0.48401667824878386,1
7881,7882,Kalyan Nagar,37250,114090,-76840,-2.0628187919463086,1
7882,7883,Marathahalli,85600,34970,50630,0.5914719626168224,0
7883,7884,Hoodi,266000,96030,169970,0.638984962406015,0
7884,7885,Mahadevapura,251650,100190,151460,0.6018676733558513,0
7885,7886,Rajajinagar,210300,89940,120360,0.5723252496433666,0
7886,7887,Mahadevapura,333250,26630,306620,0.9200900225056264,-1
7887,7888,Vasanth Nagar,40650,62600,-21950,-0.5399753997539976,1
7888,7889,Rajajinagar,248450,65400,183050,0.7367679613604347,0
7889,7890,HBR Layout,270800,81520,189280,0.6989660265878878,0
7890,7891,Marathahalli,318550,62100,256450,0.8050541516245487,-1
7891,7892,Indiranagar,438450,78180,360270,0.8216900444748546,-1
7892,7893,Mahadevapura,273800,30680,243120,0.8879474068663258,-1
7893,7894,Marathahalli,386400,99780,286620,0.7417701863354037,0
7894,7895,HBR Layout,227550,3350,224200,0.985277960887717,-1
7895,7896,Hebbal,325150,76760,248390,0.7639243426111025,0
7896,7897,Malleswaram,58950,67940,-8990,-0.15250212044105174,1
7897,7898,Kammanahalli,308250,132640,175610,0.5696999188969992,0
7898,7899,Shivajinagar,251150,54740,196410,0.782042604021501,0
7899,7900,Varthur,43400,94830,-51430,-1.1850230414746543,1
7900,7901,Malleswaram,298250,114970,183280,0.6145180217937971,0
7901,7902,Marathahalli,177950,42690,135260,0.7601011520089913,0
7902,7903,Vasanth Nagar,82450,32560,49890,0.6050939963614311,0
7903,7904,Shivajinagar,171800,30290,141510,0.8236903376018626,-1
7904,7905,Horamavu,219450,85660,133790,0.6096605149236728,0
7905,7906,Shivajinagar,430700,99320,331380,0.7693986533550035,0
7906,7907,Mahadevapura,423350,57760,365590,0.8635644265973781,-1
7907,7908,Vasanth Nagar,333350,13630,319720,0.9591120443977801,-1
7908,7909,Vasanth Nagar,426050,100070,325980,0.7651214646168291,0
7909,7910,Marathahalli,74100,107740,-33640,-0.45398110661268554,1
7910,7911,Marathahalli,399400,67420,331980,0.8311967951927892,-1
7911,7912,Marathahalli,41550,92380,-50830,-1.2233453670276775,1
7912,7913,Hebbal,65900,129590,-63690,-0.966464339908953,1
7913,7914,Kalyan Nagar,372700,39040,333660,0.8952508720150255,-1
7914,7915,Jalahalli,103150,52180,50970,0.494134755210858,1
7915,7916,Kalyan Nagar,289150,5420,283730,0.9812554037696697,-1
7916,7917,Vasanth Nagar,181450,61410,120040,0.6615596583080738,0
7917,7918,HBR Layout,305000,15790,289210,0.9482295081967214,-1
7918,7919,Marathahalli,400700,36110,364590,0.9098827052657849,-1
7919,7920,Rajajinagar,402200,104320,297880,0.740626553953257,0
7920,7921,CV Raman Nagar,67250,36210,31040,0.4615613382899628,1
7921,7922,Rajajinagar,309450,28610,280840,0.9075456455000808,-1
7922,7923,Krishnarajapuram,206500,46240,160260,0.7760774818401937,0
7923,7924,Shivajinagar,270750,38810,231940,0.856657433056325,-1
7924,7925,Whitefield,114950,71330,43620,0.3794693344932579,1
7925,7926,Horamavu,50650,13340,37310,0.7366238894373149,0
7926,7927,CV Raman Nagar,415700,90820,324880,0.7815251383209045,0
7927,7928,Horamavu,256950,63490,193460,0.7529091262891613,0
7928,7929,Marathahalli,109750,71840,37910,0.34542141230068335,1
7929,7930,Malleswaram,339200,84240,254960,0.7516509433962264,0
7930,7931,Whitefield,325300,45620,279680,0.8597602213341531,-1
7931,7932,Varthur,411750,21910,389840,0.9467880995749848,-1
7932,7933,Indiranagar,432200,41760,390440,0.9033780657103193,-1
7933,7934,Hoodi,123950,35310,88640,0.7151270673658733,0
7934,7935,Mahadevapura,413800,64110,349690,0.8450700821652972,-1
7935,7936,Hoodi,211250,26310,184940,0.8754556213017751,-1
7936,7937,Shivajinagar,444600,65680,378920,0.8522717049032839,-1
7937,7938,Hebbal,384050,46590,337460,0.878687670876188,-1
7938,7939,Marathahalli,120750,22080,98670,0.8171428571428572,-1
7939,7940,Malleswaram,203350,69150,134200,0.6599459060732726,0
7940,7941,Whitefield,70550,63560,6990,0.09907866761162296,1
7941,7942,Rajajinagar,207300,0,207300,1.0,-1
7942,7943,Indiranagar,395850,114440,281410,0.7109005936592143,0
7943,7944,Kammanahalli,188950,49400,139550,0.7385551733262768,0
7944,7945,HBR Layout,78700,107820,-29120,-0.37001270648030493,1
7945,7946,Marathahalli,336350,71860,264490,0.7863535008176007,0
7946,7947,Indiranagar,398050,69110,328940,0.8263785956538123,-1
7947,7948,Varthur,172400,93970,78430,0.45493039443155453,1
7948,7949,Whitefield,94700,101470,-6770,-0.07148891235480465,1
7949,7950,Shivajinagar,101800,63870,37930,0.37259332023575636,1
7950,7951,Kammanahalli,197450,57320,140130,0.709698657888073,0
7951,7952,Kammanahalli,76250,68070,8180,0.10727868852459016,1
7952,7953,Hoodi,283250,63030,220220,0.7774757281553398,0
7953,7954,Hebbal,47250,26970,20280,0.4292063492063492,1
7954,7955,Horamavu,363900,45900,318000,0.8738664468260511,-1
7955,7956,Jalahalli,294500,78910,215590,0.7320543293718167,0
7956,7957,Marathahalli,93700,50080,43620,0.4655282817502668,1
7957,7958,Varthur,167000,26050,140950,0.8440119760479042,-1
7958,7959,Shivajinagar,27100,52430,-25330,-0.9346863468634686,1
7959,7960,Jalahalli,94250,80740,13510,0.143342175066313,1
7960,7961,Jalahalli,305400,39800,265600,0.8696791093647676,-1
7961,7962,Malleswaram,295700,47470,248230,0.8394656746702739,-1
7962,7963,Krishnarajapuram,104600,44630,59970,0.5733269598470363,0
7963,7964,Jalahalli,204900,40770,164130,0.8010248901903367,-1
7964,7965,Horamavu,188350,48640,139710,0.7417573666047252,0
7965,7966,Mahadevapura,438150,47190,390960,0.8922971585073605,-1
7966,7967,Mahadevapura,310850,17060,293790,0.9451182242239022,-1
7967,7968,Varthur,66650,35300,31350,0.4703675918979745,1
7968,7969,Hoodi,170950,23320,147630,0.8635858438139807,-1
7969,7970,Vasanth Nagar,404700,107190,297510,0.7351371386212009,0
7970,7971,Shivajinagar,105650,35090,70560,0.6678655939422622,0
7971,7972,Krishnarajapuram,265350,71290,194060,0.731335971358583,0
7972,7973,Mahadevapura,422400,76400,346000,0.8191287878787878,-1
7973,7974,Kammanahalli,153350,36810,116540,0.7599608738180632,0
7974,7975,Whitefield,402300,23560,378740,0.941436738752175,-1
7975,7976,Shivajinagar,224050,31870,192180,0.8577549654095068,-1
7976,7977,Hebbal,348150,86590,261560,0.751285365503375,0
7977,7978,Jalahalli,72600,63470,9130,0.12575757575757576,1
7978,7979,Indiranagar,338100,84140,253960,0.7511387163561076,0
7979,7980,Varthur,241950,82890,159060,0.6574085554866708,0
7980,7981,Jalahalli,78000,35030,42970,0.5508974358974359,0
7981,7982,CV Raman Nagar,43750,85070,-41320,-0.9444571428571429,1
7982,7983,Jalahalli,125250,57240,68010,0.5429940119760479,0
7983,7984,Jalahalli,171500,109440,62060,0.361865889212828,1
7984,7985,Hoodi,168550,82790,85760,0.5088104420053396,0
7985,7986,Kammanahalli,89200,34110,55090,0.6176008968609865,0
7986,7987,Hoodi,232450,52840,179610,0.7726822972682297,0
7987,7988,Horamavu,207850,58730,149120,0.717440461871542,0
7988,7989,Mahadevapura,263600,7850,255750,0.9702200303490136,-1
7989,7990,Horamavu,240350,21510,218840,0.9105055127938423,-1
7990,7991,Whitefield,412950,53580,359370,0.870250635670178,-1
7991,7992,Hoodi,269150,69310,199840,0.7424856028237042,0
7992,7993,Banaswadi,142850,109710,33140,0.231991599579979,1
7993,7994,Horamavu,394000,89700,304300,0.7723350253807106,0
7994,7995,Marathahalli,216150,43220,172930,0.8000462641684015,-1
7995,7996,Jalahalli,189450,12960,176490,0.9315914489311163,-1
7996,7997,CV Raman Nagar,292750,20980,271770,0.928334756618275,-1
7997,7998,Mahadevapura,103350,56310,47040,0.4551523947750363,1
7998,7999,Krishnarajapuram,352650,81310,271340,0.7694314476109457,0
7999,8000,Krishnarajapuram,111150,60570,50580,0.45506072874493925,1
8000,8001,Shivajinagar,166700,4170,162530,0.9749850029994002,-1
8001,8002,Vasanth Nagar,232150,104100,128050,0.5515830282145164,0
8002,8003,Jalahalli,238050,46560,191490,0.8044108380592313,-1
8003,8004,Rajajinagar,255900,122030,133870,0.5231340367330989,0
8004,8005,Shivajinagar,40550,33480,7070,0.17435265104808878,1
8005,8006,Mahadevapura,30450,49560,-19110,-0.6275862068965518,1
8006,8007,Indiranagar,250850,139750,111100,0.44289415985648795,1
8007,8008,Hebbal,188650,42240,146410,0.7760932944606413,0
8008,8009,Varthur,292750,104290,188460,0.6437574722459436,0
8009,8010,Jalahalli,271200,113900,157300,0.5800147492625368,0
8010,8011,Indiranagar,79000,72770,6230,0.07886075949367088,1
8011,8012,CV Raman Nagar,140150,34730,105420,0.7521940777738138,0
8012,8013,Hoodi,313500,39650,273850,0.8735247208931419,-1
8013,8014,Whitefield,171500,50360,121140,0.7063556851311953,0
8014,8015,Mahadevapura,353800,91880,261920,0.7403052572074619,0
8015,8016,Whitefield,247650,37740,209910,0.8476075105996366,-1
8016,8017,Jalahalli,302750,104170,198580,0.6559207266721717,0
8017,8018,Varthur,198750,106470,92280,0.4643018867924528,1
8018,8019,HBR Layout,287050,41910,245140,0.8539975614004529,-1
8019,8020,Hoodi,280200,27430,252770,0.9021056388294075,-1
8020,8021,Rajajinagar,187700,88890,98810,0.526425146510389,0
8021,8022,Varthur,35050,72760,-37710,-1.0758915834522111,1
8022,8023,Marathahalli,84900,48150,36750,0.43286219081272087,1
8023,8024,Shivajinagar,322250,38070,284180,0.8818619084561675,-1
8024,8025,Kammanahalli,319650,101570,218080,0.6822462067886751,0
8025,8026,Rajajinagar,326500,35980,290520,0.8898009188361409,-1
8026,8027,Varthur,348350,80170,268180,0.7698579015358117,0
8027,8028,Rajajinagar,417850,73680,344170,0.8236687806629173,-1
8028,8029,Mahadevapura,231800,73130,158670,0.6845125107851596,0
8029,8030,CV Raman Nagar,241600,106300,135300,0.5600165562913907,0
8030,8031,Indiranagar,377450,61040,316410,0.8382832163200424,-1
8031,8032,Vasanth Nagar,156000,123060,32940,0.21115384615384616,1
8032,8033,Varthur,369050,89210,279840,0.7582712369597615,0
8033,8034,Kammanahalli,102550,21430,81120,0.7910287664553877,0
8034,8035,HBR Layout,131600,39980,91620,0.6962006079027355,0
8035,8036,Jalahalli,445600,64050,381550,0.8562612208258528,-1
8036,8037,HBR Layout,115150,117290,-2140,-0.018584455058619193,1
8037,8038,Banaswadi,323450,57310,266140,0.822816509506879,-1
8038,8039,Varthur,80500,73680,6820,0.08472049689440994,1
8039,8040,Marathahalli,263250,105390,157860,0.5996581196581197,0
8040,8041,Hebbal,304800,32900,271900,0.8920603674540682,-1
8041,8042,Kalyan Nagar,136700,34810,101890,0.7453547915142648,0
8042,8043,HBR Layout,26800,69560,-42760,-1.5955223880597016,1
8043,8044,Banaswadi,235950,27260,208690,0.8844670481034117,-1
8044,8045,Krishnarajapuram,393350,75070,318280,0.8091521545697217,-1
8045,8046,Varthur,59050,95190,-36140,-0.6120237087214225,1
8046,8047,Marathahalli,89150,58970,30180,0.33853056646102075,1
8047,8048,Hoodi,250900,89230,161670,0.6443603029095257,0
8048,8049,Indiranagar,391600,27640,363960,0.9294177732379979,-1
8049,8050,Indiranagar,414400,39920,374480,0.9036679536679537,-1
8050,8051,Vasanth Nagar,296900,24510,272390,0.9174469518356348,-1
8051,8052,Marathahalli,287750,121210,166540,0.5787662901824501,0
8052,8053,CV Raman Nagar,232150,4250,227900,0.9816928709885849,-1
8053,8054,Whitefield,180650,70670,109980,0.6088015499584832,0
8054,8055,Vasanth Nagar,180000,14860,165140,0.9174444444444444,-1
8055,8056,Mahadevapura,157800,71800,86000,0.5449936628643853,0
8056,8057,Kalyan Nagar,364550,48970,315580,0.8656700041146619,-1
8057,8058,Indiranagar,74800,124420,-49620,-0.6633689839572192,1
8058,8059,Kalyan Nagar,392350,41070,351280,0.8953230533962023,-1
8059,8060,Krishnarajapuram,446350,33200,413150,0.9256189089279713,-1
8060,8061,Hebbal,68750,55130,13620,0.1981090909090909,1
8061,8062,Varthur,301900,48790,253110,0.83839019542895,-1
8062,8063,Krishnarajapuram,424750,3230,421520,0.9923955267804591,-1
8063,8064,Krishnarajapuram,189350,7220,182130,0.9618695537364669,-1
8064,8065,Rajajinagar,288350,49350,239000,0.8288538234784116,-1
8065,8066,Horamavu,396000,65380,330620,0.8348989898989899,-1
8066,8067,Malleswaram,442900,116880,326020,0.7361029577782795,0
8067,8068,Malleswaram,148450,111240,37210,0.2506567867969013,1
8068,8069,Kammanahalli,347400,60180,287220,0.8267702936096718,-1
8069,8070,HBR Layout,367250,74960,292290,0.7958883594281825,0
8070,8071,Horamavu,354400,39090,315310,0.8897009029345373,-1
8071,8072,Banaswadi,194950,107300,87650,0.4496024621697871,1
8072,8073,Malleswaram,153850,144250,9600,0.062398440038999026,1
8073,8074,Shivajinagar,89200,55840,33360,0.3739910313901345,1
8074,8075,Mahadevapura,34750,22560,12190,0.35079136690647483,1
8075,8076,Whitefield,214000,73150,140850,0.6581775700934579,0
8076,8077,Marathahalli,284550,111290,173260,0.6088912317694606,0
8077,8078,Malleswaram,166700,40450,126250,0.7573485302939412,0
8078,8079,Whitefield,164550,55300,109250,0.66393193558189,0
8079,8080,Varthur,131850,84110,47740,0.3620781190747061,1
8080,8081,Indiranagar,111150,44570,66580,0.5990103463787674,0
8081,8082,Varthur,397150,66150,331000,0.8334382475135339,-1
8082,8083,HBR Layout,150050,57430,92620,0.6172609130289903,0
8083,8084,Shivajinagar,70750,46650,24100,0.34063604240282686,1
8084,8085,Indiranagar,350400,47820,302580,0.8635273972602739,-1
8085,8086,Vasanth Nagar,195950,31570,164380,0.8388874712936973,-1
8086,8087,Krishnarajapuram,390250,38210,352040,0.9020884048686739,-1
8087,8088,HBR Layout,113750,71960,41790,0.36738461538461537,1
8088,8089,HBR Layout,293700,73970,219730,0.7481443649982976,0
8089,8090,Kalyan Nagar,416400,38150,378250,0.9083813640730067,-1
8090,8091,Whitefield,245650,17470,228180,0.9288825564828007,-1
8091,8092,Krishnarajapuram,134950,57700,77250,0.5724342349018154,0
8092,8093,Kalyan Nagar,37450,48350,-10900,-0.2910547396528705,1
8093,8094,Kalyan Nagar,167050,103130,63920,0.38263992816521997,1
8094,8095,Shivajinagar,223000,52720,170280,0.7635874439461884,0
8095,8096,Varthur,67150,74110,-6960,-0.10364854802680566,1
8096,8097,Banaswadi,225700,84300,141400,0.6264953478068233,0
8097,8098,Malleswaram,167500,57960,109540,0.6539701492537313,0
8098,8099,Malleswaram,95700,63220,32480,0.3393939393939394,1
8099,8100,Kammanahalli,84650,62980,21670,0.2559952746603662,1
8100,8101,Kammanahalli,102200,67410,34790,0.3404109589041096,1
8101,8102,Horamavu,77700,34800,42900,0.5521235521235521,0
8102,8103,Whitefield,272500,55330,217170,0.796954128440367,0
8103,8104,Krishnarajapuram,49750,138450,-88700,-1.7829145728643216,1
8104,8105,CV Raman Nagar,50050,55150,-5100,-0.1018981018981019,1
8105,8106,Marathahalli,213700,102800,110900,0.5189518015910154,0
8106,8107,Rajajinagar,34000,70670,-36670,-1.078529411764706,1
8107,8108,Marathahalli,337650,42570,295080,0.8739227010217681,-1
8108,8109,Vasanth Nagar,336500,44120,292380,0.8688855869242199,-1
8109,8110,Vasanth Nagar,38450,77260,-38810,-1.0093628088426527,1
8110,8111,HBR Layout,116950,59470,57480,0.49149209063702437,1
8111,8112,Varthur,331050,134730,196320,0.5930222020842773,0
8112,8113,Jalahalli,25750,52130,-26380,-1.0244660194174757,1
8113,8114,Kalyan Nagar,411350,114530,296820,0.7215753008387018,0
8114,8115,Kammanahalli,440250,53570,386680,0.8783191368540602,-1
8115,8116,Marathahalli,60250,178750,-118500,-1.966804979253112,1
8116,8117,Rajajinagar,245500,58780,186720,0.7605702647657842,0
8117,8118,Indiranagar,63500,144420,-80920,-1.2743307086614173,1
8118,8119,Horamavu,385550,27180,358370,0.9295033069640773,-1
8119,8120,Horamavu,131500,99120,32380,0.24623574144486693,1
8120,8121,Malleswaram,419950,51650,368300,0.8770091677580665,-1
8121,8122,Banaswadi,82700,22010,60690,0.7338573155985489,0
8122,8123,Whitefield,373250,76610,296640,0.7947488278633623,0
8123,8124,Varthur,375500,20350,355150,0.9458055925432757,-1
8124,8125,Krishnarajapuram,196650,39730,156920,0.7979659293160437,0
8125,8126,Krishnarajapuram,436250,27480,408770,0.9370085959885387,-1
8126,8127,Jalahalli,186800,85930,100870,0.5399892933618844,0
8127,8128,Varthur,423550,40990,382560,0.903222760004722,-1
8128,8129,Varthur,435100,38930,396170,0.9105263157894737,-1
8129,8130,Kammanahalli,84000,97100,-13100,-0.15595238095238095,1
8130,8131,CV Raman Nagar,445900,65600,380300,0.8528818120654855,-1
8131,8132,Kalyan Nagar,185950,26130,159820,0.8594783543963431,-1
8132,8133,HBR Layout,268550,53000,215550,0.8026438279649972,-1
8133,8134,CV Raman Nagar,340600,67460,273140,0.801937756899589,-1
8134,8135,Shivajinagar,301500,78050,223450,0.7411276948590382,0
8135,8136,Indiranagar,262550,49500,213050,0.8114644829556275,-1
8136,8137,Hoodi,311800,143610,168190,0.5394162924951892,0
8137,8138,Kammanahalli,357750,34990,322760,0.9021942697414396,-1
8138,8139,Kalyan Nagar,301150,66480,234670,0.7792462228125518,0
8139,8140,CV Raman Nagar,74700,34440,40260,0.5389558232931727,0
8140,8141,Varthur,218950,58020,160930,0.7350079926923955,0
8141,8142,Varthur,447750,83030,364720,0.8145616973757678,-1
8142,8143,CV Raman Nagar,406300,31360,374940,0.922815653458036,-1
8143,8144,Mahadevapura,228100,71120,156980,0.6882069267864972,0
8144,8145,Hebbal,114900,36510,78390,0.6822454308093995,0
8145,8146,Marathahalli,307800,61240,246560,0.8010396361273554,-1
8146,8147,Jalahalli,110200,135510,-25310,-0.2296733212341198,1
8147,8148,Rajajinagar,78750,118020,-39270,-0.49866666666666665,1
8148,8149,Varthur,255100,88990,166110,0.651156409251274,0
8149,8150,Marathahalli,391750,71000,320750,0.818761965539247,-1
8150,8151,Indiranagar,76900,135820,-58920,-0.7661898569570871,1
8151,8152,Jalahalli,105700,65470,40230,0.3806054872280038,1
8152,8153,HBR Layout,404550,133180,271370,0.6707947101717958,0
8153,8154,Jalahalli,107900,69540,38360,0.35551436515291934,1
8154,8155,Whitefield,97800,131250,-33450,-0.34202453987730064,1
8155,8156,Malleswaram,374900,70860,304040,0.8109895972259269,-1
8156,8157,Horamavu,115500,118160,-2660,-0.02303030303030303,1
8157,8158,Mahadevapura,48250,61420,-13170,-0.27295336787564767,1
8158,8159,Malleswaram,58400,71900,-13500,-0.23116438356164384,1
8159,8160,Malleswaram,304350,46210,258140,0.8481682273698045,-1
8160,8161,Hoodi,235050,89280,145770,0.6201659221442246,0
8161,8162,Vasanth Nagar,172650,90630,82020,0.47506516072980015,1
8162,8163,Whitefield,224400,89770,134630,0.5999554367201426,0
8163,8164,Rajajinagar,214700,119060,95640,0.44545877969259434,1
8164,8165,Malleswaram,292200,49020,243180,0.8322381930184805,-1
8165,8166,Rajajinagar,273800,55910,217890,0.795799853907962,0
8166,8167,Krishnarajapuram,316650,178480,138170,0.4363492815411337,1
8167,8168,Jalahalli,212850,87720,125130,0.5878787878787879,0
8168,8169,Indiranagar,136850,146020,-9170,-0.0670076726342711,1
8169,8170,Whitefield,82650,35870,46780,0.5660012099213552,0
8170,8171,Kalyan Nagar,133500,34530,98970,0.7413483146067416,0
8171,8172,Indiranagar,101050,24720,76330,0.7553686293913904,0
8172,8173,Vasanth Nagar,187300,83790,103510,0.5526428190069408,0
8173,8174,Horamavu,185050,14080,170970,0.9239124560929478,-1
8174,8175,Krishnarajapuram,360050,38140,321910,0.8940702680183308,-1
8175,8176,Rajajinagar,323850,14540,309310,0.9551026709896557,-1
8176,8177,CV Raman Nagar,147950,70530,77420,0.5232848935451166,0
8177,8178,Rajajinagar,32250,104530,-72280,-2.2412403100775196,1
8178,8179,CV Raman Nagar,358350,14070,344280,0.9607367099204688,-1
8179,8180,Horamavu,239700,53530,186170,0.7766791823112223,0
8180,8181,Whitefield,422800,48060,374740,0.8863292336802271,-1
8181,8182,Mahadevapura,103250,87370,15880,0.15380145278450363,1
8182,8183,Whitefield,218150,98230,119920,0.5497134998854,0
8183,8184,Kammanahalli,284700,58710,225990,0.7937829293993678,0
8184,8185,Banaswadi,42800,77980,-35180,-0.8219626168224299,1
8185,8186,Marathahalli,383700,11330,372370,0.970471722700026,-1
8186,8187,Krishnarajapuram,202600,15220,187380,0.9248766041461007,-1
8187,8188,Rajajinagar,227700,116420,111280,0.48871321914800175,1
8188,8189,Rajajinagar,149550,52900,96650,0.6462721497826813,0
8189,8190,Shivajinagar,373450,51530,321920,0.8620163341812827,-1
8190,8191,Whitefield,130000,64400,65600,0.5046153846153846,0
8191,8192,Rajajinagar,386100,62700,323400,0.8376068376068376,-1
8192,8193,Whitefield,74950,41660,33290,0.44416277518345565,1
8193,8194,HBR Layout,430350,89540,340810,0.7919367956314628,0
8194,8195,HBR Layout,380050,80050,300000,0.7893698197605579,0
8195,8196,Mahadevapura,200300,49250,151050,0.754118821767349,0
8196,8197,Jalahalli,59850,26170,33680,0.5627401837928153,0
8197,8198,Shivajinagar,277250,17350,259900,0.9374211000901713,-1
8198,8199,Hebbal,412450,126060,286390,0.6943629530852224,0
8199,8200,Varthur,225350,109120,116230,0.5157754603949412,0
8200,8201,Whitefield,211450,112520,98930,0.46786474343816503,1
8201,8202,Varthur,242100,68580,173520,0.7167286245353159,0
8202,8203,Whitefield,383350,112130,271220,0.7074996739272206,0
8203,8204,Horamavu,325450,54500,270950,0.8325395606083884,-1
8204,8205,Malleswaram,255100,55600,199500,0.782046256370051,0
8205,8206,Marathahalli,160500,17190,143310,0.8928971962616823,-1
8206,8207,Hebbal,404750,53960,350790,0.8666831377393452,-1
8207,8208,Malleswaram,344100,163800,180300,0.5239755884917175,0
8208,8209,Varthur,384800,79370,305430,0.7937370062370063,0
8209,8210,Krishnarajapuram,169500,31340,138160,0.8151032448377581,-1
8210,8211,Malleswaram,215600,76250,139350,0.6463358070500927,0
8211,8212,Jalahalli,212200,38270,173930,0.8196512723845429,-1
8212,8213,Horamavu,299750,50750,249000,0.8306922435362802,-1
8213,8214,HBR Layout,147800,69230,78570,0.5315967523680649,0
8214,8215,Hebbal,372750,52070,320680,0.8603085177733065,-1
8215,8216,Malleswaram,143250,87400,55850,0.3898778359511344,1
8216,8217,Horamavu,176550,36250,140300,0.7946757292551685,0
8217,8218,HBR Layout,208500,0,208500,1.0,-1
8218,8219,Indiranagar,83800,55740,28060,0.3348448687350835,1
8219,8220,Kammanahalli,50050,59760,-9710,-0.194005994005994,1
8220,8221,Rajajinagar,253400,116060,137340,0.541988950276243,0
8221,8222,Banaswadi,431800,40280,391520,0.906716072255674,-1
8222,8223,Marathahalli,215700,95090,120610,0.5591562355122855,0
8223,8224,CV Raman Nagar,65100,79220,-14120,-0.21689708141321046,1
8224,8225,Shivajinagar,152950,127480,25470,0.16652500817260543,1
8225,8226,Hebbal,436700,56450,380250,0.8707350583924891,-1
8226,8227,Mahadevapura,381400,42070,339330,0.889695857367593,-1
8227,8228,HBR Layout,285550,110360,175190,0.6135177727193136,0
8228,8229,Banaswadi,435500,77910,357590,0.8211021814006889,-1
8229,8230,Hoodi,180950,57690,123260,0.6811826471400939,0
8230,8231,Marathahalli,291300,80550,210750,0.723480947476828,0
8231,8232,CV Raman Nagar,299450,53670,245780,0.8207714142594758,-1
8232,8233,HBR Layout,407250,47970,359280,0.8822099447513813,-1
8233,8234,Mahadevapura,172900,71360,101540,0.5872758820127241,0
8234,8235,Vasanth Nagar,370300,35370,334930,0.904482851741831,-1
8235,8236,Jalahalli,408550,99110,309440,0.7574103536898789,0
8236,8237,Mahadevapura,291100,60830,230270,0.7910340089316387,0
8237,8238,Hebbal,84300,102950,-18650,-0.22123368920521946,1
8238,8239,Hebbal,91250,61520,29730,0.32580821917808217,1
8239,8240,Krishnarajapuram,142650,66740,75910,0.5321416053277253,0
8240,8241,Mahadevapura,403100,34130,368970,0.9153311833291987,-1
8241,8242,HBR Layout,166200,133030,33170,0.19957882069795427,1
8242,8243,CV Raman Nagar,444800,65470,379330,0.8528102517985612,-1
8243,8244,Whitefield,369200,68780,300420,0.8137053087757313,-1
8244,8245,Banaswadi,234300,23580,210720,0.899359795134443,-1
8245,8246,Vasanth Nagar,347700,26240,321460,0.9245326430831177,-1
8246,8247,Indiranagar,222300,78360,143940,0.6475033738191633,0
8247,8248,Varthur,274300,74040,200260,0.7300765585125775,0
8248,8249,Kalyan Nagar,222100,85240,136860,0.6162089149031967,0
8249,8250,Kalyan Nagar,399200,80450,318750,0.7984719438877755,0
8250,8251,Malleswaram,427650,61380,366270,0.856471413539109,-1
8251,8252,Hoodi,426500,44500,382000,0.895662368112544,-1
8252,8253,Rajajinagar,172950,85950,87000,0.5030355594102341,0
8253,8254,Shivajinagar,390050,36960,353090,0.9052429175746699,-1
8254,8255,Krishnarajapuram,160800,76310,84490,0.5254353233830846,0
8255,8256,Banaswadi,174850,130850,44000,0.251644266514155,1
8256,8257,Banaswadi,302850,21430,281420,0.9292388971438006,-1
8257,8258,Shivajinagar,132000,32230,99770,0.7558333333333334,0
8258,8259,HBR Layout,290050,55960,234090,0.8070677469401827,-1
8259,8260,Indiranagar,178400,57260,121140,0.6790358744394619,0
8260,8261,Shivajinagar,213950,74180,139770,0.6532834774480019,0
8261,8262,Kammanahalli,136550,110320,26230,0.19209080922738925,1
8262,8263,Jalahalli,120000,74550,45450,0.37875,1
8263,8264,Malleswaram,76050,39540,36510,0.48007889546351085,1
8264,8265,Shivajinagar,143400,15030,128370,0.8951882845188285,-1
8265,8266,Marathahalli,263600,74790,188810,0.7162746585735964,0
8266,8267,Mahadevapura,330450,74350,256100,0.7750037827205326,0
8267,8268,Indiranagar,328450,61570,266880,0.8125437661744558,-1
8268,8269,Hebbal,427700,52100,375600,0.878185644143091,-1
8269,8270,Horamavu,113000,27150,85850,0.7597345132743363,0
8270,8271,CV Raman Nagar,160400,46140,114260,0.7123441396508728,0
8271,8272,Rajajinagar,427150,69330,357820,0.837691677396699,-1
8272,8273,Rajajinagar,449750,68030,381720,0.8487381878821567,-1
8273,8274,Hoodi,253650,54350,199300,0.7857283658584664,0
8274,8275,Kalyan Nagar,203800,37390,166410,0.8165358194308145,-1
8275,8276,Whitefield,406850,106490,300360,0.738257343001106,0
8276,8277,Malleswaram,176650,109450,67200,0.38041324653269176,1
8277,8278,Marathahalli,109950,147060,-37110,-0.3375170532060027,1
8278,8279,Indiranagar,310100,65070,245030,0.790164463076427,0
8279,8280,Jalahalli,87850,46990,40860,0.46511098463289696,1
8280,8281,Kalyan Nagar,197000,50300,146700,0.7446700507614213,0
8281,8282,Jalahalli,316300,37050,279250,0.8828643692696807,-1
8282,8283,Malleswaram,443450,79630,363820,0.8204307137219529,-1
8283,8284,Banaswadi,297050,34590,262460,0.883554957077933,-1
8284,8285,Marathahalli,307950,70670,237280,0.7705146939438221,0
8285,8286,Indiranagar,72750,44910,27840,0.38268041237113404,1
8286,8287,Varthur,172000,41690,130310,0.7576162790697675,0
8287,8288,Mahadevapura,348650,64070,284580,0.8162340456044744,-1
8288,8289,Hebbal,103750,46420,57330,0.5525783132530121,0
8289,8290,Hebbal,270900,106330,164570,0.6074935400516795,0
8290,8291,Mahadevapura,177700,30130,147570,0.8304445694991559,-1
8291,8292,Shivajinagar,396900,36870,360030,0.9071050642479214,-1
8292,8293,Kalyan Nagar,271550,56220,215330,0.7929663045479654,0
8293,8294,Indiranagar,368450,85120,283330,0.7689781517166508,0
8294,8295,Varthur,96450,90120,6330,0.0656298600311042,1
8295,8296,CV Raman Nagar,143700,51170,92530,0.6439109255393181,0
8296,8297,Hebbal,410900,53500,357400,0.8697980043806279,-1
8297,8298,Mahadevapura,252850,62650,190200,0.7522246391140993,0
8298,8299,Varthur,98750,54940,43810,0.44364556962025314,1
8299,8300,Rajajinagar,176550,2940,173610,0.9833474936278674,-1
8300,8301,Shivajinagar,402000,20670,381330,0.9485820895522388,-1
8301,8302,Whitefield,249050,65100,183950,0.7386067054808272,0
8302,8303,Varthur,134200,96660,37540,0.2797317436661699,1
8303,8304,Krishnarajapuram,280800,52260,228540,0.8138888888888889,-1
8304,8305,Marathahalli,416700,76820,339880,0.8156467482601392,-1
8305,8306,Horamavu,182350,23120,159230,0.8732108582396491,-1
8306,8307,HBR Layout,193600,86510,107090,0.553150826446281,0
8307,8308,Indiranagar,252650,76230,176420,0.6982782505442312,0
8308,8309,HBR Layout,310750,10590,300160,0.9659211584875301,-1
8309,8310,Varthur,337650,50430,287220,0.8506441581519325,-1
8310,8311,Shivajinagar,367750,3940,363810,0.9892861998640381,-1
8311,8312,Indiranagar,242500,101530,140970,0.5813195876288659,0
8312,8313,Kammanahalli,180900,17950,162950,0.9007739082365948,-1
8313,8314,Jalahalli,333850,26610,307240,0.9202935450052419,-1
8314,8315,Horamavu,55050,84290,-29240,-0.5311534968210717,1
8315,8316,Shivajinagar,384100,43480,340620,0.886800312418641,-1
8316,8317,Jalahalli,113500,71590,41910,0.3692511013215859,1
8317,8318,HBR Layout,182750,59090,123660,0.6766621067031464,0
8318,8319,Hebbal,309200,146100,163100,0.527490297542044,0
8319,8320,CV Raman Nagar,209500,70460,139040,0.6636754176610978,0
8320,8321,Malleswaram,297700,66310,231390,0.7772589855559288,0
8321,8322,Varthur,245750,45860,199890,0.8133875890132248,-1
8322,8323,Marathahalli,140650,89170,51480,0.3660149306789904,1
8323,8324,Indiranagar,237400,89760,147640,0.6219039595619208,0
8324,8325,Banaswadi,304050,55020,249030,0.8190429205722743,-1
8325,8326,Marathahalli,275050,36360,238690,0.8678058534811852,-1
8326,8327,Mahadevapura,362100,25750,336350,0.9288870477768573,-1
8327,8328,Kammanahalli,363850,39650,324200,0.891026521918373,-1
8328,8329,Rajajinagar,58200,30300,27900,0.4793814432989691,1
8329,8330,Mahadevapura,150600,46280,104320,0.6926958831341301,0
8330,8331,Marathahalli,132250,77260,54990,0.41580340264650284,1
8331,8332,Marathahalli,286150,78860,207290,0.7244102743316443,0
8332,8333,Jalahalli,76900,53170,23730,0.30858257477243173,1
8333,8334,Varthur,370300,75490,294810,0.7961382662705914,0
8334,8335,Malleswaram,348900,90930,257970,0.7393809114359415,0
8335,8336,Whitefield,342900,28350,314550,0.9173228346456693,-1
8336,8337,Indiranagar,108400,73370,35030,0.3231549815498155,1
8337,8338,Horamavu,162100,126880,35220,0.21727328809376928,1
8338,8339,Krishnarajapuram,278150,102410,175740,0.6318173647312602,0
8339,8340,Krishnarajapuram,257050,48620,208430,0.81085391947092,-1
8340,8341,Indiranagar,138950,68080,70870,0.5100395825836632,0
8341,8342,Indiranagar,86200,69820,16380,0.1900232018561485,1
8342,8343,Mahadevapura,383800,84110,299690,0.7808494007295467,0
8343,8344,Kammanahalli,343100,12100,331000,0.9647333139026523,-1
8344,8345,Hoodi,30250,72060,-41810,-1.3821487603305784,1
8345,8346,Mahadevapura,328900,47060,281840,0.8569169960474309,-1
8346,8347,Malleswaram,105750,74550,31200,0.2950354609929078,1
8347,8348,Varthur,225750,12540,213210,0.944451827242525,-1
8348,8349,Krishnarajapuram,376200,129670,246530,0.6553163211057947,0
8349,8350,Hoodi,406500,67440,339060,0.8340959409594096,-1
8350,8351,Shivajinagar,281950,35460,246490,0.874233020039014,-1
8351,8352,Horamavu,176800,33740,143060,0.8091628959276018,-1
8352,8353,Jalahalli,236650,61360,175290,0.7407141347982252,0
8353,8354,HBR Layout,351500,60140,291360,0.8289046941678521,-1
8354,8355,Whitefield,430950,49020,381930,0.8862513052558302,-1
8355,8356,Rajajinagar,396200,66940,329260,0.8310449268046441,-1
8356,8357,HBR Layout,179600,86670,92930,0.5174276169265033,0
8357,8358,Kalyan Nagar,302250,67430,234820,0.7769065343258892,0
8358,8359,Mahadevapura,167800,80620,87180,0.5195470798569726,0
8359,8360,Whitefield,166350,61440,104910,0.6306582506762849,0
8360,8361,Kalyan Nagar,106600,85940,20660,0.19380863039399623,1
8361,8362,Hebbal,317400,85860,231540,0.7294896030245747,0
8362,8363,HBR Layout,219200,20260,198940,0.9075729927007299,-1
8363,8364,HBR Layout,266450,79410,187040,0.7019703509101145,0
8364,8365,Hoodi,316150,20580,295570,0.9349043175707734,-1
8365,8366,HBR Layout,210850,71160,139690,0.6625088925776619,0
8366,8367,Banaswadi,66800,34580,32220,0.48233532934131734,1
8367,8368,Varthur,435150,74550,360600,0.8286797655980697,-1
8368,8369,Marathahalli,249650,64130,185520,0.7431203685159223,0
8369,8370,Vasanth Nagar,184850,83410,101440,0.5487692723830132,0
8370,8371,Whitefield,330000,76980,253020,0.7667272727272727,0
8371,8372,Malleswaram,361850,45300,316550,0.8748100041453641,-1
8372,8373,Shivajinagar,50250,52750,-2500,-0.04975124378109453,1
8373,8374,Shivajinagar,64850,78570,-13720,-0.2115651503469545,1
8374,8375,Hebbal,349500,29630,319870,0.9152217453505007,-1
8375,8376,Banaswadi,94850,31500,63350,0.6678966789667896,0
8376,8377,Krishnarajapuram,436900,33710,403190,0.9228427557793546,-1
8377,8378,Hoodi,448200,173740,274460,0.6123605533244088,0
8378,8379,Varthur,261550,106730,154820,0.5919327088510801,0
8379,8380,Whitefield,418400,78850,339550,0.8115439770554493,-1
8380,8381,Hoodi,116350,26340,90010,0.7736140954018049,0
8381,8382,Indiranagar,395650,69450,326200,0.8244660684948818,-1
8382,8383,Hebbal,99900,66650,33250,0.3328328328328328,1
8383,8384,Shivajinagar,269000,75890,193110,0.7178810408921933,0
8384,8385,Jalahalli,32200,28840,3360,0.10434782608695652,1
8385,8386,Jalahalli,71200,64610,6590,0.0925561797752809,1
8386,8387,Hebbal,58650,83390,-24740,-0.4218243819266837,1
8387,8388,Kammanahalli,346300,9450,336850,0.9727115218019059,-1
8388,8389,Kalyan Nagar,202200,65620,136580,0.6754698318496538,0
8389,8390,Shivajinagar,422900,90870,332030,0.7851265074485694,0
8390,8391,Krishnarajapuram,128250,74410,53840,0.41980506822612085,1
8391,8392,Banaswadi,364000,89760,274240,0.7534065934065934,0
8392,8393,HBR Layout,83050,82910,140,0.0016857314870559904,1
8393,8394,Vasanth Nagar,58700,28220,30480,0.5192504258943782,0
8394,8395,HBR Layout,247800,15270,232530,0.9383777239709443,-1
8395,8396,Shivajinagar,254500,56610,197890,0.7775638506876228,0
8396,8397,Varthur,111050,147720,-36670,-0.330211616389014,1
8397,8398,Malleswaram,311850,38450,273400,0.8767035433702101,-1
8398,8399,HBR Layout,176750,19800,156950,0.887977369165488,-1
8399,8400,Malleswaram,160600,109330,51270,0.3192403486924035,1
8400,8401,Whitefield,296650,61660,234990,0.7921456261587729,0
8401,8402,CV Raman Nagar,228850,96550,132300,0.5781079309591436,0
8402,8403,Indiranagar,441750,55170,386580,0.8751103565365026,-1
8403,8404,Malleswaram,191050,27240,163810,0.8574195236848993,-1
8404,8405,Rajajinagar,303400,73100,230300,0.7590639419907712,0
8405,8406,Malleswaram,90600,54160,36440,0.4022075055187638,1
8406,8407,CV Raman Nagar,236000,50910,185090,0.7842796610169491,0
8407,8408,Varthur,182350,75000,107350,0.5887030435974774,0
8408,8409,Krishnarajapuram,206550,132890,73660,0.35662067296054223,1
8409,8410,Vasanth Nagar,256900,17150,239750,0.9332425068119891,-1
8410,8411,Mahadevapura,26700,48750,-22050,-0.8258426966292135,1
8411,8412,Hebbal,438100,34480,403620,0.921296507646656,-1
8412,8413,Rajajinagar,38100,75370,-37270,-0.9782152230971128,1
8413,8414,Jalahalli,245350,57640,187710,0.76507030772366,0
8414,8415,CV Raman Nagar,151100,90430,60670,0.4015221707478491,1
8415,8416,Jalahalli,121950,74690,47260,0.3875358753587536,1
8416,8417,Shivajinagar,167650,74870,92780,0.5534148523710111,0
8417,8418,Kammanahalli,203900,30160,173740,0.8520843550760177,-1
8418,8419,Rajajinagar,38200,88830,-50630,-1.325392670157068,1
8419,8420,Hebbal,342400,71970,270430,0.7898072429906542,0
8420,8421,Vasanth Nagar,263600,78420,185180,0.7025037936267071,0
8421,8422,Kalyan Nagar,292750,60150,232600,0.794534585824082,0
8422,8423,Krishnarajapuram,289950,75030,214920,0.741231246766684,0
8423,8424,Jalahalli,392900,26360,366540,0.9329091371850343,-1
8424,8425,Indiranagar,51950,80810,-28860,-0.55553416746872,1
8425,8426,CV Raman Nagar,164050,42590,121460,0.7403840292593722,0
8426,8427,Marathahalli,303500,39240,264260,0.8707084019769358,-1
8427,8428,Indiranagar,319450,82020,237430,0.7432462044138363,0
8428,8429,Rajajinagar,59950,55290,4660,0.07773144286905755,1
8429,8430,Rajajinagar,281400,137740,143660,0.5105188343994315,0
8430,8431,Kalyan Nagar,180500,94850,85650,0.4745152354570637,1
8431,8432,Jalahalli,387800,76840,310960,0.8018566271273853,-1
8432,8433,HBR Layout,411600,35520,376080,0.9137026239067055,-1
8433,8434,Mahadevapura,64700,48890,15810,0.24435857805255023,1
8434,8435,Malleswaram,304300,52610,251690,0.827111403220506,-1
8435,8436,Kammanahalli,114300,81330,32970,0.2884514435695538,1
8436,8437,CV Raman Nagar,64900,29320,35580,0.5482280431432974,0
8437,8438,Jalahalli,311800,26490,285310,0.9150416933932007,-1
8438,8439,Rajajinagar,250300,68270,182030,0.7272473032361166,0
8439,8440,Jalahalli,271450,70120,201330,0.7416835512985817,0
8440,8441,HBR Layout,367400,74050,293350,0.7984485574305934,0
8441,8442,Varthur,203700,68000,135700,0.6661757486499754,0
8442,8443,Shivajinagar,150100,54330,95770,0.6380413057961359,0
8443,8444,Horamavu,178250,65150,113100,0.6345021037868163,0
8444,8445,Kammanahalli,433550,20770,412780,0.9520931841771422,-1
8445,8446,Indiranagar,57400,28380,29020,0.5055749128919861,0
8446,8447,Hebbal,318050,97930,220120,0.6920924382958654,0
8447,8448,Malleswaram,70050,83060,-13010,-0.18572448251249107,1
8448,8449,Kammanahalli,396400,73150,323250,0.8154641775983855,-1
8449,8450,Rajajinagar,124850,30330,94520,0.7570684821786143,0
8450,8451,Whitefield,304400,82750,221650,0.7281537450722734,0
8451,8452,Jalahalli,178400,37940,140460,0.7873318385650224,0
8452,8453,Hoodi,149100,12080,137020,0.9189805499664655,-1
8453,8454,Banaswadi,245300,55760,189540,0.7726865063187933,0
8454,8455,Kalyan Nagar,447600,18370,429230,0.9589588918677391,-1
8455,8456,Hoodi,286250,65880,220370,0.7698515283842795,0
8456,8457,Varthur,255500,46250,209250,0.8189823874755382,-1
8457,8458,Indiranagar,362450,53090,309360,0.8535246240860809,-1
8458,8459,Krishnarajapuram,128850,93550,35300,0.2739619712844393,1
8459,8460,Hoodi,257600,29850,227750,0.8841226708074534,-1
8460,8461,Jalahalli,329100,44230,284870,0.865603160133698,-1
8461,8462,Shivajinagar,336150,20420,315730,0.939253309534434,-1
8462,8463,Horamavu,249950,98310,151640,0.6066813362672534,0
8463,8464,Kammanahalli,259900,84380,175520,0.6753366679492112,0
8464,8465,Jalahalli,27250,56840,-29590,-1.0858715596330275,1
8465,8466,Shivajinagar,429750,97160,332590,0.7739150668993601,0
8466,8467,CV Raman Nagar,221000,81560,139440,0.6309502262443439,0
8467,8468,Kalyan Nagar,180250,1370,178880,0.9923994452149792,-1
8468,8469,Banaswadi,215550,0,215550,1.0,-1
8469,8470,CV Raman Nagar,48550,142170,-93620,-1.9283213182286303,1
8470,8471,Krishnarajapuram,251700,97550,154150,0.6124354390147,0
8471,8472,Indiranagar,416600,40040,376560,0.9038886221795487,-1
8472,8473,Malleswaram,405850,89170,316680,0.7802882838487126,0
8473,8474,Varthur,330750,108990,221760,0.6704761904761904,0
8474,8475,Horamavu,248800,104850,143950,0.5785771704180064,0
8475,8476,Indiranagar,346700,35950,310750,0.896308047303144,-1
8476,8477,Varthur,76500,88790,-12290,-0.16065359477124183,1
8477,8478,Whitefield,42300,94470,-52170,-1.2333333333333334,1
8478,8479,Hoodi,272800,47010,225790,0.8276759530791788,-1
8479,8480,Banaswadi,383400,39880,343520,0.8959833072509129,-1
8480,8481,HBR Layout,161350,60360,100990,0.6259064146265881,0
8481,8482,Horamavu,402750,29000,373750,0.9279950341402855,-1
8482,8483,Shivajinagar,317500,32680,284820,0.8970708661417323,-1
8483,8484,Shivajinagar,43200,19410,23790,0.5506944444444445,0
8484,8485,Kalyan Nagar,436850,32370,404480,0.9259013391324253,-1
8485,8486,Marathahalli,25250,68520,-43270,-1.7136633663366336,1
8486,8487,Rajajinagar,205500,46610,158890,0.7731873479318735,0
8487,8488,CV Raman Nagar,351900,83530,268370,0.7626314293833475,0
8488,8489,Malleswaram,84900,92730,-7830,-0.09222614840989399,1
8489,8490,Whitefield,140800,33810,106990,0.7598721590909091,0
8490,8491,Vasanth Nagar,112700,44820,67880,0.602307009760426,0
8491,8492,Horamavu,183600,54440,129160,0.7034858387799564,0
8492,8493,Varthur,407200,117970,289230,0.7102897838899803,0
8493,8494,Shivajinagar,39100,61490,-22390,-0.5726342710997443,1
8494,8495,Mahadevapura,61250,81530,-20280,-0.33110204081632655,1
8495,8496,Hoodi,136350,76150,60200,0.44151081774844153,1
8496,8497,Horamavu,158650,107070,51580,0.32511818468326503,1
8497,8498,Banaswadi,258800,5910,252890,0.9771638330757342,-1
8498,8499,Indiranagar,309800,51650,258150,0.8332795351839897,-1
8499,8500,Krishnarajapuram,397650,60450,337200,0.8479818936250472,-1
8500,8501,Whitefield,140750,72330,68420,0.4861101243339254,1
8501,8502,Indiranagar,31250,18590,12660,0.40512,1
8502,8503,Malleswaram,140650,28690,111960,0.7960184856025595,0
8503,8504,Kalyan Nagar,332350,60770,271580,0.8171505942530465,-1
8504,8505,Vasanth Nagar,424800,68820,355980,0.8379943502824859,-1
8505,8506,Shivajinagar,220350,87420,132930,0.6032675289312458,0
8506,8507,Mahadevapura,231600,41990,189610,0.8186960276338515,-1
8507,8508,Hebbal,350600,54830,295770,0.8436109526525956,-1
8508,8509,Vasanth Nagar,302600,89660,212940,0.7037012557832122,0
8509,8510,Hebbal,236150,55650,180500,0.7643446961676901,0
8510,8511,Rajajinagar,236700,37950,198750,0.8396704689480355,-1
8511,8512,Hebbal,131350,43170,88180,0.6713361248572516,0
8512,8513,HBR Layout,150000,32500,117500,0.7833333333333333,0
8513,8514,Vasanth Nagar,407000,185830,221170,0.5434152334152335,0
8514,8515,CV Raman Nagar,400900,20740,380160,0.9482664005986531,-1
8515,8516,Mahadevapura,231550,44400,187150,0.8082487583675232,-1
8516,8517,Rajajinagar,185500,69480,116020,0.62544474393531,0
8517,8518,Indiranagar,286200,46610,239590,0.837141858839972,-1
8518,8519,Krishnarajapuram,70000,64570,5430,0.07757142857142857,1
8519,8520,Vasanth Nagar,47000,77440,-30440,-0.6476595744680851,1
8520,8521,Shivajinagar,405450,57580,347870,0.8579849549882846,-1
8521,8522,Malleswaram,344850,41730,303120,0.8789908655937364,-1
8522,8523,Varthur,39850,57770,-17920,-0.44968632371392725,1
8523,8524,Banaswadi,107600,65250,42350,0.39358736059479554,1
8524,8525,Indiranagar,96600,22710,73890,0.7649068322981366,0
8525,8526,HBR Layout,405150,112780,292370,0.7216339627298531,0
8526,8527,Jalahalli,31100,15560,15540,0.4996784565916399,1
8527,8528,Horamavu,223100,137920,85180,0.3818018825638727,1
8528,8529,Jalahalli,170800,48410,122390,0.7165690866510539,0
8529,8530,Jalahalli,302200,22170,280030,0.9266379880873593,-1
8530,8531,Marathahalli,71100,30380,40720,0.5727144866385373,0
8531,8532,Varthur,99850,37910,61940,0.6203304957436154,0
8532,8533,Whitefield,429850,53660,376190,0.8751657554961033,-1
8533,8534,Rajajinagar,367650,75360,292290,0.7950224398204815,0
8534,8535,Horamavu,184200,90770,93430,0.5072204125950054,0
8535,8536,Jalahalli,431500,19950,411550,0.953765932792584,-1
8536,8537,Mahadevapura,150350,110650,39700,0.26405054871965417,1
8537,8538,Whitefield,327750,42690,285060,0.8697482837528604,-1
8538,8539,Malleswaram,32200,68970,-36770,-1.1419254658385094,1
8539,8540,Hoodi,307250,112480,194770,0.633913751017087,0
8540,8541,Vasanth Nagar,278050,19060,258990,0.9314511778457112,-1
8541,8542,Mahadevapura,379800,134620,245180,0.645550289626119,0
8542,8543,Vasanth Nagar,388300,64120,324180,0.8348699459181046,-1
8543,8544,Banaswadi,257150,101740,155410,0.604355434571262,0
8544,8545,Rajajinagar,377650,104790,272860,0.7225208526413346,0
8545,8546,Marathahalli,27250,101750,-74500,-2.7339449541284404,1
8546,8547,Indiranagar,104550,55630,48920,0.4679100908656145,1
8547,8548,Whitefield,336850,50730,286120,0.8493988422146356,-1
8548,8549,Hoodi,331950,10780,321170,0.9675252297032686,-1
8549,8550,Hoodi,151050,20410,130640,0.864879179079775,-1
8550,8551,Jalahalli,114950,24050,90900,0.7907785993910396,0
8551,8552,Rajajinagar,314350,46880,267470,0.8508668681406076,-1
8552,8553,Rajajinagar,73550,54610,18940,0.2575118966689327,1
8553,8554,CV Raman Nagar,408650,65370,343280,0.8400342591459684,-1
8554,8555,Horamavu,317000,128360,188640,0.5950788643533123,0
8555,8556,Marathahalli,263700,100470,163230,0.6189988623435723,0
8556,8557,Rajajinagar,397300,51190,346110,0.8711552982632771,-1
8557,8558,Indiranagar,243900,61280,182620,0.7487494874948749,0
8558,8559,Malleswaram,80650,111660,-31010,-0.3845009299442034,1
8559,8560,Malleswaram,35150,45020,-9870,-0.28079658605974395,1
8560,8561,Kalyan Nagar,222300,79140,143160,0.6439946018893388,0
8561,8562,Mahadevapura,200100,41680,158420,0.7917041479260369,0
8562,8563,Varthur,61850,20620,41230,0.6666127728375101,0
8563,8564,Marathahalli,69700,89390,-19690,-0.2824964131994261,1
8564,8565,Rajajinagar,370550,145260,225290,0.6079881257590068,0
8565,8566,Indiranagar,439100,22510,416590,0.9487360510134366,-1
8566,8567,HBR Layout,83850,88980,-5130,-0.06118067978533095,1
8567,8568,Krishnarajapuram,180500,84200,96300,0.5335180055401662,0
8568,8569,Rajajinagar,322200,58430,263770,0.8186530105524519,-1
8569,8570,Marathahalli,204000,64080,139920,0.6858823529411765,0
8570,8571,Jalahalli,227400,27110,200290,0.880782761653474,-1
8571,8572,Horamavu,197850,38640,159210,0.8047005307050796,-1
8572,8573,Mahadevapura,271900,69010,202890,0.7461934534755424,0
8573,8574,Shivajinagar,392250,109850,282400,0.7199490121096239,0
8574,8575,CV Raman Nagar,323950,41610,282340,0.8715542521994135,-1
8575,8576,Whitefield,326150,48710,277440,0.8506515407021309,-1
8576,8577,Vasanth Nagar,283300,87360,195940,0.691634309918814,0
8577,8578,Hoodi,27550,23810,3740,0.13575317604355716,1
8578,8579,Vasanth Nagar,419050,65770,353280,0.8430497553991171,-1
8579,8580,HBR Layout,34450,103480,-69030,-2.0037735849056606,1
8580,8581,Shivajinagar,114000,48490,65510,0.5746491228070175,0
8581,8582,Indiranagar,140900,74070,66830,0.4743080198722498,1
8582,8583,Whitefield,319150,45400,273750,0.8577471408428639,-1
8583,8584,Whitefield,104400,75320,29080,0.278544061302682,1
8584,8585,Jalahalli,311000,131380,179620,0.577556270096463,0
8585,8586,Vasanth Nagar,80700,42230,38470,0.47670384138785626,1
8586,8587,HBR Layout,34750,57420,-22670,-0.6523741007194245,1
8587,8588,Vasanth Nagar,274600,51230,223370,0.8134377276037873,-1
8588,8589,CV Raman Nagar,132850,100070,32780,0.24674444862627024,1
8589,8590,Horamavu,270300,38570,231730,0.857306696263411,-1
8590,8591,Indiranagar,64450,64500,-50,-0.0007757951900698216,1
8591,8592,Shivajinagar,426650,45520,381130,0.8933083323567327,-1
8592,8593,Kammanahalli,282200,71030,211170,0.7482990786676116,0
8593,8594,Whitefield,86100,72520,13580,0.15772357723577235,1
8594,8595,Banaswadi,446100,104080,342020,0.7666890831652096,0
8595,8596,Marathahalli,241900,24490,217410,0.8987598181066556,-1
8596,8597,Marathahalli,376350,71560,304790,0.8098578450910057,-1
8597,8598,Shivajinagar,218900,70880,148020,0.6761991777067154,0
8598,8599,Shivajinagar,98800,28640,70160,0.7101214574898785,0
8599,8600,CV Raman Nagar,157100,41950,115150,0.7329726288987906,0
8600,8601,Kammanahalli,404550,32900,371650,0.9186750710666173,-1
8601,8602,Jalahalli,428450,146600,281850,0.65783638697631,0
8602,8603,Shivajinagar,46400,18280,28120,0.6060344827586207,0
8603,8604,Shivajinagar,344900,28270,316630,0.9180342128153088,-1
8604,8605,Hoodi,213900,100910,112990,0.5282374941561477,0
8605,8606,Hoodi,165300,79710,85590,0.5177858439201452,0
8606,8607,Mahadevapura,275300,115660,159640,0.5798764983654195,0
8607,8608,Varthur,232700,75830,156870,0.6741297808336915,0
8608,8609,Marathahalli,80450,38370,42080,0.5230577998756992,0
8609,8610,Kalyan Nagar,394000,30300,363700,0.9230964467005076,-1
8610,8611,Marathahalli,425000,59820,365180,0.8592470588235294,-1
8611,8612,Mahadevapura,405750,69270,336480,0.829279112754159,-1
8612,8613,Hebbal,47600,34270,13330,0.2800420168067227,1
8613,8614,Horamavu,323100,66860,256240,0.7930671618693903,0
8614,8615,Vasanth Nagar,84200,120720,-36520,-0.433729216152019,1
8615,8616,Malleswaram,434500,53210,381290,0.8775373993095512,-1
8616,8617,Hebbal,294950,44090,250860,0.850517036785896,-1
8617,8618,Kammanahalli,262000,74950,187050,0.7139312977099237,0
8618,8619,Marathahalli,309450,81360,228090,0.7370819195346583,0
8619,8620,Mahadevapura,440950,24930,416020,0.9434629776618664,-1
8620,8621,Krishnarajapuram,375550,50990,324560,0.8642258021568366,-1
8621,8622,Kammanahalli,102950,15410,87540,0.8503156872268092,-1
8622,8623,Krishnarajapuram,197450,36110,161340,0.8171182577867815,-1
8623,8624,Hebbal,255350,64640,190710,0.7468572547483846,0
8624,8625,Banaswadi,266750,53270,213480,0.8002999062792877,-1
8625,8626,Vasanth Nagar,170000,14150,155850,0.9167647058823529,-1
8626,8627,Hebbal,214400,70960,143440,0.6690298507462686,0
8627,8628,CV Raman Nagar,349700,88720,260980,0.7462968258507292,0
8628,8629,Mahadevapura,386350,52710,333640,0.8635693024459686,-1
8629,8630,Krishnarajapuram,390450,31050,359400,0.9204763734152901,-1
8630,8631,Varthur,109800,102640,7160,0.06520947176684881,1
8631,8632,HBR Layout,206550,65160,141390,0.6845315904139434,0
8632,8633,Varthur,447150,24240,422910,0.945790003354579,-1
8633,8634,Vasanth Nagar,68050,79100,-11050,-0.1623806024981631,1
8634,8635,Kalyan Nagar,387750,13850,373900,0.9642811089619601,-1
8635,8636,Whitefield,361350,120850,240500,0.665559706655597,0
8636,8637,CV Raman Nagar,321150,53800,267350,0.8324770356531216,-1
8637,8638,Kalyan Nagar,256650,125620,131030,0.5105396454315215,0
8638,8639,Marathahalli,209300,68870,140430,0.6709507883420927,0
8639,8640,Shivajinagar,433350,62010,371340,0.8569055036344756,-1
8640,8641,Whitefield,411500,74000,337500,0.8201701093560145,-1
8641,8642,Rajajinagar,144400,64160,80240,0.5556786703601108,0
8642,8643,Horamavu,321250,36590,284660,0.8861011673151751,-1
8643,8644,Indiranagar,276600,62860,213740,0.7727404193781634,0
8644,8645,Kalyan Nagar,332650,54510,278140,0.8361340748534496,-1
8645,8646,Indiranagar,430700,70140,360560,0.8371488274901323,-1
8646,8647,Rajajinagar,295350,0,295350,1.0,-1
8647,8648,Rajajinagar,313250,33060,280190,0.8944612928970471,-1
8648,8649,Varthur,117400,62370,55030,0.46873935264054517,1
8649,8650,Krishnarajapuram,416550,53860,362690,0.870699795942864,-1
8650,8651,Banaswadi,184450,90540,93910,0.5091352670100299,0
8651,8652,Indiranagar,304800,84760,220040,0.7219160104986877,0
8652,8653,Mahadevapura,191850,42920,148930,0.7762835548605681,0
8653,8654,Kammanahalli,419450,6370,413080,0.9848134461795208,-1
8654,8655,Indiranagar,405500,40570,364930,0.8999506781750924,-1
8655,8656,CV Raman Nagar,348250,47380,300870,0.8639483129935391,-1
8656,8657,Indiranagar,391450,133120,258330,0.6599310256737769,0
8657,8658,Hebbal,428600,52290,376310,0.8779981334577694,-1
8658,8659,Malleswaram,87150,41120,46030,0.5281698221457257,0
8659,8660,Hoodi,197250,25850,171400,0.8689480354879594,-1
8660,8661,Malleswaram,412550,99080,313470,0.7598351714943643,0
8661,8662,Varthur,405400,13690,391710,0.9662308830784411,-1
8662,8663,Jalahalli,334800,93110,241690,0.7218936678614098,0
8663,8664,Indiranagar,431200,64570,366630,0.8502551020408163,-1
8664,8665,Hoodi,177850,74650,103200,0.5802642676412707,0
8665,8666,Shivajinagar,289200,76450,212750,0.7356500691562933,0
8666,8667,Malleswaram,208400,68090,140310,0.6732725527831094,0
8667,8668,Whitefield,180050,101250,78800,0.4376562066092752,1
8668,8669,Jalahalli,420200,36030,384170,0.9142551166111376,-1
8669,8670,Kalyan Nagar,309000,92440,216560,0.70084142394822,0
8670,8671,Kammanahalli,234750,25970,208780,0.8893716719914803,-1
8671,8672,Kammanahalli,135250,107970,27280,0.20170055452865066,1
8672,8673,Varthur,296650,55630,241020,0.8124726108208327,-1
8673,8674,Jalahalli,156050,71860,84190,0.5395065684075617,0
8674,8675,Kalyan Nagar,77850,66590,11260,0.14463712267180476,1
8675,8676,Hebbal,56150,16020,40130,0.714692787177204,0
8676,8677,Marathahalli,249650,106940,142710,0.5716402964149809,0
8677,8678,Mahadevapura,148050,44230,103820,0.7012495778453225,0
8678,8679,Marathahalli,401650,97300,304350,0.757749284202664,0
8679,8680,Jalahalli,300750,41940,258810,0.8605486284289277,-1
8680,8681,Hoodi,288950,97880,191070,0.6612562727115417,0
8681,8682,CV Raman Nagar,30450,21610,8840,0.290311986863711,1
8682,8683,HBR Layout,205800,46170,159630,0.7756559766763849,0
8683,8684,Kammanahalli,123900,65540,58360,0.47102502017756254,1
8684,8685,HBR Layout,356000,47620,308380,0.8662359550561798,-1
8685,8686,Vasanth Nagar,76350,58140,18210,0.23850687622789785,1
8686,8687,Shivajinagar,84000,32410,51590,0.6141666666666666,0
8687,8688,Hoodi,320800,55920,264880,0.8256857855361596,-1
8688,8689,Krishnarajapuram,187100,11190,175910,0.9401924104756815,-1
8689,8690,Hebbal,319350,79060,240290,0.7524346328479724,0
8690,8691,Rajajinagar,210750,63160,147590,0.7003084223013049,0
8691,8692,Hoodi,136500,72150,64350,0.4714285714285714,1
8692,8693,Hebbal,407450,71330,336120,0.8249355749171677,-1
8693,8694,Vasanth Nagar,177550,80930,96620,0.544184736693889,0
8694,8695,Banaswadi,222350,40560,181790,0.8175848886890038,-1
8695,8696,Banaswadi,389150,36300,352850,0.9067197738661185,-1
8696,8697,Shivajinagar,166050,120240,45810,0.27588075880758806,1
8697,8698,Kalyan Nagar,82750,75180,7570,0.09148036253776436,1
8698,8699,Mahadevapura,440850,31320,409530,0.9289554270159919,-1
8699,8700,Hebbal,189800,37200,152600,0.804004214963119,-1
8700,8701,Krishnarajapuram,345500,112550,232950,0.6742402315484805,0
8701,8702,Kalyan Nagar,144250,128480,15770,0.10932409012131716,1
8702,8703,Marathahalli,140300,25020,115280,0.8216678545972915,-1
8703,8704,Varthur,391900,53830,338070,0.8626435315131411,-1
8704,8705,Jalahalli,127100,32640,94460,0.7431943351691581,0
8705,8706,Mahadevapura,377800,74560,303240,0.8026469031233456,-1
8706,8707,Mahadevapura,416500,51520,364980,0.8763025210084033,-1
8707,8708,Hoodi,326550,4310,322240,0.9868014086663605,-1
8708,8709,Banaswadi,307400,19670,287730,0.9360117111255692,-1
8709,8710,Kalyan Nagar,432900,76080,356820,0.8242550242550243,-1
8710,8711,Malleswaram,154100,75940,78160,0.5072031148604802,0
8711,8712,Horamavu,273850,47860,225990,0.8252327916742742,-1
8712,8713,Horamavu,192900,35080,157820,0.8181441161223432,-1
8713,8714,Hebbal,166750,21520,145230,0.870944527736132,-1
8714,8715,Vasanth Nagar,239350,114260,125090,0.5226237727177773,0
8715,8716,Whitefield,104950,188710,-83760,-0.7980943306336351,1
8716,8717,CV Raman Nagar,164700,8910,155790,0.9459016393442623,-1
8717,8718,Rajajinagar,55150,71290,-16140,-0.2926563916591115,1
8718,8719,Malleswaram,447450,108540,338910,0.757425410660409,0
8719,8720,Jalahalli,176850,22700,154150,0.8716426350014136,-1
8720,8721,Mahadevapura,245650,160960,84690,0.3447588031752493,1
8721,8722,Mahadevapura,116550,62870,53680,0.4605748605748606,1
8722,8723,Krishnarajapuram,176250,60910,115340,0.6544113475177304,0
8723,8724,Banaswadi,279750,159240,120510,0.4307774798927614,1
8724,8725,Jalahalli,169650,50560,119090,0.7019746536987916,0
8725,8726,Horamavu,350050,63820,286230,0.8176831881159834,-1
8726,8727,Indiranagar,362250,10020,352230,0.9723395445134576,-1
8727,8728,Vasanth Nagar,221500,112310,109190,0.49295711060948083,1
8728,8729,Jalahalli,217150,40670,176480,0.8127101082201243,-1
8729,8730,Jalahalli,429450,40580,388870,0.905507043893352,-1
8730,8731,Jalahalli,223250,40850,182400,0.8170212765957446,-1
8731,8732,Hoodi,442450,50630,391820,0.8855689908464234,-1
8732,8733,Vasanth Nagar,81150,59620,21530,0.26531115218730744,1
8733,8734,Varthur,417100,56330,360770,0.8649484536082475,-1
8734,8735,Vasanth Nagar,224300,51350,172950,0.7710655372269282,0
8735,8736,Mahadevapura,318200,49460,268740,0.8445631678189818,-1
8736,8737,Krishnarajapuram,37250,121600,-84350,-2.264429530201342,1
8737,8738,Shivajinagar,380600,58910,321690,0.8452180767209669,-1
8738,8739,Kammanahalli,307600,38840,268760,0.8737321196358908,-1
8739,8740,Kammanahalli,199550,46120,153430,0.7688799799548985,0
8740,8741,Kammanahalli,371000,108370,262630,0.7078975741239892,0
8741,8742,Shivajinagar,44700,77880,-33180,-0.7422818791946308,1
8742,8743,Indiranagar,343000,79900,263100,0.7670553935860058,0
8743,8744,Hoodi,149550,27830,121720,0.8139083918421932,-1
8744,8745,Horamavu,260800,73820,186980,0.7169478527607362,0
8745,8746,Shivajinagar,77800,115700,-37900,-0.487146529562982,1
8746,8747,Marathahalli,423900,37240,386660,0.9121490917669262,-1
8747,8748,Vasanth Nagar,100200,16620,83580,0.834131736526946,-1
8748,8749,Whitefield,249050,62310,186740,0.7498092752459345,0
8749,8750,HBR Layout,142250,68290,73960,0.5199297012302285,0
8750,8751,Shivajinagar,96400,78620,17780,0.18443983402489628,1
8751,8752,Kalyan Nagar,409450,89510,319940,0.7813896690682623,0
8752,8753,Kammanahalli,96900,67660,29240,0.3017543859649123,1
8753,8754,Varthur,397050,31530,365520,0.9205893464299206,-1
8754,8755,Hoodi,129800,124670,5130,0.039522342064714944,1
8755,8756,Shivajinagar,187500,25210,162290,0.8655466666666667,-1
8756,8757,Shivajinagar,80550,35130,45420,0.5638733705772812,0
8757,8758,HBR Layout,209250,95860,113390,0.5418876941457587,0
8758,8759,Whitefield,207700,27860,179840,0.8658642272508426,-1
8759,8760,Jalahalli,86650,54120,32530,0.37541834968263127,1
8760,8761,Marathahalli,75000,23890,51110,0.6814666666666667,0
8761,8762,Indiranagar,364550,15360,349190,0.9578658620216706,-1
8762,8763,Kammanahalli,153750,113360,40390,0.2626991869918699,1
8763,8764,Jalahalli,366550,37180,329370,0.8985677260946665,-1
8764,8765,Kammanahalli,257000,59270,197730,0.7693774319066148,0
8765,8766,HBR Layout,340300,18600,321700,0.9453423449897149,-1
8766,8767,Shivajinagar,249250,58320,190930,0.7660180541624875,0
8767,8768,Whitefield,59050,131060,-72010,-1.2194750211685013,1
8768,8769,Hebbal,417550,60790,356760,0.8544126451921925,-1
8769,8770,Marathahalli,403300,102350,300950,0.7462186957599801,0
8770,8771,Rajajinagar,371150,119400,251750,0.6782971844267817,0
8771,8772,Vasanth Nagar,218000,57980,160020,0.7340366972477064,0
8772,8773,Shivajinagar,90900,64450,26450,0.290979097909791,1
8773,8774,Horamavu,79000,79870,-870,-0.011012658227848101,1
8774,8775,Kalyan Nagar,331050,43300,287750,0.8692040477269295,-1
8775,8776,Marathahalli,111200,68920,42280,0.3802158273381295,1
8776,8777,Indiranagar,99400,66740,32660,0.32857142857142857,1
8777,8778,Horamavu,103600,34240,69360,0.6694980694980694,0
8778,8779,Krishnarajapuram,84900,38340,46560,0.5484098939929328,0
8779,8780,Hebbal,74100,231380,-157280,-2.122537112010796,1
8780,8781,Varthur,175300,49760,125540,0.7161437535653166,0
8781,8782,CV Raman Nagar,244800,37050,207750,0.8486519607843137,-1
8782,8783,Hebbal,137900,40020,97880,0.7097897026831037,0
8783,8784,Banaswadi,71850,72870,-1020,-0.014196242171189978,1
8784,8785,Vasanth Nagar,218750,22400,196350,0.8976,-1
8785,8786,Indiranagar,72150,111130,-38980,-0.5402633402633402,1
8786,8787,Shivajinagar,141200,53740,87460,0.6194050991501416,0
8787,8788,Kammanahalli,151850,52890,98960,0.6516957523872242,0
8788,8789,Varthur,345000,165480,179520,0.5203478260869565,0
8789,8790,Malleswaram,212900,43810,169090,0.7942226397369657,0
8790,8791,Rajajinagar,51150,106990,-55840,-1.0916911045943305,1
8791,8792,Mahadevapura,162650,51310,111340,0.6845373501383338,0
8792,8793,Whitefield,198850,88070,110780,0.5571033442293186,0
8793,8794,Rajajinagar,268250,43320,224930,0.8385088536812675,-1
8794,8795,Mahadevapura,230050,78080,151970,0.6605955227124538,0
8795,8796,Jalahalli,70900,116550,-45650,-0.6438645980253879,1
8796,8797,Banaswadi,129150,106390,22760,0.17622919086333722,1
8797,8798,Hebbal,216550,49530,167020,0.7712768413761256,0
8798,8799,Marathahalli,272300,42770,229530,0.8429305912596401,-1
8799,8800,Krishnarajapuram,399700,75510,324190,0.8110833124843633,-1
8800,8801,Kammanahalli,443400,43860,399540,0.9010825439783491,-1
8801,8802,Kalyan Nagar,181950,39950,142000,0.7804341852157186,0
8802,8803,Krishnarajapuram,265450,98700,166750,0.6281785647014504,0
8803,8804,Rajajinagar,320250,53230,267020,0.8337861046057767,-1
8804,8805,Kammanahalli,95400,46820,48580,0.5092243186582809,0
8805,8806,Indiranagar,67550,85590,-18040,-0.2670614359733531,1
8806,8807,Banaswadi,438350,39700,398650,0.9094331014029885,-1
8807,8808,Whitefield,212700,8320,204380,0.9608838740009403,-1
8808,8809,HBR Layout,187150,69660,117490,0.6277851990382046,0
8809,8810,Hoodi,215100,61520,153580,0.7139934913993491,0
8810,8811,Whitefield,30150,53520,-23370,-0.7751243781094528,1
8811,8812,Indiranagar,379950,60530,319420,0.8406895644163705,-1
8812,8813,CV Raman Nagar,361200,120310,240890,0.6669158361018827,0
8813,8814,Whitefield,51450,125880,-74430,-1.4466472303206996,1
8814,8815,Vasanth Nagar,389100,28820,360280,0.9259316371112825,-1
8815,8816,Shivajinagar,303550,42650,260900,0.8594959644210179,-1
8816,8817,Banaswadi,263200,79160,184040,0.6992401215805472,0
8817,8818,Marathahalli,218600,110520,108080,0.49441903019213174,1
8818,8819,Kammanahalli,278600,112530,166070,0.5960875807609476,0
8819,8820,Mahadevapura,28100,24470,3630,0.12918149466192172,1
8820,8821,Krishnarajapuram,355100,99470,255630,0.7198817234581808,0
8821,8822,Vasanth Nagar,139100,64060,75040,0.5394680086268872,0
8822,8823,Banaswadi,196750,48680,148070,0.752579415501906,0
8823,8824,Banaswadi,177900,99390,78510,0.4413153456998314,1
8824,8825,Shivajinagar,86900,72530,14370,0.16536248561565017,1
8825,8826,Kammanahalli,182450,61280,121170,0.6641271581255138,0
8826,8827,CV Raman Nagar,279650,36650,243000,0.868943322009655,-1
8827,8828,CV Raman Nagar,406950,56490,350460,0.8611868779948396,-1
8828,8829,Mahadevapura,259700,97460,162240,0.624720831728918,0
8829,8830,Hebbal,396750,43540,353210,0.8902583490863264,-1
8830,8831,Rajajinagar,84000,100540,-16540,-0.19690476190476192,1
8831,8832,HBR Layout,185500,38140,147360,0.7943935309973046,0
8832,8833,Hoodi,151150,127090,24060,0.15917962289116772,1
8833,8834,Indiranagar,105150,64820,40330,0.383547313361864,1
8834,8835,Jalahalli,278700,87680,191020,0.6853964836742017,0
8835,8836,Shivajinagar,194000,90230,103770,0.5348969072164949,0
8836,8837,Marathahalli,124400,55610,68790,0.5529742765273312,0
8837,8838,Hoodi,150100,70910,79190,0.5275816122584943,0
8838,8839,Krishnarajapuram,247700,52920,194780,0.7863544610415826,0
8839,8840,Malleswaram,436550,78240,358310,0.820776543351277,-1
8840,8841,Varthur,292100,124600,167500,0.5734337555631633,0
8841,8842,Varthur,220050,50690,169360,0.7696432628947967,0
8842,8843,Malleswaram,438850,44460,394390,0.8986897573202689,-1
8843,8844,Hebbal,63150,63100,50,0.000791765637371338,1
8844,8845,Marathahalli,157100,38170,118930,0.7570337364735837,0
8845,8846,Malleswaram,96450,57870,38580,0.4,1
8846,8847,Banaswadi,98950,35900,63050,0.6371905002526529,0
8847,8848,Horamavu,312650,89860,222790,0.7125859587398049,0
8848,8849,CV Raman Nagar,137050,61940,75110,0.5480481576067129,0
8849,8850,Hoodi,186250,51780,134470,0.7219865771812081,0
8850,8851,Mahadevapura,351450,106960,244490,0.6956608336890027,0
8851,8852,Shivajinagar,298150,0,298150,1.0,-1
8852,8853,Vasanth Nagar,279350,34540,244810,0.8763558260247002,-1
8853,8854,Krishnarajapuram,184900,48740,136160,0.7363980530016225,0
8854,8855,Whitefield,396400,20250,376150,0.9489152371342079,-1
8855,8856,CV Raman Nagar,323350,50550,272800,0.8436678521725685,-1
8856,8857,Hebbal,62850,56120,6730,0.10708035003977724,1
8857,8858,Rajajinagar,167500,59630,107870,0.644,0
8858,8859,Malleswaram,66850,51990,14860,0.22228870605833956,1
8859,8860,HBR Layout,359900,60650,299250,0.8314809669352597,-1
8860,8861,Vasanth Nagar,173150,30610,142540,0.8232168639907594,-1
8861,8862,Rajajinagar,394550,85510,309040,0.7832720821188696,0
8862,8863,Shivajinagar,428100,31140,396960,0.927259985984583,-1
8863,8864,Indiranagar,65950,185070,-119120,-1.8062168309325246,1
8864,8865,Hebbal,396550,70790,325760,0.8214853108056992,-1
8865,8866,Varthur,224250,3990,220260,0.9822073578595317,-1
8866,8867,Vasanth Nagar,226450,33860,192590,0.8504747184809008,-1
8867,8868,Kammanahalli,95050,29970,65080,0.6846922672277749,0
8868,8869,HBR Layout,59350,31250,28100,0.4734625105307498,1
8869,8870,Kalyan Nagar,126550,13620,112930,0.8923745555116555,-1
8870,8871,Kammanahalli,105850,16110,89740,0.8478034955125178,-1
8871,8872,Rajajinagar,304000,30040,273960,0.9011842105263158,-1
8872,8873,Shivajinagar,42150,55080,-12930,-0.30676156583629893,1
8873,8874,Shivajinagar,398550,43290,355260,0.891381257056831,-1
8874,8875,Vasanth Nagar,406800,43500,363300,0.8930678466076696,-1
8875,8876,Mahadevapura,189200,49330,139870,0.7392706131078224,0
8876,8877,CV Raman Nagar,152100,26690,125410,0.8245233399079553,-1
8877,8878,Malleswaram,45250,107780,-62530,-1.381878453038674,1
8878,8879,CV Raman Nagar,99500,133630,-34130,-0.3430150753768844,1
8879,8880,Hoodi,387950,55040,332910,0.8581260471710271,-1
8880,8881,Krishnarajapuram,48350,79620,-31270,-0.6467425025853154,1
8881,8882,Shivajinagar,66100,67720,-1620,-0.024508320726172466,1
8882,8883,Jalahalli,55400,49670,5730,0.10342960288808664,1
8883,8884,Vasanth Nagar,261550,52650,208900,0.798700057350411,0
8884,8885,Whitefield,226400,53350,173050,0.7643551236749117,0
8885,8886,Rajajinagar,238150,69880,168270,0.7065714885576317,0
8886,8887,Rajajinagar,228350,38010,190340,0.8335449967155683,-1
8887,8888,Malleswaram,182250,8560,173690,0.9530315500685871,-1
8888,8889,Kalyan Nagar,156450,35390,121060,0.7737935442633429,0
8889,8890,Indiranagar,106100,16060,90040,0.8486333647502357,-1
8890,8891,Shivajinagar,166450,72400,94050,0.5650345449083809,0
8891,8892,Jalahalli,380600,16370,364230,0.956988964792433,-1
8892,8893,Indiranagar,64000,60260,3740,0.0584375,1
8893,8894,Krishnarajapuram,80400,74610,5790,0.07201492537313432,1
8894,8895,Vasanth Nagar,186700,71760,114940,0.6156400642742368,0
8895,8896,Marathahalli,297050,23580,273470,0.9206194243393369,-1
8896,8897,Hoodi,294400,78690,215710,0.7327105978260869,0
8897,8898,Krishnarajapuram,433750,84840,348910,0.8044034582132565,-1
8898,8899,Jalahalli,220950,66560,154390,0.698755374519122,0
8899,8900,CV Raman Nagar,312300,43580,268720,0.8604546910022415,-1
8900,8901,Krishnarajapuram,50100,57620,-7520,-0.1500998003992016,1
8901,8902,Indiranagar,42900,41200,1700,0.039627039627039624,1
8902,8903,Hebbal,110200,39310,70890,0.6432849364791289,0
8903,8904,Varthur,30850,51750,-20900,-0.6774716369529984,1
8904,8905,Kammanahalli,112500,76360,36140,0.32124444444444444,1
8905,8906,Krishnarajapuram,404250,102590,301660,0.7462213976499691,0
8906,8907,Horamavu,42800,29780,13020,0.3042056074766355,1
8907,8908,Rajajinagar,382350,128230,254120,0.6646266509742382,0
8908,8909,Kammanahalli,221050,54980,166070,0.7512779914046596,0
8909,8910,Indiranagar,137400,25690,111710,0.8130276564774381,-1
8910,8911,Jalahalli,374400,59100,315300,0.8421474358974359,-1
8911,8912,Kalyan Nagar,437700,53840,383860,0.8769933744573909,-1
8912,8913,Kalyan Nagar,324550,16600,307950,0.9488522569711909,-1
8913,8914,Whitefield,154600,72910,81690,0.5283958602846054,0
8914,8915,Banaswadi,413950,61850,352100,0.8505858195434232,-1
8915,8916,Malleswaram,192700,55490,137210,0.7120394395433316,0
8916,8917,CV Raman Nagar,130250,50700,79550,0.6107485604606526,0
8917,8918,Whitefield,265400,34770,230630,0.8689902034664657,-1
8918,8919,Banaswadi,128150,52490,75660,0.5904018728053063,0
8919,8920,Malleswaram,299600,97250,202350,0.6754005340453939,0
8920,8921,Whitefield,408250,81170,327080,0.8011757501530925,-1
8921,8922,Mahadevapura,36600,40100,-3500,-0.09562841530054644,1
8922,8923,Varthur,123200,52260,70940,0.5758116883116883,0
8923,8924,Horamavu,295250,87960,207290,0.7020829805249789,0
8924,8925,Hoodi,390350,90060,300290,0.769283975919047,0
8925,8926,Vasanth Nagar,434900,65310,369590,0.8498275465624281,-1
8926,8927,Mahadevapura,400350,43850,356500,0.8904708380167353,-1
8927,8928,Whitefield,363350,101750,261600,0.7199669739920187,0
8928,8929,Indiranagar,400450,55030,345420,0.8625795979523037,-1
8929,8930,Hebbal,45500,32030,13470,0.29604395604395606,1
8930,8931,Jalahalli,293600,58930,234670,0.7992847411444142,0
8931,8932,Varthur,115000,68550,46450,0.40391304347826085,1
8932,8933,Indiranagar,396600,121020,275580,0.694856278366112,0
8933,8934,Indiranagar,139150,49560,89590,0.6438375853395616,0
8934,8935,Vasanth Nagar,264200,42180,222020,0.8403482210446631,-1
8935,8936,Horamavu,334350,0,334350,1.0,-1
8936,8937,Vasanth Nagar,79350,30580,48770,0.6146187775677379,0
8937,8938,Horamavu,344550,59800,284750,0.8264402844289653,-1
8938,8939,Marathahalli,167000,50280,116720,0.6989221556886227,0
8939,8940,Shivajinagar,183200,31540,151660,0.8278384279475982,-1
8940,8941,HBR Layout,123300,50000,73300,0.5944849959448499,0
8941,8942,Hebbal,257100,77930,179170,0.6968883702839362,0
8942,8943,Krishnarajapuram,84650,61440,23210,0.274187832250443,1
8943,8944,HBR Layout,114800,51620,63180,0.5503484320557491,0
8944,8945,CV Raman Nagar,182850,67790,115060,0.6292589554279464,0
8945,8946,Indiranagar,228000,51540,176460,0.7739473684210526,0
8946,8947,Vasanth Nagar,441200,67680,373520,0.8466001813236628,-1
8947,8948,Hebbal,160800,40790,120010,0.7463308457711443,0
8948,8949,Whitefield,315850,32970,282880,0.8956150071236346,-1
8949,8950,Krishnarajapuram,319700,77970,241730,0.7561151079136691,0
8950,8951,Kalyan Nagar,228350,71580,156770,0.686533829647471,0
8951,8952,Hebbal,76200,119680,-43480,-0.5706036745406824,1
8952,8953,Varthur,356050,92330,263720,0.7406824884145485,0
8953,8954,Hebbal,406000,54860,351140,0.8648768472906404,-1
8954,8955,Hoodi,302700,84560,218140,0.7206475057813017,0
8955,8956,Malleswaram,384100,68290,315810,0.8222077583962509,-1
8956,8957,Kammanahalli,340700,104250,236450,0.694012327560904,0
8957,8958,Rajajinagar,89100,49950,39150,0.4393939393939394,1
8958,8959,Vasanth Nagar,137100,92720,44380,0.3237053245805981,1
8959,8960,Kalyan Nagar,204750,67140,137610,0.6720879120879121,0
8960,8961,Vasanth Nagar,53700,38880,14820,0.2759776536312849,1
8961,8962,Hoodi,427750,45340,382410,0.8940035067212156,-1
8962,8963,Krishnarajapuram,132800,37240,95560,0.719578313253012,0
8963,8964,CV Raman Nagar,220350,50400,169950,0.7712729748127978,0
8964,8965,Indiranagar,131350,89660,41690,0.31739626950894556,1
8965,8966,Whitefield,261500,116830,144670,0.5532313575525812,0
8966,8967,Whitefield,51300,38920,12380,0.24132553606237817,1
8967,8968,Kalyan Nagar,40250,158260,-118010,-2.931925465838509,1
8968,8969,Mahadevapura,420400,130690,289710,0.6891294005708849,0
8969,8970,Indiranagar,366600,124200,242400,0.6612111292962357,0
8970,8971,Kalyan Nagar,253350,82670,170680,0.6736925202289323,0
8971,8972,Banaswadi,190700,59900,130800,0.6858940744625066,0
8972,8973,Mahadevapura,407150,77690,329460,0.8091858037578288,-1
8973,8974,HBR Layout,138200,57610,80590,0.5831403762662808,0
8974,8975,Varthur,207400,73850,133550,0.6439247830279653,0
8975,8976,Whitefield,140300,11740,128560,0.9163221667854597,-1
8976,8977,Jalahalli,434400,56310,378090,0.8703729281767956,-1
8977,8978,Varthur,177050,113940,63110,0.3564529793843547,1
8978,8979,Malleswaram,259300,15520,243780,0.9401465483995373,-1
8979,8980,Mahadevapura,57550,89920,-32370,-0.5624674196350999,1
8980,8981,Hoodi,102950,19780,83170,0.8078678970373968,-1
8981,8982,Mahadevapura,84650,41840,42810,0.5057294743059657,0
8982,8983,Horamavu,287150,128210,158940,0.5535086191885774,0
8983,8984,Marathahalli,419650,56410,363240,0.8655784582390087,-1
8984,8985,CV Raman Nagar,37100,36340,760,0.020485175202156335,1
8985,8986,CV Raman Nagar,28450,60630,-32180,-1.1311072056239015,1
8986,8987,Malleswaram,415250,26830,388420,0.9353883202889826,-1
8987,8988,Kalyan Nagar,325050,73390,251660,0.7742193508690971,0
8988,8989,Marathahalli,442200,69620,372580,0.8425599276345545,-1
8989,8990,Malleswaram,279050,66420,212630,0.7619781401182584,0
8990,8991,Rajajinagar,77900,92460,-14560,-0.18690629011553272,1
8991,8992,Hoodi,221850,132560,89290,0.4024791525805725,1
8992,8993,Mahadevapura,435600,101190,334410,0.7676997245179064,0
8993,8994,Kalyan Nagar,25850,73320,-47470,-1.8363636363636364,1
8994,8995,CV Raman Nagar,177950,49260,128690,0.7231806687271706,0
8995,8996,Banaswadi,114400,103770,10630,0.09291958041958041,1
8996,8997,Varthur,392500,59220,333280,0.8491210191082803,-1
8997,8998,Shivajinagar,205500,47880,157620,0.7670072992700729,0
8998,8999,Varthur,154900,15680,139220,0.8987734021949645,-1
8999,9000,Horamavu,232650,74070,158580,0.681624758220503,0
9000,9001,Kalyan Nagar,236500,80160,156340,0.6610570824524313,0
9001,9002,Marathahalli,145200,0,145200,1.0,-1
9002,9003,Varthur,347050,38810,308240,0.8881717331796571,-1
9003,9004,Jalahalli,221450,72320,149130,0.673425152404606,0
9004,9005,Kammanahalli,396450,36720,359730,0.9073779795686719,-1
9005,9006,Malleswaram,276500,79190,197310,0.7135985533453888,0
9006,9007,Horamavu,280750,27250,253500,0.9029385574354408,-1
9007,9008,HBR Layout,262650,70260,192390,0.7324957167332953,0
9008,9009,Malleswaram,92050,2420,89630,0.9737099402498642,-1
9009,9010,CV Raman Nagar,240850,87310,153540,0.6374922150716213,0
9010,9011,Hebbal,119850,81490,38360,0.320066750104297,1
9011,9012,Hebbal,373150,59560,313590,0.8403859037920407,-1
9012,9013,Varthur,373450,59300,314150,0.8412103360556968,-1
9013,9014,Indiranagar,205900,49920,155980,0.7575522098105877,0
9014,9015,Rajajinagar,286250,32350,253900,0.8869868995633188,-1
9015,9016,Kalyan Nagar,251800,47030,204770,0.8132247815726767,-1
9016,9017,Banaswadi,295750,95190,200560,0.6781403212172443,0
9017,9018,Hoodi,327750,45530,282220,0.8610831426392067,-1
9018,9019,Kalyan Nagar,438650,5810,432840,0.9867548159124587,-1
9019,9020,Horamavu,132100,74700,57400,0.4345193035579107,1
9020,9021,Whitefield,79250,40060,39190,0.49451104100946375,1
9021,9022,Jalahalli,354000,63060,290940,0.821864406779661,-1
9022,9023,Kalyan Nagar,157100,91540,65560,0.4173138128580522,1
9023,9024,Banaswadi,48850,10610,38240,0.7828045035823951,0
9024,9025,Rajajinagar,436650,51620,385030,0.8817817473949388,-1
9025,9026,HBR Layout,170500,51390,119110,0.6985923753665689,0
9026,9027,Indiranagar,323950,23450,300500,0.9276122858465813,-1
9027,9028,Kalyan Nagar,405350,56340,349010,0.8610090045639571,-1
9028,9029,Kammanahalli,170500,81330,89170,0.522991202346041,0
9029,9030,Krishnarajapuram,81800,68610,13190,0.16124694376528118,1
9030,9031,CV Raman Nagar,104450,51690,52760,0.5051220679751077,0
9031,9032,Vasanth Nagar,282100,5870,276230,0.9791917759659695,-1
9032,9033,Horamavu,39800,83520,-43720,-1.0984924623115577,1
9033,9034,Rajajinagar,265750,78740,187010,0.7037064910630292,0
9034,9035,Horamavu,99050,90290,8760,0.08844018172640081,1
9035,9036,Horamavu,163600,31450,132150,0.8077628361858191,-1
9036,9037,Jalahalli,165300,39760,125540,0.7594676346037508,0
9037,9038,Rajajinagar,409500,62210,347290,0.848083028083028,-1
9038,9039,HBR Layout,130650,50400,80250,0.6142365097588978,0
9039,9040,Horamavu,98550,49710,48840,0.49558599695586,1
9040,9041,Kammanahalli,170750,111710,59040,0.34576866764275255,1
9041,9042,Rajajinagar,434950,26030,408920,0.9401540406943327,-1
9042,9043,Kammanahalli,107200,9340,97860,0.9128731343283583,-1
9043,9044,Banaswadi,293750,101410,192340,0.6547744680851064,0
9044,9045,Mahadevapura,262950,74310,188640,0.7173987450085567,0
9045,9046,Malleswaram,349300,83330,265970,0.7614371600343545,0
9046,9047,Horamavu,84200,63030,21170,0.2514251781472684,1
9047,9048,Krishnarajapuram,234250,115370,118880,0.5074919957310565,0
9048,9049,Rajajinagar,300100,46650,253450,0.8445518160613129,-1
9049,9050,Vasanth Nagar,58450,53530,4920,0.08417450812660393,1
9050,9051,Rajajinagar,435900,56270,379630,0.8709107593484744,-1
9051,9052,Hoodi,357150,25650,331500,0.9281814363712726,-1
9052,9053,Banaswadi,75600,65530,10070,0.1332010582010582,1
9053,9054,CV Raman Nagar,253100,67240,185860,0.734334255235085,0
9054,9055,Whitefield,220650,162320,58330,0.26435531384545663,1
9055,9056,Kammanahalli,138000,9890,128110,0.9283333333333333,-1
9056,9057,Banaswadi,414200,50340,363860,0.8784645098985997,-1
9057,9058,Whitefield,393600,72950,320650,0.8146595528455285,-1
9058,9059,Marathahalli,383300,34960,348340,0.9087920688755544,-1
9059,9060,Whitefield,194550,78020,116530,0.5989719866358263,0
9060,9061,Malleswaram,369200,108320,260880,0.7066088840736728,0
9061,9062,Vasanth Nagar,231600,62810,168790,0.7287996545768567,0
9062,9063,CV Raman Nagar,190150,87600,102550,0.5393110702077307,0
9063,9064,Banaswadi,366250,29640,336610,0.9190716723549488,-1
9064,9065,Banaswadi,266150,48150,218000,0.8190869810257374,-1
9065,9066,Indiranagar,133050,63060,69990,0.5260428410372041,0
9066,9067,Varthur,213750,58340,155410,0.7270643274853801,0
9067,9068,Kammanahalli,228350,61310,167040,0.7315086490037224,0
9068,9069,Indiranagar,363550,44820,318730,0.8767157199834961,-1
9069,9070,Banaswadi,111100,177860,-66760,-0.6009000900090009,1
9070,9071,Varthur,398650,128420,270230,0.6778627869058071,0
9071,9072,Horamavu,363750,64550,299200,0.8225429553264605,-1
9072,9073,CV Raman Nagar,357950,101810,256140,0.7155748009498534,0
9073,9074,Jalahalli,52400,40630,11770,0.224618320610687,1
9074,9075,Jalahalli,395150,12450,382700,0.9684929773503733,-1
9075,9076,Hebbal,428450,29750,398700,0.9305636597035827,-1
9076,9077,CV Raman Nagar,264000,62680,201320,0.7625757575757576,0
9077,9078,Varthur,220750,17020,203730,0.9228992072480181,-1
9078,9079,Mahadevapura,248550,27340,221210,0.8900020116676725,-1
9079,9080,HBR Layout,163350,79280,84070,0.5146617692072237,0
9080,9081,Horamavu,51150,30290,20860,0.40782013685239493,1
9081,9082,Horamavu,130800,76260,54540,0.4169724770642202,1
9082,9083,Whitefield,253500,30010,223490,0.8816173570019724,-1
9083,9084,Malleswaram,366550,70100,296450,0.8087573318783249,-1
9084,9085,Horamavu,393400,115020,278380,0.7076258261311642,0
9085,9086,Hoodi,413150,57780,355370,0.8601476461333656,-1
9086,9087,Banaswadi,438500,142240,296260,0.6756214367160776,0
9087,9088,Jalahalli,127900,33060,94840,0.7415168100078187,0
9088,9089,Indiranagar,129100,93390,35710,0.27660728117738187,1
9089,9090,Jalahalli,44900,36000,8900,0.19821826280623608,1
9090,9091,Varthur,377750,84090,293660,0.7773924553275976,0
9091,9092,Marathahalli,238100,90630,147470,0.6193616127677446,0
9092,9093,Varthur,131150,61940,69210,0.5277163553183378,0
9093,9094,CV Raman Nagar,191000,95610,95390,0.4994240837696335,1
9094,9095,HBR Layout,363350,35350,328000,0.9027108848217972,-1
9095,9096,Marathahalli,324800,47690,277110,0.8531711822660099,-1
9096,9097,Malleswaram,185350,88380,96970,0.5231723765848395,0
9097,9098,Hoodi,114250,59060,55190,0.4830634573304158,1
9098,9099,Krishnarajapuram,233150,60020,173130,0.7425691614840232,0
9099,9100,Jalahalli,36700,125810,-89110,-2.4280653950953677,1
9100,9101,Kalyan Nagar,427550,91050,336500,0.7870424511753011,0
9101,9102,Varthur,59550,115180,-55630,-0.9341729638958858,1
9102,9103,Vasanth Nagar,440850,11200,429650,0.9745945332879664,-1
9103,9104,Indiranagar,129600,100240,29360,0.22654320987654322,1
9104,9105,HBR Layout,335950,40080,295870,0.8806965322220569,-1
9105,9106,Vasanth Nagar,269150,71650,197500,0.733791566041241,0
9106,9107,Hoodi,101850,78600,23250,0.22827687776141384,1
9107,9108,HBR Layout,293500,65550,227950,0.7766609880749574,0
9108,9109,Banaswadi,396300,71620,324680,0.8192783245016402,-1
9109,9110,Vasanth Nagar,164150,36450,127700,0.7779469996954006,0
9110,9111,Kammanahalli,247450,52370,195080,0.7883612851081027,0
9111,9112,Mahadevapura,443900,45690,398210,0.8970714124802883,-1
9112,9113,Hoodi,208400,69190,139210,0.6679942418426104,0
9113,9114,CV Raman Nagar,45450,72600,-27150,-0.5973597359735974,1
9114,9115,Vasanth Nagar,177250,55490,121760,0.6869393511988716,0
9115,9116,Horamavu,165150,61310,103840,0.628761731759007,0
9116,9117,Hoodi,393400,53070,340330,0.8650991357397051,-1
9117,9118,Hoodi,432100,68600,363500,0.841240453598704,-1
9118,9119,Malleswaram,225600,88040,137560,0.6097517730496453,0
9119,9120,Horamavu,230200,52880,177320,0.7702867072111208,0
9120,9121,Hebbal,264750,43230,221520,0.83671388101983,-1
9121,9122,Jalahalli,338450,34110,304340,0.8992170187620032,-1
9122,9123,Jalahalli,260150,42850,217300,0.8352873342302518,-1
9123,9124,Whitefield,381950,18740,363210,0.9509359863856526,-1
9124,9125,Banaswadi,155700,99610,56090,0.36024405908798973,1
9125,9126,Shivajinagar,266750,83440,183310,0.6871977507029053,0
9126,9127,CV Raman Nagar,36250,74000,-37750,-1.0413793103448277,1
9127,9128,Rajajinagar,209500,58030,151470,0.7230071599045346,0
9128,9129,HBR Layout,51250,116700,-65450,-1.2770731707317073,1
9129,9130,Hoodi,165500,44030,121470,0.7339577039274925,0
9130,9131,Vasanth Nagar,324750,108360,216390,0.6663279445727482,0
9131,9132,Marathahalli,124950,82840,42110,0.33701480592236893,1
9132,9133,Banaswadi,414700,55690,359010,0.8657101519170485,-1
9133,9134,Hoodi,171200,98400,72800,0.4252336448598131,1
9134,9135,Kalyan Nagar,421450,55420,366030,0.8685016016134772,-1
9135,9136,Banaswadi,175500,70110,105390,0.6005128205128205,0
9136,9137,Jalahalli,218250,2780,215470,0.987262313860252,-1
9137,9138,Shivajinagar,319450,56410,263040,0.8234152449522617,-1
9138,9139,Whitefield,287350,70350,217000,0.7551766138855055,0
9139,9140,Rajajinagar,324150,84380,239770,0.7396884158568564,0
9140,9141,Whitefield,214850,23830,191020,0.8890854084244822,-1
9141,9142,Vasanth Nagar,245600,79580,166020,0.6759771986970684,0
9142,9143,CV Raman Nagar,204400,52390,152010,0.7436888454011742,0
9143,9144,HBR Layout,372500,57950,314550,0.8444295302013423,-1
9144,9145,Mahadevapura,109400,79390,30010,0.2743144424131627,1
9145,9146,Krishnarajapuram,239450,65760,173690,0.7253706410524118,0
9146,9147,Hoodi,275300,91140,184160,0.668942971304032,0
9147,9148,Rajajinagar,355800,102190,253610,0.712788083192805,0
9148,9149,Jalahalli,132150,42310,89840,0.6798335225122967,0
9149,9150,Kalyan Nagar,26250,86360,-60110,-2.289904761904762,1
9150,9151,Horamavu,132100,71880,60220,0.4558667676003028,1
9151,9152,Varthur,126900,21290,105610,0.8322301024428684,-1
9152,9153,Kammanahalli,365900,104510,261390,0.7143755124350916,0
9153,9154,Shivajinagar,221200,114420,106780,0.48273056057866187,1
9154,9155,Whitefield,304300,28790,275510,0.9053894183371672,-1
9155,9156,Malleswaram,364750,83800,280950,0.7702535983550377,0
9156,9157,Whitefield,128250,85710,42540,0.33169590643274854,1
9157,9158,Vasanth Nagar,62950,65580,-2630,-0.041779189833200954,1
9158,9159,Kammanahalli,419200,35210,383990,0.916006679389313,-1
9159,9160,Krishnarajapuram,415550,90460,325090,0.7823125977620021,0
9160,9161,Shivajinagar,172850,46130,126720,0.7331212033555106,0
9161,9162,HBR Layout,151550,63860,87690,0.5786209171890465,0
9162,9163,Banaswadi,98600,78320,20280,0.2056795131845842,1
9163,9164,CV Raman Nagar,316200,40160,276040,0.8729917773561038,-1
9164,9165,Marathahalli,276450,47440,229010,0.8283957315970338,-1
9165,9166,HBR Layout,138000,32970,105030,0.7610869565217391,0
9166,9167,Indiranagar,352950,104180,248770,0.7048307125655192,0
9167,9168,Vasanth Nagar,222450,9700,212750,0.9563946954371769,-1
9168,9169,Hebbal,423000,119590,303410,0.7172813238770686,0
9169,9170,Jalahalli,186300,60830,125470,0.6734836285560923,0
9170,9171,CV Raman Nagar,197500,49360,148140,0.7500759493670887,0
9171,9172,Banaswadi,422900,26790,396110,0.9366516907070229,-1
9172,9173,Mahadevapura,88600,141890,-53290,-0.6014672686230248,1
9173,9174,Varthur,354150,55350,298800,0.843710292249047,-1
9174,9175,Indiranagar,432550,28390,404160,0.9343659692521096,-1
9175,9176,Marathahalli,168100,8270,159830,0.9508030933967876,-1
9176,9177,Banaswadi,279000,77600,201400,0.7218637992831541,0
9177,9178,CV Raman Nagar,143850,65780,78070,0.5427181091414668,0
9178,9179,Banaswadi,117900,51300,66600,0.5648854961832062,0
9179,9180,Mahadevapura,422200,58550,363650,0.8613216485078162,-1
9180,9181,Krishnarajapuram,212450,64050,148400,0.6985172981878089,0
9181,9182,Rajajinagar,247600,56020,191580,0.7737479806138934,0
9182,9183,Whitefield,146700,82750,63950,0.43592365371506475,1
9183,9184,Marathahalli,137000,51390,85610,0.6248905109489051,0
9184,9185,Krishnarajapuram,71950,93160,-21210,-0.2947880472550382,1
9185,9186,Banaswadi,211800,53750,158050,0.746222851746931,0
9186,9187,Mahadevapura,35200,100080,-64880,-1.8431818181818183,1
9187,9188,Horamavu,242700,58780,183920,0.7578079934074989,0
9188,9189,Banaswadi,116200,740,115460,0.993631669535284,-1
9189,9190,Marathahalli,322200,52640,269560,0.8366232153941651,-1
9190,9191,Indiranagar,290900,42630,248270,0.8534547954623583,-1
9191,9192,Vasanth Nagar,281900,99040,182860,0.6486697410429231,0
9192,9193,Indiranagar,155700,92420,63280,0.40642260757867693,1
9193,9194,Vasanth Nagar,372900,60110,312790,0.8388039688924644,-1
9194,9195,Indiranagar,151050,86430,64620,0.4278053624627607,1
9195,9196,Kammanahalli,220250,52400,167850,0.762088535754824,0
9196,9197,Mahadevapura,287050,107380,179670,0.6259188294722173,0
9197,9198,Rajajinagar,185050,122240,62810,0.33942177789786543,1
9198,9199,Whitefield,188600,182490,6110,0.0323966065747614,1
9199,9200,Banaswadi,62700,87390,-24690,-0.3937799043062201,1
9200,9201,HBR Layout,376000,86770,289230,0.7692287234042553,0
9201,9202,Varthur,256600,61440,195160,0.7605611847233048,0
9202,9203,Krishnarajapuram,330500,78660,251840,0.7619969742813918,0
9203,9204,Kammanahalli,335000,80030,254970,0.7611044776119403,0
9204,9205,Rajajinagar,220750,93750,127000,0.5753114382785957,0
9205,9206,HBR Layout,404900,30590,374310,0.9244504816003951,-1
9206,9207,Malleswaram,122100,39280,82820,0.6782964782964783,0
9207,9208,Shivajinagar,72100,8570,63530,0.8811373092926491,-1
9208,9209,Rajajinagar,449350,38690,410660,0.913897852453544,-1
9209,9210,Jalahalli,312600,76670,235930,0.7547344849648112,0
9210,9211,Krishnarajapuram,225500,133510,91990,0.4079379157427938,1
9211,9212,Vasanth Nagar,42350,39140,3210,0.07579693034238488,1
9212,9213,Vasanth Nagar,62450,145360,-82910,-1.3276220976781425,1
9213,9214,Rajajinagar,141000,34080,106920,0.7582978723404256,0
9214,9215,Hebbal,54550,104270,-49720,-0.9114573785517873,1
9215,9216,Krishnarajapuram,267500,48290,219210,0.8194766355140187,-1
9216,9217,Banaswadi,196400,82750,113650,0.5786659877800407,0
9217,9218,Hoodi,309900,83990,225910,0.7289770893836721,0
9218,9219,Hebbal,248250,46710,201540,0.8118429003021148,-1
9219,9220,Marathahalli,352100,66810,285290,0.8102527690996876,-1
9220,9221,Mahadevapura,133300,57130,76170,0.5714178544636159,0
9221,9222,Varthur,315700,1470,314230,0.9953436807095344,-1
9222,9223,Hebbal,227500,40540,186960,0.8218021978021978,-1
9223,9224,Shivajinagar,332650,52370,280280,0.8425672628889223,-1
9224,9225,Vasanth Nagar,402100,105220,296880,0.7383238000497389,0
9225,9226,Krishnarajapuram,87050,50780,36270,0.4166570936243538,1
9226,9227,Malleswaram,106000,85390,20610,0.19443396226415094,1
9227,9228,Horamavu,271700,70290,201410,0.7412955465587044,0
9228,9229,Krishnarajapuram,334750,39670,295080,0.8814936519790889,-1
9229,9230,Marathahalli,253050,110350,142700,0.5639201738786801,0
9230,9231,CV Raman Nagar,76700,109660,-32960,-0.4297262059973924,1
9231,9232,Krishnarajapuram,438700,43120,395580,0.9017095965352177,-1
9232,9233,Banaswadi,271450,71970,199480,0.7348682998710628,0
9233,9234,Hebbal,315850,43630,272220,0.8618648092448947,-1
9234,9235,Rajajinagar,430000,15970,414030,0.9628604651162791,-1
9235,9236,Rajajinagar,329700,89080,240620,0.7298149833181681,0
9236,9237,Vasanth Nagar,443550,132440,311110,0.7014090857851426,0
9237,9238,Kalyan Nagar,240850,81850,159000,0.660161926510276,0
9238,9239,Whitefield,225150,53390,171760,0.7628691983122363,0
9239,9240,Indiranagar,184850,49010,135840,0.7348661076548553,0
9240,9241,Horamavu,270350,59480,210870,0.7799889032735343,0
9241,9242,Hoodi,152550,88330,64220,0.4209767289413307,1
9242,9243,Varthur,60300,43070,17230,0.2857379767827529,1
9243,9244,Rajajinagar,434600,36060,398540,0.9170271514035895,-1
9244,9245,Mahadevapura,297500,110840,186660,0.6274285714285714,0
9245,9246,Vasanth Nagar,347600,109200,238400,0.6858457997698504,0
9246,9247,Hoodi,446600,35270,411330,0.92102552619794,-1
9247,9248,Hebbal,57650,52140,5510,0.09557675628794449,1
9248,9249,Shivajinagar,335600,115850,219750,0.6547973778307509,0
9249,9250,Whitefield,83200,44260,38940,0.46802884615384616,1
9250,9251,Horamavu,276200,52770,223430,0.8089427950760318,-1
9251,9252,Whitefield,329750,43460,286290,0.8682031842304776,-1
9252,9253,Shivajinagar,263350,58780,204570,0.7767989367761534,0
9253,9254,Banaswadi,379250,73360,305890,0.8065655899802241,-1
9254,9255,Krishnarajapuram,347200,80350,266850,0.7685771889400922,0
9255,9256,Indiranagar,180850,74040,106810,0.5905999447055571,0
9256,9257,CV Raman Nagar,135650,55580,80070,0.5902690748249171,0
9257,9258,Hebbal,434050,59960,374090,0.8618592328072803,-1
9258,9259,Hebbal,242450,16830,225620,0.9305836254897917,-1
9259,9260,Malleswaram,251000,33590,217410,0.8661752988047808,-1
9260,9261,Mahadevapura,244400,43660,200740,0.8213584288052374,-1
9261,9262,Rajajinagar,176950,61320,115630,0.6534614297824244,0
9262,9263,HBR Layout,245950,118410,127540,0.5185606830656637,0
9263,9264,Hoodi,316400,119460,196940,0.6224399494310999,0
9264,9265,Varthur,32050,14520,17530,0.5469578783151327,0
9265,9266,Kammanahalli,376550,60330,316220,0.8397822334351348,-1
9266,9267,Jalahalli,196900,81830,115070,0.5844083291010665,0
9267,9268,Hebbal,324100,88500,235600,0.7269361308238198,0
9268,9269,Hoodi,323500,74400,249100,0.770015455950541,0
9269,9270,Banaswadi,51200,25880,25320,0.49453125,1
9270,9271,Hoodi,327600,115200,212400,0.6483516483516484,0
9271,9272,Krishnarajapuram,198800,53930,144870,0.7287223340040242,0
9272,9273,Horamavu,215600,102320,113280,0.525417439703154,0
9273,9274,Krishnarajapuram,167950,30340,137610,0.8193509973206311,-1
9274,9275,CV Raman Nagar,93900,38810,55090,0.5866879659211928,0
9275,9276,Rajajinagar,123550,30910,92640,0.7498178874949413,0
9276,9277,Vasanth Nagar,371100,126980,244120,0.6578280786849906,0
9277,9278,Shivajinagar,140600,0,140600,1.0,-1
9278,9279,Hebbal,36800,22980,13820,0.3755434782608696,1
9279,9280,Malleswaram,381600,46650,334950,0.877751572327044,-1
9280,9281,Kammanahalli,305450,39330,266120,0.8712391553445736,-1
9281,9282,Jalahalli,248600,45550,203050,0.8167739340305712,-1
9282,9283,Malleswaram,276100,136130,139970,0.5069540021731257,0
9283,9284,Hoodi,388050,52890,335160,0.8637031310398144,-1
9284,9285,Hoodi,160200,10970,149230,0.9315230961298377,-1
9285,9286,Hebbal,407800,20240,387560,0.950367827366356,-1
9286,9287,Vasanth Nagar,133300,28300,105000,0.7876969242310577,0
9287,9288,Whitefield,90200,51990,38210,0.4236141906873614,1
9288,9289,HBR Layout,302650,66940,235710,0.7788204196266314,0
9289,9290,Horamavu,331950,44080,287870,0.8672089170055731,-1
9290,9291,Vasanth Nagar,406000,36680,369320,0.9096551724137931,-1
9291,9292,Banaswadi,268650,101390,167260,0.6225944537502326,0
9292,9293,Marathahalli,107250,21700,85550,0.7976689976689977,0
9293,9294,CV Raman Nagar,170950,29020,141930,0.8302427610412402,-1
9294,9295,Krishnarajapuram,352700,31650,321050,0.9102636801814573,-1
9295,9296,Horamavu,202250,56470,145780,0.7207911001236094,0
9296,9297,Varthur,346450,35220,311230,0.8983403088468754,-1
9297,9298,Kammanahalli,346350,88290,258060,0.7450844521437852,0
9298,9299,CV Raman Nagar,237750,91710,146040,0.6142586750788643,0
9299,9300,Krishnarajapuram,86100,102310,-16210,-0.18826945412311266,1
9300,9301,Jalahalli,88050,69860,18190,0.20658716638273708,1
9301,9302,Varthur,288200,44350,243850,0.8461138098542679,-1
9302,9303,Horamavu,372850,115400,257450,0.6904921550221269,0
9303,9304,Mahadevapura,426850,55170,371680,0.8707508492444652,-1
9304,9305,Banaswadi,128050,20360,107690,0.8409996095275283,-1
9305,9306,Hoodi,133550,74770,58780,0.440134780980906,1
9306,9307,Indiranagar,372650,60910,311740,0.8365490406547699,-1
9307,9308,HBR Layout,388300,103140,285160,0.7343806335307752,0
9308,9309,Rajajinagar,196050,103910,92140,0.4699821474113747,1
9309,9310,Indiranagar,258150,48010,210140,0.8140228549293047,-1
9310,9311,Jalahalli,411950,116150,295800,0.7180483068333535,0
9311,9312,Horamavu,369800,115690,254110,0.6871552190373175,0
9312,9313,Kammanahalli,27950,125500,-97550,-3.4901610017889086,1
9313,9314,CV Raman Nagar,51750,14650,37100,0.7169082125603865,0
9314,9315,Banaswadi,251600,80930,170670,0.6783386327503974,0
9315,9316,Banaswadi,122400,149930,-27530,-0.22491830065359478,1
9316,9317,Shivajinagar,414350,36300,378050,0.9123929045492941,-1
9317,9318,Varthur,279400,123750,155650,0.5570866141732284,0
9318,9319,Horamavu,435750,114980,320770,0.7361331038439473,0
9319,9320,Shivajinagar,377650,50150,327500,0.8672050840725539,-1
9320,9321,Krishnarajapuram,94850,54540,40310,0.4249868212967844,1
9321,9322,Shivajinagar,245250,63580,181670,0.7407543323139654,0
9322,9323,Banaswadi,315900,27710,288190,0.9122823678379234,-1
9323,9324,Marathahalli,56050,74160,-18110,-0.3231043710972346,1
9324,9325,Hebbal,130050,80640,49410,0.37993079584775086,1
9325,9326,Hoodi,269000,15420,253580,0.9426765799256506,-1
9326,9327,Kammanahalli,312050,11040,301010,0.9646210543182182,-1
9327,9328,Kammanahalli,180950,58680,122270,0.6757115225200332,0
9328,9329,HBR Layout,262850,80890,181960,0.6922579417918965,0
9329,9330,Hoodi,254050,84140,169910,0.668805353276914,0
9330,9331,Malleswaram,41250,82430,-41180,-0.9983030303030302,1
9331,9332,Kammanahalli,344150,22070,322080,0.9358709864884498,-1
9332,9333,Indiranagar,249250,94520,154730,0.6207823470411233,0
9333,9334,Vasanth Nagar,105550,4730,100820,0.9551871151113216,-1
9334,9335,Hebbal,181750,72040,109710,0.6036313617606602,0
9335,9336,Whitefield,288200,129580,158620,0.5503816793893129,0
9336,9337,Hebbal,219850,63200,156650,0.7125312713213555,0
9337,9338,Vasanth Nagar,82150,6410,75740,0.9219720024345709,-1
9338,9339,Varthur,70350,43890,26460,0.3761194029850746,1
9339,9340,Jalahalli,170450,47870,122580,0.7191551774713992,0
9340,9341,Varthur,81550,71460,10090,0.12372777437155119,1
9341,9342,Vasanth Nagar,150450,21040,129410,0.8601528747092058,-1
9342,9343,HBR Layout,117250,57320,59930,0.5111300639658849,0
9343,9344,Hoodi,42000,52910,-10910,-0.25976190476190475,1
9344,9345,Shivajinagar,385850,37630,348220,0.902475055073215,-1
9345,9346,Krishnarajapuram,386000,30790,355210,0.9202331606217616,-1
9346,9347,Shivajinagar,246600,71940,174660,0.7082725060827251,0
9347,9348,Rajajinagar,269500,90570,178930,0.6639332096474954,0
9348,9349,Jalahalli,353850,118430,235420,0.6653101596721774,0
9349,9350,Jalahalli,82350,66690,15660,0.1901639344262295,1
9350,9351,Hebbal,362850,87460,275390,0.7589637591291167,0
9351,9352,Rajajinagar,71250,36240,35010,0.49136842105263157,1
9352,9353,Hoodi,368400,35520,332880,0.9035830618892509,-1
9353,9354,Indiranagar,304100,72460,231640,0.7617231173955935,0
9354,9355,Krishnarajapuram,272900,76760,196140,0.7187248076218395,0
9355,9356,Banaswadi,146700,40950,105750,0.7208588957055214,0
9356,9357,Marathahalli,59750,68610,-8860,-0.1482845188284519,1
9357,9358,Varthur,407350,41890,365460,0.8971646004664293,-1
9358,9359,Varthur,383350,116010,267340,0.6973783748532673,0
9359,9360,Hebbal,71700,16940,54760,0.7637377963737796,0
9360,9361,Hoodi,85500,60070,25430,0.2974269005847953,1
9361,9362,Varthur,405550,46980,358570,0.8841573172235236,-1
9362,9363,Indiranagar,86350,77100,9250,0.10712217718587146,1
9363,9364,Vasanth Nagar,322850,56120,266730,0.8261731454235713,-1
9364,9365,Mahadevapura,440150,49890,390260,0.8866522776326252,-1
9365,9366,HBR Layout,254100,90330,163770,0.6445100354191263,0
9366,9367,Kalyan Nagar,71500,111650,-40150,-0.5615384615384615,1
9367,9368,Hebbal,108150,72830,35320,0.326583448913546,1
9368,9369,Mahadevapura,108150,131320,-23170,-0.21423948220064726,1
9369,9370,Banaswadi,166200,22100,144100,0.8670276774969916,-1
9370,9371,Kammanahalli,347550,102800,244750,0.704215220831535,0
9371,9372,Whitefield,64700,45330,19370,0.2993817619783617,1
9372,9373,Shivajinagar,165400,64590,100810,0.6094921402660217,0
9373,9374,Marathahalli,421350,92770,328580,0.7798267473596773,0
9374,9375,Indiranagar,83200,60870,22330,0.2683894230769231,1
9375,9376,Krishnarajapuram,401350,68960,332390,0.8281798928615921,-1
9376,9377,Whitefield,349650,90280,259370,0.7417989417989418,0
9377,9378,Shivajinagar,257350,54400,202950,0.7886147270254518,0
9378,9379,Kalyan Nagar,85650,51140,34510,0.40291885580852305,1
9379,9380,Banaswadi,150500,94800,55700,0.37009966777408637,1
9380,9381,Whitefield,253050,28920,224130,0.8857142857142857,-1
9381,9382,Indiranagar,386650,64610,322040,0.832897969740075,-1
9382,9383,Hebbal,257400,71780,185620,0.7211344211344212,0
9383,9384,Kalyan Nagar,377850,34260,343590,0.9093290988487495,-1
9384,9385,Vasanth Nagar,389300,68700,320600,0.8235294117647058,-1
9385,9386,Krishnarajapuram,213350,10860,202490,0.9490977267400984,-1
9386,9387,HBR Layout,137150,65240,71910,0.5243164418519869,0
9387,9388,Vasanth Nagar,279900,28880,251020,0.896820292961772,-1
9388,9389,Kammanahalli,25250,57250,-32000,-1.2673267326732673,1
9389,9390,Shivajinagar,354050,19090,334960,0.9460810619968931,-1
9390,9391,Mahadevapura,350300,47290,303010,0.8650014273479875,-1
9391,9392,Jalahalli,225300,88150,137150,0.6087438970261873,0
9392,9393,Whitefield,299650,134800,164850,0.5501418321374938,0
9393,9394,Kalyan Nagar,69650,99890,-30240,-0.43417085427135677,1
9394,9395,Whitefield,177250,34180,143070,0.8071650211565585,-1
9395,9396,Horamavu,400900,36240,364660,0.9096033923671739,-1
9396,9397,HBR Layout,55950,69800,-13850,-0.24754244861483468,1
9397,9398,Indiranagar,424950,43660,381290,0.8972585010001176,-1
9398,9399,Vasanth Nagar,374200,56590,317610,0.8487707108498129,-1
9399,9400,HBR Layout,371400,78300,293100,0.7891760904684976,0
9400,9401,Jalahalli,116650,36310,80340,0.6887269609944278,0
9401,9402,Kammanahalli,134650,45180,89470,0.6644634236910508,0
9402,9403,HBR Layout,436050,17670,418380,0.9594771241830066,-1
9403,9404,Shivajinagar,282250,47240,235010,0.8326306465899026,-1
9404,9405,HBR Layout,30750,61290,-30540,-0.9931707317073171,1
9405,9406,Rajajinagar,297450,66160,231290,0.7775760632038998,0
9406,9407,Indiranagar,438650,59390,379260,0.8646073179072153,-1
9407,9408,Mahadevapura,36050,151360,-115310,-3.198613037447989,1
9408,9409,Hebbal,433800,28770,405030,0.9336791147994468,-1
9409,9410,Jalahalli,230000,44620,185380,0.806,-1
9410,9411,Shivajinagar,219600,42660,176940,0.8057377049180328,-1
9411,9412,Kammanahalli,182900,65970,116930,0.639311098961181,0
9412,9413,Horamavu,314400,28740,285660,0.908587786259542,-1
9413,9414,Krishnarajapuram,139650,158060,-18410,-0.1318295739348371,1
9414,9415,Hoodi,363400,32210,331190,0.9113648871766649,-1
9415,9416,Shivajinagar,90000,77800,12200,0.13555555555555557,1
9416,9417,Rajajinagar,264550,58630,205920,0.7783783783783784,0
9417,9418,Vasanth Nagar,286800,68160,218640,0.7623430962343096,0
9418,9419,HBR Layout,384250,90360,293890,0.7648405985686402,0
9419,9420,Krishnarajapuram,117800,124510,-6710,-0.05696095076400679,1
9420,9421,Mahadevapura,438050,73080,364970,0.8331697294829358,-1
9421,9422,Varthur,416700,21820,394880,0.9476361891048716,-1
9422,9423,CV Raman Nagar,374700,71010,303690,0.8104883907125701,-1
9423,9424,Marathahalli,243850,102500,141350,0.5796596268197662,0
9424,9425,HBR Layout,234150,34790,199360,0.8514200298953662,-1
9425,9426,Indiranagar,344000,83790,260210,0.7564244186046511,0
9426,9427,Whitefield,351300,84960,266340,0.7581554227156276,0
9427,9428,CV Raman Nagar,138600,61060,77540,0.5594516594516594,0
9428,9429,Shivajinagar,325900,22280,303620,0.9316354710033753,-1
9429,9430,Horamavu,177550,97870,79680,0.44877499295972967,1
9430,9431,Mahadevapura,251650,60300,191350,0.7603814822173653,0
9431,9432,Indiranagar,326100,84290,241810,0.7415210058264337,0
9432,9433,Varthur,280250,67080,213170,0.76064228367529,0
9433,9434,Vasanth Nagar,40800,53870,-13070,-0.320343137254902,1
9434,9435,HBR Layout,109750,18950,90800,0.8273348519362187,-1
9435,9436,Mahadevapura,54200,34660,19540,0.36051660516605166,1
9436,9437,Rajajinagar,221950,44890,177060,0.7977472403694525,0
9437,9438,Varthur,69500,48830,20670,0.29741007194244606,1
9438,9439,Rajajinagar,170150,66530,103620,0.6089920658242727,0
9439,9440,Malleswaram,250400,10670,239730,0.9573881789137381,-1
9440,9441,Shivajinagar,359800,60480,299320,0.8319066147859923,-1
9441,9442,Varthur,72950,31050,41900,0.5743660041124058,0
9442,9443,Horamavu,147500,48710,98790,0.6697627118644068,0
9443,9444,Malleswaram,28250,62260,-34010,-1.2038938053097346,1
9444,9445,Banaswadi,385650,50820,334830,0.8682224815246986,-1
9445,9446,Horamavu,253000,73770,179230,0.7084189723320158,0
9446,9447,Kammanahalli,160950,69230,91720,0.5698664181422802,0
9447,9448,Whitefield,278150,103520,174630,0.6278267122056445,0
9448,9449,Rajajinagar,33100,91400,-58300,-1.7613293051359518,1
9449,9450,Marathahalli,288850,123990,164860,0.5707460619698805,0
9450,9451,Kammanahalli,239550,84790,154760,0.646044667084116,0
9451,9452,CV Raman Nagar,372950,81800,291150,0.7806676498190106,0
9452,9453,Varthur,150150,143800,6350,0.04229104229104229,1
9453,9454,Horamavu,282450,65750,216700,0.7672154363604178,0
9454,9455,Hebbal,40850,81260,-40410,-0.9892288861689107,1
9455,9456,Mahadevapura,289850,45150,244700,0.8442297740210454,-1
9456,9457,Marathahalli,53650,53530,120,0.0022367194780987883,1
9457,9458,Kammanahalli,266950,78810,188140,0.7047761753137292,0
9458,9459,HBR Layout,406150,41070,365080,0.8988797242398129,-1
9459,9460,Hoodi,243150,83680,159470,0.655850298169854,0
9460,9461,Whitefield,262500,61980,200520,0.7638857142857143,0
9461,9462,Kalyan Nagar,122350,49660,72690,0.5941152431548835,0
9462,9463,Jalahalli,114750,134890,-20140,-0.1755119825708061,1
9463,9464,Whitefield,425900,56920,368980,0.8663536041324255,-1
9464,9465,Whitefield,81400,87190,-5790,-0.07113022113022113,1
9465,9466,CV Raman Nagar,53600,54920,-1320,-0.024626865671641792,1
9466,9467,Mahadevapura,138450,33820,104630,0.7557240881184543,0
9467,9468,Krishnarajapuram,343050,118950,224100,0.6532575426322693,0
9468,9469,Hebbal,53100,65530,-12430,-0.23408662900188323,1
9469,9470,Vasanth Nagar,171300,61560,109740,0.640630472854641,0
9470,9471,Banaswadi,147700,49640,98060,0.6639133378469871,0
9471,9472,HBR Layout,354950,89020,265930,0.749204113255388,0
9472,9473,Horamavu,308500,64930,243570,0.7895299837925446,0
9473,9474,CV Raman Nagar,329750,145410,184340,0.5590295678544351,0
9474,9475,CV Raman Nagar,120200,72710,47490,0.39509151414309485,1
9475,9476,Indiranagar,414900,137850,277050,0.6677512653651483,0
9476,9477,Shivajinagar,370050,34690,335360,0.9062559113633293,-1
9477,9478,Krishnarajapuram,78200,70690,7510,0.09603580562659847,1
9478,9479,Hebbal,193200,124930,68270,0.35336438923395447,1
9479,9480,Banaswadi,236150,100180,135970,0.5757781071352953,0
9480,9481,CV Raman Nagar,120650,31240,89410,0.7410692084542064,0
9481,9482,Rajajinagar,235850,97590,138260,0.5862200551197795,0
9482,9483,Hoodi,370150,16030,354120,0.9566932324733216,-1
9483,9484,Whitefield,443450,59800,383650,0.8651482692524524,-1
9484,9485,Kammanahalli,448350,124100,324250,0.7232073157131705,0
9485,9486,Hoodi,300600,37340,263260,0.8757817697937459,-1
9486,9487,Marathahalli,76150,41930,34220,0.44937623112278396,1
9487,9488,Shivajinagar,307300,43080,264220,0.8598112593556785,-1
9488,9489,Hebbal,271550,87240,184310,0.678733198306021,0
9489,9490,Malleswaram,350000,50330,299670,0.8562,-1
9490,9491,Shivajinagar,143450,64640,78810,0.5493900313698152,0
9491,9492,Krishnarajapuram,302550,70130,232420,0.7682036027102959,0
9492,9493,Kammanahalli,308400,92660,215740,0.6995460440985732,0
9493,9494,Hebbal,352150,35790,316360,0.8983671730796535,-1
9494,9495,Whitefield,396750,58740,338010,0.8519470699432892,-1
9495,9496,Horamavu,99050,113440,-14390,-0.14528016153457848,1
9496,9497,Hebbal,296300,86880,209420,0.7067836652041849,0
9497,9498,Kalyan Nagar,33550,65850,-32300,-0.96274217585693,1
9498,9499,Vasanth Nagar,350800,79740,271060,0.772690992018244,0
9499,9500,Shivajinagar,29700,39250,-9550,-0.32154882154882153,1
9500,9501,Shivajinagar,420400,90700,329700,0.7842530922930543,0
9501,9502,Rajajinagar,100500,105130,-4630,-0.04606965174129353,1
9502,9503,HBR Layout,180000,68680,111320,0.6184444444444445,0
9503,9504,Kalyan Nagar,224050,128680,95370,0.4256639143048427,1
9504,9505,Hebbal,229350,43950,185400,0.8083714846304775,-1
9505,9506,Kammanahalli,134000,103250,30750,0.2294776119402985,1
9506,9507,Whitefield,119850,30780,89070,0.7431789737171465,0
9507,9508,Indiranagar,239000,113080,125920,0.5268619246861924,0
9508,9509,Hebbal,186000,51630,134370,0.7224193548387097,0
9509,9510,Vasanth Nagar,447400,14640,432760,0.96727760393384,-1
9510,9511,Vasanth Nagar,71850,77240,-5390,-0.07501739735560195,1
9511,9512,Hoodi,126950,110190,16760,0.13202048050413548,1
9512,9513,Malleswaram,170450,48730,121720,0.7141097095922558,0
9513,9514,CV Raman Nagar,188100,33150,154950,0.8237639553429027,-1
9514,9515,Kalyan Nagar,242000,36000,206000,0.8512396694214877,-1
9515,9516,Mahadevapura,171350,66030,105320,0.6146483805077327,0
9516,9517,Vasanth Nagar,378100,64620,313480,0.8290928325839725,-1
9517,9518,Hoodi,94650,48150,46500,0.49128367670364503,1
9518,9519,Varthur,400400,40230,360170,0.8995254745254745,-1
9519,9520,Kammanahalli,181550,92760,88790,0.4890663729000275,1
9520,9521,Banaswadi,292750,50510,242240,0.827463706233988,-1
9521,9522,CV Raman Nagar,381250,27450,353800,0.928,-1
9522,9523,CV Raman Nagar,214400,65600,148800,0.6940298507462687,0
9523,9524,Shivajinagar,202650,106310,96340,0.4754009375771034,1
9524,9525,HBR Layout,227800,120330,107470,0.4717734855136084,1
9525,9526,Horamavu,180000,42080,137920,0.7662222222222222,0
9526,9527,Kalyan Nagar,317650,36240,281410,0.8859121674799307,-1
9527,9528,Kammanahalli,268800,103820,164980,0.6137648809523809,0
9528,9529,HBR Layout,118950,132360,-13410,-0.11273644388398486,1
9529,9530,HBR Layout,332250,56710,275540,0.8293152746425884,-1
9530,9531,CV Raman Nagar,161100,44730,116370,0.7223463687150838,0
9531,9532,Whitefield,350150,42770,307380,0.8778523489932886,-1
9532,9533,Horamavu,190350,96800,93550,0.49146309429997376,1
9533,9534,Shivajinagar,430250,65660,364590,0.8473910517141197,-1
9534,9535,Kammanahalli,155700,93580,62120,0.3989723827874117,1
9535,9536,Indiranagar,72550,90100,-17550,-0.24190213645761544,1
9536,9537,CV Raman Nagar,87900,76950,10950,0.12457337883959044,1
9537,9538,Kalyan Nagar,125700,25460,100240,0.7974542561654734,0
9538,9539,Vasanth Nagar,83150,76230,6920,0.08322309079975947,1
9539,9540,Banaswadi,305850,79020,226830,0.7416380578715056,0
9540,9541,Hebbal,246800,81910,164890,0.6681118314424636,0
9541,9542,CV Raman Nagar,364100,27090,337010,0.9255973633617138,-1
9542,9543,Kammanahalli,162150,106430,55720,0.3436324390995991,1
9543,9544,Rajajinagar,357600,15590,342010,0.956403803131991,-1
9544,9545,Hoodi,93300,46040,47260,0.5065380493033226,0
9545,9546,Malleswaram,277450,50170,227280,0.8191746260587494,-1
9546,9547,Marathahalli,119750,76630,43120,0.36008350730688937,1
9547,9548,Kammanahalli,358600,80650,277950,0.7750976017847183,0
9548,9549,Varthur,344200,114470,229730,0.6674317257408483,0
9549,9550,Krishnarajapuram,350600,36520,314080,0.8958357102110668,-1
9550,9551,Hebbal,205800,24740,181060,0.8797862001943635,-1
9551,9552,Kammanahalli,152950,13130,139820,0.9141549525988886,-1
9552,9553,Horamavu,141950,74610,67340,0.4743923916872138,1
9553,9554,Banaswadi,338200,0,338200,1.0,-1
9554,9555,Varthur,231000,170520,60480,0.26181818181818184,1
9555,9556,Hoodi,54450,113370,-58920,-1.0820936639118457,1
9556,9557,Kammanahalli,95000,84810,10190,0.10726315789473684,1
9557,9558,Marathahalli,259350,52220,207130,0.7986504723346829,0
9558,9559,Banaswadi,77850,17220,60630,0.778805394990366,0
9559,9560,Hebbal,294050,75880,218170,0.7419486481890835,0
9560,9561,Indiranagar,178450,80920,97530,0.5465396469599327,0
9561,9562,Mahadevapura,359500,73260,286240,0.7962169680111265,0
9562,9563,Mahadevapura,364150,102950,261200,0.7172868323493066,0
9563,9564,Kalyan Nagar,212200,40640,171560,0.8084825636192271,-1
9564,9565,Malleswaram,77250,77700,-450,-0.005825242718446602,1
9565,9566,Indiranagar,281400,35260,246140,0.8746979388770434,-1
9566,9567,Marathahalli,225950,19300,206650,0.9145828723168843,-1
9567,9568,HBR Layout,85250,74490,10760,0.12621700879765396,1
9568,9569,Mahadevapura,381300,20610,360690,0.9459480723839496,-1
9569,9570,Hebbal,370300,47210,323090,0.8725087766675669,-1
9570,9571,Hoodi,321200,38920,282280,0.878829389788294,-1
9571,9572,Shivajinagar,373850,92830,281020,0.7516918550220677,0
9572,9573,Vasanth Nagar,195250,44080,151170,0.7742381562099871,0
9573,9574,HBR Layout,376300,77890,298410,0.7930108955620515,0
9574,9575,Kalyan Nagar,358400,54480,303920,0.8479910714285714,-1
9575,9576,Krishnarajapuram,284800,88750,196050,0.688377808988764,0
9576,9577,Marathahalli,262000,16880,245120,0.9355725190839694,-1
9577,9578,Kalyan Nagar,285350,59210,226140,0.7925004380585247,0
9578,9579,Indiranagar,357350,66500,290850,0.8139079333986288,-1
9579,9580,Varthur,218950,73760,145190,0.6631194336606531,0
9580,9581,Vasanth Nagar,26400,36460,-10060,-0.38106060606060604,1
9581,9582,Mahadevapura,333450,75120,258330,0.7747188484030589,0
9582,9583,Indiranagar,302350,10260,292090,0.9660658177608732,-1
9583,9584,Krishnarajapuram,405400,46840,358560,0.8844597927972373,-1
9584,9585,Varthur,323100,4470,318630,0.9861652739090065,-1
9585,9586,Marathahalli,57250,76080,-18830,-0.3289082969432314,1
9586,9587,Kalyan Nagar,219400,55730,163670,0.7459890610756609,0
9587,9588,Indiranagar,81600,66330,15270,0.18713235294117647,1
9588,9589,Banaswadi,298950,92650,206300,0.6900819535039304,0
9589,9590,Mahadevapura,257950,50490,207460,0.8042643923240939,-1
9590,9591,Malleswaram,38400,139070,-100670,-2.6216145833333333,1
9591,9592,Hoodi,61700,120320,-58620,-0.9500810372771474,1
9592,9593,HBR Layout,57000,16530,40470,0.71,0
9593,9594,Indiranagar,345100,64450,280650,0.8132425383946682,-1
9594,9595,Jalahalli,349850,56090,293760,0.8396741460625983,-1
9595,9596,Kalyan Nagar,424200,29740,394460,0.9298915605846299,-1
9596,9597,Hebbal,300850,3920,296930,0.9869702509556257,-1
9597,9598,Malleswaram,91000,96860,-5860,-0.06439560439560439,1
9598,9599,Shivajinagar,332950,149150,183800,0.552034840066076,0
9599,9600,Vasanth Nagar,146200,52980,93220,0.6376196990424077,0
9600,9601,Whitefield,116550,31680,84870,0.7281853281853282,0
9601,9602,Shivajinagar,198450,37770,160680,0.8096749811035525,-1
9602,9603,CV Raman Nagar,178550,112660,65890,0.3690282833940073,1
9603,9604,Banaswadi,279650,22500,257150,0.9195422849991061,-1
9604,9605,Varthur,91400,119740,-28340,-0.3100656455142232,1
9605,9606,Mahadevapura,96750,88870,7880,0.0814470284237726,1
9606,9607,Kalyan Nagar,138100,51540,86560,0.6267921795800144,0
9607,9608,Kammanahalli,251050,7480,243570,0.9702051384186418,-1
9608,9609,HBR Layout,193900,49590,144310,0.7442496132026818,0
9609,9610,Kalyan Nagar,156800,44500,112300,0.7161989795918368,0
9610,9611,Varthur,83150,110290,-27140,-0.3263980757666867,1
9611,9612,Hoodi,366150,13470,352680,0.963211798443261,-1
9612,9613,Marathahalli,211250,42060,169190,0.8008994082840236,-1
9613,9614,Krishnarajapuram,274850,37220,237630,0.8645806803711115,-1
9614,9615,Vasanth Nagar,30850,71980,-41130,-1.33322528363047,1
9615,9616,CV Raman Nagar,59750,83870,-24120,-0.40368200836820084,1
9616,9617,Vasanth Nagar,43600,82820,-39220,-0.8995412844036698,1
9617,9618,Rajajinagar,300850,60830,240020,0.7978062157221206,0
9618,9619,Vasanth Nagar,96750,67130,29620,0.3061498708010336,1
9619,9620,Jalahalli,39850,81480,-41630,-1.044667503136763,1
9620,9621,Jalahalli,147050,39120,107930,0.733968038082285,0
9621,9622,Whitefield,257550,51780,205770,0.7989516598718696,0
9622,9623,Malleswaram,387350,60090,327260,0.8448689815412418,-1
9623,9624,HBR Layout,253250,166210,87040,0.34369200394866734,1
9624,9625,Horamavu,164450,59590,104860,0.6376406202493159,0
9625,9626,Horamavu,31050,87310,-56260,-1.8119162640901771,1
9626,9627,Hebbal,115550,146380,-30830,-0.26681090437040245,1
9627,9628,Marathahalli,302100,5860,296240,0.9806024495200265,-1
9628,9629,Malleswaram,411400,99560,311840,0.757997083130773,0
9629,9630,Krishnarajapuram,431900,56820,375080,0.8684417689279926,-1
9630,9631,Malleswaram,197450,43240,154210,0.78100785008863,0
9631,9632,Indiranagar,434450,68340,366110,0.8426976637127402,-1
9632,9633,Banaswadi,167100,41270,125830,0.7530221424296828,0
9633,9634,Hoodi,427600,105680,321920,0.7528531337698784,0
9634,9635,Kammanahalli,289950,51770,238180,0.8214519744783584,-1
9635,9636,Kammanahalli,164500,88930,75570,0.4593920972644377,1
9636,9637,Kalyan Nagar,41050,39760,1290,0.03142509135200974,1
9637,9638,Kalyan Nagar,228050,68320,159730,0.7004165753124315,0
9638,9639,Rajajinagar,369200,45740,323460,0.8761105092091007,-1
9639,9640,Malleswaram,442550,24410,418140,0.9448423906903175,-1
9640,9641,Indiranagar,319850,57010,262840,0.8217602000937939,-1
9641,9642,Krishnarajapuram,377500,142070,235430,0.6236556291390728,0
9642,9643,Hebbal,111600,3170,108430,0.9715949820788531,-1
9643,9644,Shivajinagar,163700,84500,79200,0.483811850946854,1
9644,9645,Marathahalli,412800,60560,352240,0.8532945736434109,-1
9645,9646,Krishnarajapuram,121900,6660,115240,0.9453650533223954,-1
9646,9647,Horamavu,261800,123190,138610,0.5294499618029029,0
9647,9648,Krishnarajapuram,291300,103130,188170,0.6459663577068314,0
9648,9649,Vasanth Nagar,414900,39840,375060,0.9039768618944324,-1
9649,9650,Kalyan Nagar,229650,51740,177910,0.774700631395602,0
9650,9651,Indiranagar,133950,16860,117090,0.8741321388577827,-1
9651,9652,Malleswaram,131300,40300,91000,0.693069306930693,0
9652,9653,Banaswadi,207350,39150,168200,0.8111888111888111,-1
9653,9654,Malleswaram,93400,110320,-16920,-0.18115631691648823,1
9654,9655,Varthur,410200,79330,330870,0.8066065333983423,-1
9655,9656,Hoodi,53050,90250,-37200,-0.7012252591894439,1
9656,9657,Shivajinagar,27250,63380,-36130,-1.3258715596330275,1
9657,9658,Hoodi,267250,84320,182930,0.684490177736202,0
9658,9659,Rajajinagar,183650,29020,154630,0.8419820310372992,-1
9659,9660,Hoodi,250600,137640,112960,0.4507581803671189,1
9660,9661,Vasanth Nagar,243150,46400,196750,0.8091712934402632,-1
9661,9662,Jalahalli,166050,17790,148260,0.8928635953026197,-1
9662,9663,Hoodi,211650,117140,94510,0.44653909756673754,1
9663,9664,Kalyan Nagar,31900,72690,-40790,-1.2786833855799373,1
9664,9665,HBR Layout,74150,173960,-99810,-1.3460552933243426,1
9665,9666,Horamavu,296750,79850,216900,0.7309182813816344,0
9666,9667,Hoodi,257250,76180,181070,0.7038678328474247,0
9667,9668,Jalahalli,273250,86470,186780,0.6835498627630375,0
9668,9669,Indiranagar,326300,62910,263390,0.8072019613852284,-1
9669,9670,Marathahalli,30250,48920,-18670,-0.617190082644628,1
9670,9671,Kammanahalli,352150,20350,331800,0.9422121255146955,-1
9671,9672,Shivajinagar,78750,100770,-22020,-0.2796190476190476,1
9672,9673,Banaswadi,35700,55850,-20150,-0.5644257703081232,1
9673,9674,Shivajinagar,203200,45370,157830,0.7767224409448819,0
9674,9675,Hoodi,217000,55330,161670,0.7450230414746544,0
9675,9676,Kalyan Nagar,142000,20050,121950,0.8588028169014085,-1
9676,9677,Hebbal,423850,76800,347050,0.8188038221068774,-1
9677,9678,Varthur,258400,56040,202360,0.7831269349845201,0
9678,9679,Marathahalli,283300,54980,228320,0.8059301094246382,-1
9679,9680,Horamavu,28950,77160,-48210,-1.6652849740932643,1
9680,9681,Kammanahalli,40100,51610,-11510,-0.28703241895261844,1
9681,9682,Hebbal,373150,42110,331040,0.8871499397025325,-1
9682,9683,HBR Layout,253850,101680,152170,0.5994484932046484,0
9683,9684,Rajajinagar,105250,68890,36360,0.3454631828978622,1
9684,9685,HBR Layout,388600,47000,341600,0.8790530108080288,-1
9685,9686,Varthur,122250,84210,38040,0.31116564417177917,1
9686,9687,Kammanahalli,25450,141120,-115670,-4.544990176817289,1
9687,9688,Mahadevapura,429500,94700,334800,0.779511059371362,0
9688,9689,Shivajinagar,170150,88650,81500,0.47898912724067,1
9689,9690,Mahadevapura,327100,40730,286370,0.8754815041271782,-1
9690,9691,Marathahalli,398900,51200,347700,0.8716470293306593,-1
9691,9692,Marathahalli,147250,75980,71270,0.4840067911714771,1
9692,9693,Indiranagar,428400,136630,291770,0.6810690943043884,0
9693,9694,Kalyan Nagar,379150,29710,349440,0.9216405116708427,-1
9694,9695,Shivajinagar,301300,124700,176600,0.5861267839362762,0
9695,9696,Whitefield,136200,26360,109840,0.8064610866372981,-1
9696,9697,CV Raman Nagar,55800,96240,-40440,-0.7247311827956989,1
9697,9698,Rajajinagar,68750,84140,-15390,-0.22385454545454544,1
9698,9699,Banaswadi,228100,104300,123800,0.5427444103463394,0
9699,9700,Indiranagar,272900,55930,216970,0.7950531330157566,0
9700,9701,Kammanahalli,339600,27120,312480,0.9201413427561838,-1
9701,9702,HBR Layout,310850,35800,275050,0.8848319124979894,-1
9702,9703,Whitefield,77700,106780,-29080,-0.37425997425997426,1
9703,9704,Vasanth Nagar,116800,110100,6700,0.05736301369863014,1
9704,9705,Banaswadi,212050,1900,210150,0.9910398490921952,-1
9705,9706,Banaswadi,149550,66840,82710,0.5530591775325978,0
9706,9707,Mahadevapura,161050,54120,106930,0.6639552933871469,0
9707,9708,CV Raman Nagar,41300,58600,-17300,-0.4188861985472155,1
9708,9709,Whitefield,93450,44200,49250,0.527019796682718,0
9709,9710,Kammanahalli,33850,18050,15800,0.4667651403249631,1
9710,9711,Whitefield,27250,23480,3770,0.138348623853211,1
9711,9712,Malleswaram,360100,25700,334400,0.9286309358511524,-1
9712,9713,Vasanth Nagar,94150,68360,25790,0.2739245884227297,1
9713,9714,Malleswaram,377750,49410,328340,0.8691992058239576,-1
9714,9715,HBR Layout,383800,35040,348760,0.9087024491922876,-1
9715,9716,Hoodi,98050,13370,84680,0.8636409994900561,-1
9716,9717,Kalyan Nagar,428050,40880,387170,0.9044971381847915,-1
9717,9718,Shivajinagar,109250,30410,78840,0.7216475972540046,0
9718,9719,Whitefield,253250,82510,170740,0.6741954590325765,0
9719,9720,Malleswaram,359050,47580,311470,0.86748363737641,-1
9720,9721,Shivajinagar,395350,37680,357670,0.904692045023397,-1
9721,9722,Hoodi,109550,55280,54270,0.4953902327704245,1
9722,9723,Varthur,363950,81310,282640,0.7765901909602967,0
9723,9724,Whitefield,234350,74730,159620,0.6811179859184979,0
9724,9725,HBR Layout,267850,48940,218910,0.8172857942878476,-1
9725,9726,Rajajinagar,171200,46350,124850,0.7292640186915887,0
9726,9727,Krishnarajapuram,203800,37690,166110,0.8150637880274779,-1
9727,9728,Hoodi,401600,96760,304840,0.7590637450199204,0
9728,9729,Banaswadi,402450,61580,340870,0.8469872033793018,-1
9729,9730,Indiranagar,182950,23890,159060,0.8694178737359934,-1
9730,9731,Mahadevapura,73950,102130,-28180,-0.3810682893847194,1
9731,9732,Whitefield,91250,0,91250,1.0,-1
9732,9733,Jalahalli,299450,78220,221230,0.7387877775922524,0
9733,9734,Marathahalli,127150,95120,32030,0.2519071962249312,1
9734,9735,Malleswaram,152900,69740,83160,0.543884892086331,0
9735,9736,Horamavu,229050,36150,192900,0.842174197773412,-1
9736,9737,Kalyan Nagar,292350,97430,194920,0.6667350778176843,0
9737,9738,Kammanahalli,199150,43440,155710,0.7818729600803415,0
9738,9739,Banaswadi,445450,91430,354020,0.7947468851722976,0
9739,9740,Varthur,346500,68320,278180,0.8028282828282828,-1
9740,9741,Hebbal,252300,50670,201630,0.7991676575505351,0
9741,9742,CV Raman Nagar,62900,28680,34220,0.5440381558028616,0
9742,9743,Malleswaram,300100,79100,221000,0.7364211929356881,0
9743,9744,Whitefield,80500,116200,-35700,-0.4434782608695652,1
9744,9745,Hoodi,340350,37020,303330,0.8912296165711767,-1
9745,9746,Hoodi,213800,62220,151580,0.7089803554724041,0
9746,9747,Banaswadi,142550,101140,41410,0.2904945633111189,1
9747,9748,Jalahalli,344650,77210,267440,0.7759756274481358,0
9748,9749,Jalahalli,142500,65250,77250,0.5421052631578948,0
9749,9750,Rajajinagar,356250,14790,341460,0.9584842105263158,-1
9750,9751,Hoodi,57650,39140,18510,0.3210754553339115,1
9751,9752,Kammanahalli,183100,44470,138630,0.7571272528672857,0
9752,9753,Jalahalli,109400,89970,19430,0.17760511882998173,1
9753,9754,Kalyan Nagar,119400,114330,5070,0.04246231155778894,1
9754,9755,Indiranagar,317700,55690,262010,0.8247088448221592,-1
9755,9756,Kammanahalli,436200,93930,342270,0.7846629986244842,0
9756,9757,Kalyan Nagar,405400,59680,345720,0.8527873704982734,-1
9757,9758,CV Raman Nagar,35850,110400,-74550,-2.079497907949791,1
9758,9759,HBR Layout,421350,96400,324950,0.7712115818203393,0
9759,9760,Varthur,436850,52570,384280,0.8796612109419709,-1
9760,9761,Whitefield,369250,87160,282090,0.7639539607312119,0
9761,9762,Indiranagar,111150,48570,62580,0.5630229419703104,0
9762,9763,Varthur,384350,114440,269910,0.7022505528814882,0
9763,9764,Shivajinagar,322850,97300,225550,0.6986216509214805,0
9764,9765,Rajajinagar,250350,100320,150030,0.5992810065907729,0
9765,9766,Marathahalli,226500,24410,202090,0.8922295805739514,-1
9766,9767,Mahadevapura,431400,52260,379140,0.8788595271210013,-1
9767,9768,Krishnarajapuram,262650,80740,181910,0.692594707786027,0
9768,9769,Horamavu,310950,106510,204440,0.6574690464704936,0
9769,9770,Varthur,123700,43770,79930,0.646160064672595,0
9770,9771,CV Raman Nagar,406700,71410,335290,0.82441603147283,-1
9771,9772,Hebbal,77850,33300,44550,0.5722543352601156,0
9772,9773,CV Raman Nagar,190400,19170,171230,0.8993172268907563,-1
9773,9774,Rajajinagar,423500,12460,411040,0.9705785123966942,-1
9774,9775,Kammanahalli,336300,86870,249430,0.7416889681831698,0
9775,9776,Banaswadi,406500,43490,363010,0.8930135301353014,-1
9776,9777,Hoodi,311300,109380,201920,0.6486347574686797,0
9777,9778,CV Raman Nagar,116250,33900,82350,0.7083870967741935,0
9778,9779,Kammanahalli,49900,59890,-9990,-0.2002004008016032,1
9779,9780,HBR Layout,269850,67720,202130,0.7490457661663887,0
9780,9781,Krishnarajapuram,246750,93350,153400,0.6216818642350557,0
9781,9782,Vasanth Nagar,27650,96260,-68610,-2.481374321880651,1
9782,9783,CV Raman Nagar,171750,59140,112610,0.6556622998544396,0
9783,9784,Banaswadi,331750,66180,265570,0.8005124340617935,-1
9784,9785,Kammanahalli,85400,78870,6530,0.07646370023419204,1
9785,9786,Malleswaram,245050,100730,144320,0.5889410324423587,0
9786,9787,Kammanahalli,145500,28270,117230,0.8057044673539518,-1
9787,9788,Banaswadi,66450,58880,7570,0.11392024078254327,1
9788,9789,Shivajinagar,238450,31790,206660,0.8666806458377019,-1
9789,9790,Malleswaram,100850,80030,20820,0.20644521566683194,1
9790,9791,Banaswadi,192800,66990,125810,0.6525414937759336,0
9791,9792,Hoodi,321300,72420,248880,0.7746031746031746,0
9792,9793,Hebbal,372750,121590,251160,0.6738028169014084,0
9793,9794,Malleswaram,380500,129330,251170,0.6601051248357425,0
9794,9795,Horamavu,90500,80910,9590,0.10596685082872928,1
9795,9796,Banaswadi,167650,30570,137080,0.8176558305994631,-1
9796,9797,Hebbal,354450,23450,331000,0.9338411623642263,-1
9797,9798,Horamavu,100700,43020,57680,0.5727904667328699,0
9798,9799,Kammanahalli,256550,49230,207320,0.8081075813681543,-1
9799,9800,Banaswadi,172450,3940,168510,0.9771527979124384,-1
9800,9801,Malleswaram,420450,109700,310750,0.7390890712332026,0
9801,9802,Hoodi,418050,28630,389420,0.931515368975003,-1
9802,9803,Shivajinagar,305200,99960,205240,0.6724770642201835,0
9803,9804,Krishnarajapuram,126650,103380,23270,0.18373470193446506,1
9804,9805,Varthur,281850,57480,224370,0.7960617349654071,0
9805,9806,Rajajinagar,219400,29500,189900,0.8655423883318141,-1
9806,9807,Varthur,251600,64350,187250,0.7442368839427663,0
9807,9808,Hoodi,198050,56360,141690,0.7154253976268619,0
9808,9809,Kammanahalli,294150,10870,283280,0.9630460649328574,-1
9809,9810,Shivajinagar,132350,48840,83510,0.6309784661881375,0
9810,9811,Rajajinagar,380500,24160,356340,0.9365045992115637,-1
9811,9812,Krishnarajapuram,345950,49960,295990,0.8555860673507732,-1
9812,9813,Kammanahalli,372000,40950,331050,0.8899193548387097,-1
9813,9814,CV Raman Nagar,443800,66950,376850,0.8491437584497521,-1
9814,9815,Hebbal,78550,29960,48590,0.618586887332909,0
9815,9816,Krishnarajapuram,248050,71170,176880,0.7130820399113083,0
9816,9817,Jalahalli,447050,140740,306310,0.6851806285650375,0
9817,9818,Shivajinagar,389000,35320,353680,0.9092030848329049,-1
9818,9819,CV Raman Nagar,104250,51940,52310,0.5017745803357314,0
9819,9820,Hebbal,89500,32420,57080,0.6377653631284916,0
9820,9821,Krishnarajapuram,353700,104980,248720,0.7031947978512864,0
9821,9822,Mahadevapura,99850,40690,59160,0.5924887330996494,0
9822,9823,Mahadevapura,369250,115440,253810,0.6873662830060935,0
9823,9824,HBR Layout,64050,55710,8340,0.13021077283372365,1
9824,9825,Banaswadi,200650,45430,155220,0.7735858460004984,0
9825,9826,Shivajinagar,237900,34890,203010,0.8533417402269862,-1
9826,9827,Horamavu,388550,87180,301370,0.7756273323896539,0
9827,9828,Vasanth Nagar,153600,99330,54270,0.3533203125,1
9828,9829,Shivajinagar,373100,61510,311590,0.8351380326990083,-1
9829,9830,Kalyan Nagar,403200,47080,356120,0.883234126984127,-1
9830,9831,CV Raman Nagar,202600,45990,156610,0.7730009871668312,0
9831,9832,Horamavu,175400,6180,169220,0.9647662485746864,-1
9832,9833,Mahadevapura,369800,36150,333650,0.9022444564629529,-1
9833,9834,Hoodi,204050,12410,191640,0.9391815731438373,-1
9834,9835,HBR Layout,397100,24400,372700,0.9385545202719718,-1
9835,9836,Banaswadi,45450,38140,7310,0.16083608360836082,1
9836,9837,Krishnarajapuram,404000,149340,254660,0.6303465346534654,0
9837,9838,Rajajinagar,427900,13340,414560,0.9688244917036691,-1
9838,9839,Varthur,39350,33470,5880,0.149428208386277,1
9839,9840,Krishnarajapuram,441500,57190,384310,0.8704643261608154,-1
9840,9841,Banaswadi,96000,42880,53120,0.5533333333333333,0
9841,9842,Horamavu,447500,78730,368770,0.8240670391061452,-1
9842,9843,Hebbal,131750,139200,-7450,-0.056546489563567365,1
9843,9844,Kalyan Nagar,383350,21680,361670,0.9434459371331682,-1
9844,9845,Malleswaram,131750,36450,95300,0.7233396584440228,0
9845,9846,Marathahalli,120550,47410,73140,0.6067192036499378,0
9846,9847,Whitefield,402300,25870,376430,0.9356947551578424,-1
9847,9848,Vasanth Nagar,417900,39850,378050,0.9046422589136157,-1
9848,9849,Krishnarajapuram,448150,55410,392740,0.8763583621555283,-1
9849,9850,Varthur,161550,132860,28690,0.17759207675642216,1
9850,9851,Kalyan Nagar,246000,93500,152500,0.6199186991869918,0
9851,9852,Malleswaram,158850,81120,77730,0.4893295561850803,1
9852,9853,Varthur,405300,86630,318670,0.7862570935109795,0
9853,9854,Indiranagar,441550,65740,375810,0.8511153889706715,-1
9854,9855,Kammanahalli,210250,36260,173990,0.827538644470868,-1
9855,9856,Marathahalli,253100,62070,191030,0.7547609640458317,0
9856,9857,Kammanahalli,445500,72050,373450,0.8382716049382716,-1
9857,9858,Hoodi,355650,23420,332230,0.9341487417404752,-1
9858,9859,Rajajinagar,79850,88810,-8960,-0.11221039448966813,1
9859,9860,Mahadevapura,419500,45580,373920,0.89134684147795,-1
9860,9861,Hoodi,95550,89470,6080,0.06363160648874934,1
9861,9862,Malleswaram,329850,51770,278080,0.8430498711535547,-1
9862,9863,Marathahalli,236400,58410,177990,0.7529187817258883,0
9863,9864,Indiranagar,169900,40610,129290,0.7609770453207769,0
9864,9865,HBR Layout,32650,17430,15220,0.466156202143951,1
9865,9866,Banaswadi,194350,58300,136050,0.7000257267815796,0
9866,9867,Hoodi,290350,47930,242420,0.8349233683485449,-1
9867,9868,Vasanth Nagar,66550,54670,11880,0.17851239669421487,1
9868,9869,Malleswaram,218150,96170,121980,0.5591565436626175,0
9869,9870,Marathahalli,436450,31770,404680,0.9272081567189827,-1
9870,9871,HBR Layout,440000,37990,402010,0.9136590909090909,-1
9871,9872,Kalyan Nagar,329600,69310,260290,0.7897148058252427,0
9872,9873,Shivajinagar,265900,70710,195190,0.734072959759308,0
9873,9874,Hebbal,263900,74910,188990,0.7161424782114437,0
9874,9875,Vasanth Nagar,34650,76750,-42100,-1.215007215007215,1
9875,9876,Hebbal,291850,124470,167380,0.5735137913311633,0
9876,9877,Rajajinagar,66950,73060,-6110,-0.0912621359223301,1
9877,9878,Hebbal,286800,82610,204190,0.7119595536959553,0
9878,9879,HBR Layout,119550,33930,85620,0.7161856963613551,0
9879,9880,Kalyan Nagar,32300,36550,-4250,-0.13157894736842105,1
9880,9881,Banaswadi,370650,77370,293280,0.7912585997571834,0
9881,9882,Marathahalli,327250,92070,235180,0.718655462184874,0
9882,9883,Krishnarajapuram,202250,99310,102940,0.5089740420271941,0
9883,9884,Krishnarajapuram,147500,49990,97510,0.6610847457627118,0
9884,9885,Vasanth Nagar,299250,27470,271780,0.908203842940685,-1
9885,9886,Banaswadi,394500,34300,360200,0.9130544993662865,-1
9886,9887,Banaswadi,115550,53040,62510,0.5409779316313285,0
9887,9888,Shivajinagar,174400,57970,116430,0.6676032110091743,0
9888,9889,Mahadevapura,378250,68010,310240,0.8201982815598149,-1
9889,9890,Indiranagar,205050,45060,159990,0.7802487198244331,0
9890,9891,Whitefield,442350,70520,371830,0.8405787272521759,-1
9891,9892,Rajajinagar,357050,36950,320100,0.8965130934042851,-1
9892,9893,Mahadevapura,164500,75420,89080,0.5415197568389057,0
9893,9894,Hebbal,126500,36340,90160,0.7127272727272728,0
9894,9895,Hebbal,255750,94890,160860,0.6289736070381232,0
9895,9896,Jalahalli,382900,67690,315210,0.823217550274223,-1
9896,9897,Shivajinagar,165550,87140,78410,0.4736333434007853,1
9897,9898,Varthur,282300,23580,258720,0.916471838469713,-1
9898,9899,Kammanahalli,162400,22850,139550,0.8592980295566502,-1
9899,9900,Indiranagar,362850,28490,334360,0.9214827063524873,-1
9900,9901,Varthur,215200,83050,132150,0.6140799256505576,0
9901,9902,Indiranagar,64100,75790,-11690,-0.18237129485179407,1
9902,9903,Mahadevapura,220150,69640,150510,0.6836702248466955,0
9903,9904,Malleswaram,63050,16790,46260,0.7337034099920697,0
9904,9905,Kammanahalli,143300,51110,92190,0.6433356594556874,0
9905,9906,Marathahalli,364550,52790,311760,0.8551913317789055,-1
9906,9907,Indiranagar,310800,78220,232580,0.7483268983268984,0
9907,9908,Indiranagar,285350,100610,184740,0.6474154547047486,0
9908,9909,Horamavu,358650,82050,276600,0.7712254286909243,0
9909,9910,Kalyan Nagar,421100,68320,352780,0.8377582521966279,-1
9910,9911,CV Raman Nagar,306600,53570,253030,0.8252772341813438,-1
9911,9912,Shivajinagar,334400,173450,160950,0.4813098086124402,1
9912,9913,Malleswaram,267400,14790,252610,0.9446896035901271,-1
9913,9914,Whitefield,392750,71540,321210,0.817848504137492,-1
9914,9915,CV Raman Nagar,105550,87750,17800,0.16864045476077688,1
9915,9916,Rajajinagar,198100,76220,121880,0.6152448258455325,0
9916,9917,Varthur,37350,61200,-23850,-0.6385542168674698,1
9917,9918,Horamavu,316050,69940,246110,0.7787059009650372,0
9918,9919,Jalahalli,382050,126390,255660,0.6691794267765999,0
9919,9920,Varthur,190000,86980,103020,0.5422105263157895,0
9920,9921,Vasanth Nagar,91500,35990,55510,0.6066666666666667,0
9921,9922,Shivajinagar,263800,56600,207200,0.7854435178165277,0
9922,9923,Malleswaram,61700,16480,45220,0.7329011345218801,0
9923,9924,Kalyan Nagar,66350,49850,16500,0.24868123587038432,1
9924,9925,Jalahalli,154650,46420,108230,0.6998383446492079,0
9925,9926,Indiranagar,137050,63710,73340,0.5351331630791681,0
9926,9927,Kammanahalli,57200,6520,50680,0.8860139860139861,-1
9927,9928,Vasanth Nagar,186750,38100,148650,0.7959839357429719,0
9928,9929,Horamavu,77000,21680,55320,0.7184415584415584,0
9929,9930,Horamavu,81000,85340,-4340,-0.053580246913580244,1
9930,9931,Krishnarajapuram,172450,85250,87200,0.5056538126993332,0
9931,9932,HBR Layout,161100,80340,80760,0.5013035381750466,0
9932,9933,Hoodi,130600,83020,47580,0.36431852986217456,1
9933,9934,Malleswaram,83100,41020,42080,0.5063778580024068,0
9934,9935,Krishnarajapuram,65650,36760,28890,0.4400609291698401,1
9935,9936,Marathahalli,396500,87150,309350,0.7802017654476671,0
9936,9937,Krishnarajapuram,86150,42440,43710,0.5073708647707487,0
9937,9938,Horamavu,196350,51910,144440,0.7356251591545709,0
9938,9939,Hebbal,44150,42710,1440,0.03261608154020385,1
9939,9940,Horamavu,76900,42450,34450,0.4479843953185956,1
9940,9941,Mahadevapura,152900,29350,123550,0.8080444735120994,-1
9941,9942,Banaswadi,166800,71590,95210,0.5708033573141487,0
9942,9943,CV Raman Nagar,436250,75710,360540,0.8264527220630372,-1
9943,9944,CV Raman Nagar,341050,86160,254890,0.7473684210526316,0
9944,9945,Horamavu,174350,77540,96810,0.55526240321193,0
9945,9946,Indiranagar,337600,31980,305620,0.9052725118483412,-1
9946,9947,HBR Layout,282100,86380,195720,0.6937965260545905,0
9947,9948,Banaswadi,356700,19620,337080,0.9449957947855341,-1
9948,9949,Varthur,263750,97250,166500,0.6312796208530805,0
9949,9950,Krishnarajapuram,145000,64910,80090,0.5523448275862068,0
9950,9951,Krishnarajapuram,220700,56400,164300,0.7444494789306751,0
9951,9952,HBR Layout,265500,29650,235850,0.8883239171374765,-1
9952,9953,Marathahalli,358050,15440,342610,0.9568775310710794,-1
9953,9954,Vasanth Nagar,245150,59270,185880,0.7582296553130736,0
9954,9955,Shivajinagar,242550,69770,172780,0.7123479694908267,0
9955,9956,Rajajinagar,361150,47250,313900,0.8691679357607642,-1
9956,9957,Shivajinagar,287800,66370,221430,0.7693884642112578,0
9957,9958,Shivajinagar,289450,3890,285560,0.9865607186042494,-1
9958,9959,Vasanth Nagar,368400,36590,331810,0.9006786102062975,-1
9959,9960,Whitefield,402100,59260,342840,0.8526237254414325,-1
9960,9961,Rajajinagar,327250,76980,250270,0.7647669977081741,0
9961,9962,Shivajinagar,386650,66140,320510,0.8289409026251131,-1
9962,9963,Kammanahalli,155200,40040,115160,0.7420103092783505,0
9963,9964,Banaswadi,158350,83400,74950,0.47331859804231136,1
9964,9965,Malleswaram,116950,67150,49800,0.4258230012825994,1
9965,9966,Vasanth Nagar,44000,115940,-71940,-1.635,1
9966,9967,Rajajinagar,220750,70240,150510,0.6818120045300113,0
9967,9968,Horamavu,350800,83270,267530,0.7626282782212087,0
9968,9969,Horamavu,184600,48770,135830,0.735807150595883,0
9969,9970,Krishnarajapuram,416500,90770,325730,0.7820648259303722,0
9970,9971,Rajajinagar,64050,71180,-7130,-0.1113192818110851,1
9971,9972,Vasanth Nagar,114800,34510,80290,0.699390243902439,0
9972,9973,Malleswaram,145500,86970,58530,0.4022680412371134,1
9973,9974,Vasanth Nagar,245250,26200,219050,0.8931702344546382,-1
9974,9975,Rajajinagar,348550,56540,292010,0.8377851097403529,-1
9975,9976,Indiranagar,273900,47950,225950,0.8249361080686382,-1
9976,9977,Rajajinagar,109150,122910,-13760,-0.1260650480989464,1
9977,9978,Marathahalli,77800,67550,10250,0.13174807197943444,1
9978,9979,Hoodi,33850,69310,-35460,-1.047562776957164,1
9979,9980,Hebbal,183750,67780,115970,0.6311292517006802,0
9980,9981,Kalyan Nagar,440900,48640,392260,0.8896801995917442,-1
9981,9982,Marathahalli,199350,27640,171710,0.8613493855028844,-1
9982,9983,HBR Layout,209300,71570,137730,0.6580506450071667,0
9983,9984,Hebbal,259000,42240,216760,0.8369111969111969,-1
9984,9985,Hebbal,345950,169610,176340,0.5097268391386038,0
9985,9986,Varthur,281250,35810,245440,0.8726755555555555,-1
9986,9987,Shivajinagar,381900,87770,294130,0.7701754385964912,0
9987,9988,Hoodi,125350,79280,46070,0.3675309134423614,1
9988,9989,Varthur,327100,35160,291940,0.8925099357994497,-1
9989,9990,Hebbal,438300,91110,347190,0.7921286789869952,0
9990,9991,Rajajinagar,343750,67980,275770,0.80224,-1
9991,9992,Varthur,186000,81780,104220,0.5603225806451613,0
9992,9993,Rajajinagar,32150,5310,26840,0.8348367029548989,-1
9993,9994,Hebbal,163750,78480,85270,0.5207328244274809,0
9994,9995,Rajajinagar,78550,60640,17910,0.22800763844684915,1
9995,9996,Vasanth Nagar,342850,77650,265200,0.7735161149190608,0
9996,9997,Jalahalli,179350,36160,143190,0.7983830499024255,0
9997,9998,Hebbal,380300,63680,316620,0.8325532474362346,-1
9998,9999,Shivajinagar,404900,43960,360940,0.8914299827117806,-1
9999,10000,Vasanth Nagar,192050,0,192050,1.0,-1
