,atm_id,location,s_amt,w_amt,bal,ration,action
0,1,Hoodi,154050,55450,98600,0.6400519311911717,0
1,2,Kalyan Nagar,73000,6880,66120,0.9057534246575343,-1
2,3,Whitefield,280400,54860,225540,0.8043509272467902,-1
3,4,Hebbal,315950,59970,255980,0.8101914859946194,-1
4,5,Varthur,237450,32290,205160,0.864013476521373,0
5,6,Kalyan Nagar,111750,46600,65150,0.5829977628635347,0
6,7,Vasanth Nagar,335300,106460,228840,0.6824932895914106,0
7,8,Hebbal,252400,40690,211710,0.8387876386687797,-1
8,9,Indiranagar,441100,25530,415570,0.9421219678077534,-1
9,10,Varthur,229300,61250,168050,0.7328826864369821,-1
10,11,Indiranagar,47550,96010,-48460,-1.0191377497371188,1
11,12,Malleswaram,30350,132930,-102580,-3.3799011532125207,1
12,13,Hoodi,198150,90430,107720,0.543628564219026,0
13,14,Jalahalli,119300,127970,-8670,-0.07267393126571668,1
14,15,Hoodi,204950,19370,185580,0.9054891436935838,-1
15,16,Rajajinagar,405150,109840,295310,0.7288905343699864,0
16,17,Hoodi,172300,96350,75950,0.4408009286128845,0
17,18,Hebbal,45750,59190,-13440,-0.2937704918032787,1
18,19,Horamavu,340450,62750,277700,0.8156851226318108,0
19,20,Malleswaram,394850,53060,341790,0.8656198556413828,-1
20,21,Jalahalli,447000,9950,437050,0.9777404921700223,-1
21,22,Indiranagar,349200,46370,302830,0.8672107674684995,0
22,23,Mahadevapura,438450,62360,376090,0.8577716957463792,-1
23,24,Mahadevapura,327500,66280,261220,0.797618320610687,-1
24,25,Indiranagar,442000,105030,336970,0.7623755656108597,-1
25,26,Hoodi,352000,145450,206550,0.5867897727272727,1
26,27,Whitefield,98950,114090,-15140,-0.1530065689742294,1
27,28,Horamavu,171750,64740,107010,0.623056768558952,0
28,29,Shivajinagar,396550,32310,364240,0.9185222544445846,-1
29,30,Kalyan Nagar,192400,34390,158010,0.8212577962577963,0
30,31,Marathahalli,91450,29620,61830,0.6761071623838163,0
31,32,Varthur,218100,9050,209050,0.9585052728106374,-1
32,33,Horamavu,195850,41520,154330,0.788001021189686,-1
33,34,HBR Layout,379850,89480,290370,0.7644333289456364,0
34,35,Banaswadi,449100,25790,423310,0.9425740369628145,-1
35,36,Banaswadi,279450,118880,160570,0.5745929504383611,0
36,37,Horamavu,418850,45330,373520,0.8917750984839441,0
37,38,Whitefield,447050,27090,419960,0.9394027513700929,-1
38,39,Banaswadi,141150,71090,70060,0.4963513992206872,0
39,40,Krishnarajapuram,170300,87060,83240,0.4887844979448033,1
40,41,Mahadevapura,235300,67840,167460,0.7116872078198045,-1
41,42,HBR Layout,37450,50180,-12730,-0.33991989319092125,1
42,43,Marathahalli,147900,50400,97500,0.6592292089249493,0
43,44,Banaswadi,358400,133260,225140,0.6281808035714286,0
44,45,Shivajinagar,259350,83090,176260,0.6796221322537112,0
45,46,HBR Layout,415700,21660,394040,0.9478951166706759,-1
46,47,Hoodi,49200,85060,-35860,-0.7288617886178862,1
47,48,Jalahalli,121350,31370,89980,0.7414915533580552,0
48,49,Hebbal,351650,30250,321400,0.9139769657329732,-1
49,50,Vasanth Nagar,38700,63550,-24850,-0.6421188630490956,1
50,51,Whitefield,120300,32880,87420,0.7266832917705736,0
51,52,Kammanahalli,383650,104550,279100,0.7274859898344845,0
52,53,Horamavu,221650,31910,189740,0.8560342882923528,-1
53,54,Varthur,174050,51000,123050,0.7069807526572824,-1
54,55,Kammanahalli,413600,33750,379850,0.9183994197292069,-1
55,56,Jalahalli,225050,51260,173790,0.7722283936902911,-1
56,57,Rajajinagar,116700,16190,100510,0.8612682090831191,-1
57,58,CV Raman Nagar,89250,35880,53370,0.597983193277311,0
58,59,Shivajinagar,294200,77500,216700,0.7365737593473828,0
59,60,Shivajinagar,118150,70520,47630,0.4031316123571731,1
60,61,Marathahalli,165250,36130,129120,0.7813615733736763,-1
61,62,Hebbal,54000,21290,32710,0.6057407407407407,0
62,63,Hebbal,316050,55900,260150,0.8231292517006803,0
63,64,Banaswadi,68350,64700,3650,0.053401609363569864,1
64,65,Horamavu,343650,76630,267020,0.7770114942528735,0
65,66,Malleswaram,87250,57430,29820,0.3417765042979943,1
66,67,Hoodi,90450,103060,-12610,-0.13941404090657822,1
67,68,Hebbal,366300,66090,300210,0.8195741195741195,0
68,69,Hoodi,424800,78180,346620,0.8159604519774011,-1
69,70,Rajajinagar,327650,65080,262570,0.8013734167556844,-1
70,71,CV Raman Nagar,231050,83710,147340,0.6376974680805021,0
71,72,Kalyan Nagar,445550,15850,429700,0.9644259903490069,-1
72,73,Varthur,392100,105950,286150,0.7297883193062994,-1
73,74,HBR Layout,215150,82090,133060,0.618452242621427,0
74,75,Jalahalli,393550,62480,331070,0.8412399949180536,-1
75,76,HBR Layout,404900,142070,262830,0.6491232403062485,0
76,77,Varthur,286650,21360,265290,0.925484039769754,-1
77,78,Vasanth Nagar,312050,37860,274190,0.8786732895369331,-1
78,79,Hoodi,188650,154860,33790,0.17911476278823218,1
79,80,Hoodi,346750,62860,283890,0.8187166546503244,-1
80,81,Malleswaram,134900,38220,96680,0.7166790214974055,0
81,82,Marathahalli,324450,8460,315990,0.9739251040221913,-1
82,83,Hebbal,435350,94690,340660,0.7824968416216836,-1
83,84,Krishnarajapuram,445050,73790,371260,0.8341984046736322,0
84,85,Kammanahalli,223850,97380,126470,0.5649765467947286,0
85,86,CV Raman Nagar,242700,46950,195750,0.8065512978986403,0
86,87,Jalahalli,262700,133420,129280,0.4921202893033879,0
87,88,Whitefield,240100,65010,175090,0.72923781757601,0
88,89,Jalahalli,399250,28930,370320,0.9275391358797745,-1
89,90,Indiranagar,126550,32560,93990,0.7427103911497431,-1
90,91,Kalyan Nagar,61550,65520,-3970,-0.06450040617384241,1
91,92,Shivajinagar,318200,46950,271250,0.8524512884978002,0
92,93,Whitefield,371650,143670,227980,0.6134266110587919,0
93,94,Rajajinagar,368050,68440,299610,0.8140470044830865,-1
94,95,Vasanth Nagar,395900,32610,363290,0.9176307148269766,-1
95,96,Hebbal,100350,60470,39880,0.3974090682610862,1
96,97,Kammanahalli,33000,67840,-34840,-1.0557575757575757,1
97,98,Indiranagar,144650,41340,103310,0.7142067058416869,0
98,99,Horamavu,260400,51960,208440,0.8004608294930876,0
99,100,Kalyan Nagar,212800,93960,118840,0.5584586466165413,1
100,101,Marathahalli,74050,74320,-270,-0.0036461850101282916,1
101,102,Horamavu,101750,90920,10830,0.10643734643734644,1
102,103,Hoodi,190450,58130,132320,0.6947755316355999,0
103,104,Whitefield,104250,40520,63730,0.6113189448441247,0
104,105,Kammanahalli,176050,9120,166930,0.9481965350752627,-1
105,106,Hoodi,305750,92490,213260,0.6974979558462796,0
106,107,Vasanth Nagar,391700,64450,327250,0.8354608118458003,0
107,108,Banaswadi,89000,32980,56020,0.629438202247191,0
108,109,Rajajinagar,281100,127810,153290,0.5453219494841693,0
109,110,Varthur,373250,65830,307420,0.8236302746148694,-1
110,111,Jalahalli,35950,79140,-43190,-1.2013908205841446,1
111,112,Marathahalli,411750,4540,407210,0.9889738919247116,-1
112,113,Mahadevapura,198600,43040,155560,0.7832829808660624,-1
113,114,Whitefield,270650,107690,162960,0.6021060410123776,0
114,115,Whitefield,287700,73660,214040,0.7439694125825512,0
115,116,HBR Layout,174550,44840,129710,0.7431108564881123,0
116,117,Horamavu,325300,20210,305090,0.9378727328619736,-1
117,118,Marathahalli,430850,34340,396510,0.9202970871533016,-1
118,119,Indiranagar,129750,0,129750,1.0,-1
119,120,Malleswaram,359050,74320,284730,0.7930093301768556,0
120,121,HBR Layout,295050,71120,223930,0.7589561091340451,0
121,122,Shivajinagar,240350,42490,197860,0.8232161431246099,0
122,123,Horamavu,444950,68390,376560,0.8462973367794134,-1
123,124,Kalyan Nagar,74750,88610,-13860,-0.1854180602006689,1
124,125,Kammanahalli,253500,82820,170680,0.6732938856015779,0
125,126,Rajajinagar,283400,124280,159120,0.5614678899082569,0
126,127,Marathahalli,132450,41200,91250,0.6889392223480558,0
127,128,Rajajinagar,239250,82140,157110,0.6566771159874608,0
128,129,Banaswadi,185700,56680,129020,0.694776521270867,0
129,130,Varthur,66850,29320,37530,0.5614061331338819,0
130,131,Whitefield,204500,65450,139050,0.6799511002444988,0
131,132,Malleswaram,288200,67070,221130,0.7672796668979875,0
132,133,HBR Layout,38750,45210,-6460,-0.16670967741935483,1
133,134,Marathahalli,184100,60230,123870,0.6728408473655622,0
134,135,Mahadevapura,331700,49660,282040,0.850286403376545,-1
135,136,Malleswaram,55350,31800,23550,0.4254742547425474,0
136,137,Banaswadi,308700,39750,268950,0.8712342079689018,0
137,138,Vasanth Nagar,254800,107180,147620,0.5793563579277865,0
138,139,CV Raman Nagar,151400,61570,89830,0.59332892998679,0
139,140,Malleswaram,362600,93700,268900,0.741588527302813,0
140,141,Banaswadi,29950,56060,-26110,-0.8717863105175292,1
141,142,Whitefield,111450,24210,87240,0.7827725437415881,0
142,143,Kalyan Nagar,267700,17250,250450,0.9355621964886066,-1
143,144,Kammanahalli,229200,118730,110470,0.48198080279232114,1
144,145,Kalyan Nagar,62900,126750,-63850,-1.0151033386327504,1
145,146,Mahadevapura,327650,93690,233960,0.7140546314665039,0
146,147,Marathahalli,366400,16800,349600,0.9541484716157205,-1
147,148,Indiranagar,361650,83590,278060,0.7688649246509056,0
148,149,Vasanth Nagar,379100,38960,340140,0.8972302822474281,-1
149,150,Kammanahalli,119900,74610,45290,0.3777314428690575,1
150,151,Malleswaram,93200,105440,-12240,-0.1313304721030043,1
151,152,Kammanahalli,26900,90710,-63810,-2.372118959107807,1
152,153,HBR Layout,404050,58050,346000,0.8563296621705234,0
153,154,HBR Layout,321750,36170,285580,0.8875835275835275,-1
154,155,Horamavu,198700,61770,136930,0.6891293407146452,0
155,156,Shivajinagar,232600,14200,218400,0.938950988822012,-1
156,157,Mahadevapura,162450,80400,82050,0.5050784856879039,0
157,158,HBR Layout,138250,102810,35440,0.2563471971066908,1
158,159,Varthur,190050,60380,129670,0.6822941331228624,0
159,160,Mahadevapura,270800,68970,201830,0.7453101920236337,-1
160,161,Banaswadi,353650,78340,275310,0.7784815495546444,0
161,162,Indiranagar,58700,25110,33590,0.5722316865417376,0
162,163,Kammanahalli,48950,46970,1980,0.04044943820224719,1
163,164,Hoodi,268000,44740,223260,0.8330597014925373,-1
164,165,Rajajinagar,416350,52360,363990,0.8742404227212681,-1
165,166,Malleswaram,237650,52660,184990,0.778413633494635,-1
166,167,CV Raman Nagar,42850,87100,-44250,-1.0326721120186697,1
167,168,Rajajinagar,224050,61580,162470,0.7251506360187459,0
168,169,Vasanth Nagar,167300,102850,64450,0.3852361028093246,1
169,170,Hoodi,439200,41830,397370,0.9047586520947176,-1
170,171,Jalahalli,31550,70540,-38990,-1.2358161648177497,1
171,172,CV Raman Nagar,341900,150880,191020,0.5587013746709564,0
172,173,Whitefield,363700,63410,300290,0.8256530107231235,-1
173,174,Varthur,406600,29120,377480,0.9283817019183472,-1
174,175,Indiranagar,199900,93280,106620,0.5333666833416708,0
175,176,Krishnarajapuram,349950,21020,328930,0.9399342763251893,-1
176,177,Kammanahalli,26950,24780,2170,0.08051948051948052,1
177,178,Marathahalli,98750,44610,54140,0.548253164556962,1
178,179,Whitefield,322400,23160,299240,0.9281637717121588,-1
179,180,Hoodi,93100,20090,73010,0.7842105263157895,-1
180,181,Indiranagar,89900,58280,31620,0.35172413793103446,1
181,182,Vasanth Nagar,270400,123070,147330,0.5448594674556213,1
182,183,Shivajinagar,277650,67190,210460,0.7580046821537908,0
183,184,Horamavu,379500,92490,287010,0.7562845849802372,-1
184,185,Shivajinagar,357450,76360,281090,0.7863757168834802,-1
185,186,Whitefield,271800,15120,256680,0.9443708609271523,-1
186,187,Hebbal,106350,106180,170,0.0015984955336154209,1
187,188,Malleswaram,303150,104520,198630,0.6552201880257298,0
188,189,Jalahalli,62000,48370,13630,0.21983870967741936,1
189,190,Marathahalli,413050,67530,345520,0.8365088972279385,-1
190,191,Malleswaram,285400,48920,236480,0.8285914505956552,-1
191,192,Varthur,436300,83350,352950,0.8089617235846894,0
192,193,Hebbal,109450,33740,75710,0.6917313841936957,0
193,194,Indiranagar,325950,139660,186290,0.5715293756711152,0
194,195,Kalyan Nagar,172650,36670,135980,0.7876049811757891,0
195,196,Hoodi,50400,41540,8860,0.1757936507936508,1
196,197,Varthur,64200,127190,-62990,-0.9811526479750778,1
197,198,CV Raman Nagar,38450,60960,-22510,-0.5854356306892068,1
198,199,Indiranagar,184850,41900,142950,0.773329726805518,-1
199,200,HBR Layout,120600,10500,110100,0.9129353233830846,-1
200,201,Shivajinagar,239650,75650,164000,0.6843313165032339,0
201,202,Whitefield,304500,40810,263690,0.8659770114942529,-1
202,203,Varthur,138600,50230,88370,0.6375901875901876,0
203,204,Horamavu,179900,22870,157030,0.8728738187882157,-1
204,205,Shivajinagar,70750,107770,-37020,-0.5232508833922261,1
205,206,Vasanth Nagar,186400,104680,81720,0.438412017167382,0
206,207,Hebbal,265500,63590,201910,0.7604896421845574,0
207,208,Kammanahalli,449750,107630,342120,0.7606892718176765,0
208,209,Vasanth Nagar,244200,57930,186270,0.7627764127764127,0
209,210,Jalahalli,296150,55480,240670,0.812662502110417,0
210,211,Hoodi,140350,14800,125550,0.8945493409333808,0
211,212,Mahadevapura,137500,90850,46650,0.3392727272727273,1
212,213,Mahadevapura,372150,47620,324530,0.8720408437458014,-1
213,214,Vasanth Nagar,33000,76060,-43060,-1.304848484848485,1
214,215,Hoodi,347450,113470,233980,0.6734206360627428,0
215,216,Kammanahalli,138450,78220,60230,0.435030697002528,0
216,217,Rajajinagar,263450,102410,161040,0.6112734864300626,0
217,218,Rajajinagar,279750,39980,239770,0.8570866845397677,-1
218,219,Whitefield,360600,46950,313650,0.8698003327787022,-1
219,220,Krishnarajapuram,285500,45650,239850,0.8401050788091068,-1
220,221,Varthur,108100,78340,29760,0.27530064754856615,1
221,222,Rajajinagar,116300,62130,54170,0.46577815993121235,1
222,223,Mahadevapura,103400,45700,57700,0.558027079303675,0
223,224,Horamavu,197600,52970,144630,0.7319331983805668,0
224,225,CV Raman Nagar,70500,73610,-3110,-0.04411347517730496,1
225,226,Jalahalli,345100,68220,276880,0.8023181686467691,-1
226,227,Marathahalli,255950,40530,215420,0.8416487595233444,0
227,228,Varthur,278000,74770,203230,0.7310431654676259,0
228,229,Banaswadi,343450,79260,264190,0.7692240500800699,-1
229,230,Hebbal,212700,69810,142890,0.6717912552891396,0
230,231,CV Raman Nagar,267300,54980,212320,0.7943135054246165,0
231,232,Hoodi,280300,105100,175200,0.6250445950767035,0
232,233,Hoodi,93500,58430,35070,0.3750802139037433,1
233,234,Shivajinagar,156250,32560,123690,0.791616,0
234,235,HBR Layout,229150,30670,198480,0.8661575387300895,-1
235,236,Hoodi,282550,62290,220260,0.7795434436382941,0
236,237,Krishnarajapuram,34750,109400,-74650,-2.148201438848921,1
237,238,Marathahalli,145850,139690,6160,0.04223517312307165,1
238,239,Whitefield,88400,51910,36490,0.41278280542986423,1
239,240,Shivajinagar,142750,17110,125640,0.8801401050788091,-1
240,241,Kammanahalli,398850,46700,352150,0.8829133759558732,-1
241,242,Indiranagar,373900,41420,332480,0.8892217170366408,-1
242,243,Hoodi,331900,46420,285480,0.8601385959626393,0
243,244,Malleswaram,144800,62950,81850,0.5652624309392266,0
244,245,Indiranagar,336200,106370,229830,0.6836109458655563,0
245,246,Jalahalli,140900,50420,90480,0.6421575585521646,0
246,247,Varthur,425500,50090,375410,0.8822796709753231,-1
247,248,CV Raman Nagar,227800,42880,184920,0.8117647058823529,-1
248,249,Banaswadi,199600,15820,183780,0.9207414829659318,-1
249,250,Whitefield,99200,41070,58130,0.5859879032258064,1
250,251,Hoodi,207250,33860,173390,0.8366224366706876,0
251,252,Vasanth Nagar,54350,11890,42460,0.7812327506899724,-1
252,253,Krishnarajapuram,243350,65110,178240,0.7324429833573043,-1
253,254,HBR Layout,187250,72610,114640,0.6122296395193592,0
254,255,Hoodi,172200,77170,95030,0.5518583042973287,1
255,256,Varthur,317700,55800,261900,0.8243626062322946,-1
256,257,Hoodi,220250,97900,122350,0.5555051078320091,0
257,258,Jalahalli,230000,69140,160860,0.699391304347826,0
258,259,Horamavu,140000,62460,77540,0.5538571428571428,1
259,260,Jalahalli,57400,43360,14040,0.2445993031358885,1
260,261,Horamavu,348300,22740,325560,0.9347114556416882,-1
261,262,Kalyan Nagar,327200,40560,286640,0.876039119804401,-1
262,263,Jalahalli,34200,40310,-6110,-0.17865497076023393,1
263,264,Banaswadi,138000,123180,14820,0.10739130434782608,1
264,265,Krishnarajapuram,31800,101790,-69990,-2.200943396226415,1
265,266,Whitefield,166150,87060,79090,0.4760156485103822,1
266,267,Indiranagar,25500,54190,-28690,-1.1250980392156862,1
267,268,Hoodi,163850,10280,153570,0.9372596887397009,-1
268,269,Rajajinagar,227250,48480,178770,0.7866666666666666,0
269,270,HBR Layout,28350,79310,-50960,-1.797530864197531,1
270,271,HBR Layout,211450,45910,165540,0.7828801135020099,0
271,272,Hoodi,396450,72700,323750,0.8166225249085635,0
272,273,Hebbal,428800,55860,372940,0.8697294776119403,-1
273,274,Hebbal,429200,54530,374670,0.8729496738117428,0
274,275,HBR Layout,334750,110260,224490,0.6706198655713219,0
275,276,Whitefield,220050,26500,193550,0.8795728243581005,0
276,277,Hoodi,269100,82740,186360,0.692530657748049,0
277,278,Vasanth Nagar,178650,71490,107160,0.5998320738874895,1
278,279,Malleswaram,32000,14980,17020,0.531875,1
279,280,Jalahalli,150650,106210,44440,0.29498838367076,1
280,281,Banaswadi,416850,43730,373120,0.8950941585702291,-1
281,282,Varthur,441850,71040,370810,0.8392214552449927,-1
282,283,Kammanahalli,30850,72400,-41550,-1.346839546191248,1
283,284,Marathahalli,103350,70650,32700,0.3164005805515239,1
284,285,Banaswadi,435500,53910,381590,0.876211251435132,-1
285,286,Mahadevapura,230100,50030,180070,0.7825727944372012,0
286,287,Horamavu,420850,92890,327960,0.7792800285137222,0
287,288,HBR Layout,388350,26390,361960,0.9320458349427063,-1
288,289,Hoodi,397500,66140,331360,0.8336100628930818,-1
289,290,Jalahalli,169950,51810,118140,0.6951456310679611,0
290,291,Banaswadi,307900,53640,254260,0.8257875933744723,0
291,292,Marathahalli,384400,67490,316910,0.8244276795005203,-1
292,293,Rajajinagar,310650,40930,269720,0.8682440045066795,-1
293,294,HBR Layout,175050,22510,152540,0.8714081690945444,-1
294,295,Whitefield,401000,155310,245690,0.6126932668329177,0
295,296,Malleswaram,425300,68170,357130,0.8397131436632965,-1
296,297,Banaswadi,349200,80420,268780,0.7697021764032074,-1
297,298,Mahadevapura,80100,114890,-34790,-0.43433208489388264,1
298,299,Krishnarajapuram,40650,115080,-74430,-1.8309963099630997,1
299,300,Whitefield,80200,85520,-5320,-0.06633416458852869,1
300,301,Kammanahalli,421400,28030,393370,0.933483626008543,-1
301,302,Mahadevapura,394900,67600,327300,0.8288174221321853,-1
302,303,Varthur,133050,87470,45580,0.34257797820368285,1
303,304,CV Raman Nagar,165850,162120,3730,0.022490201989749773,1
304,305,Hebbal,275450,66270,209180,0.7594118714830278,-1
305,306,Jalahalli,331850,72080,259770,0.7827934307669128,0
306,307,Malleswaram,448150,66120,382030,0.8524601138011827,0
307,308,Rajajinagar,84650,57610,27040,0.31943295924394566,1
308,309,Marathahalli,363450,90680,272770,0.7505021323428257,0
309,310,Varthur,229750,101560,128190,0.5579542981501632,1
310,311,Shivajinagar,449100,31500,417600,0.9298597194388778,-1
311,312,Kammanahalli,212700,121440,91260,0.4290550070521862,0
312,313,Malleswaram,220600,62690,157910,0.7158204895738894,0
313,314,Mahadevapura,203850,37060,166790,0.8181996566102526,-1
314,315,Vasanth Nagar,58350,108180,-49830,-0.8539845758354756,1
315,316,Vasanth Nagar,244650,47450,197200,0.8060494584099734,-1
316,317,Jalahalli,49850,67100,-17250,-0.3460381143430291,1
317,318,Vasanth Nagar,203750,103790,99960,0.49060122699386505,0
318,319,Malleswaram,216450,49510,166940,0.7712635712635713,0
319,320,CV Raman Nagar,50100,61170,-11070,-0.22095808383233534,1
320,321,Hoodi,417050,74070,342980,0.8223953962354634,-1
321,322,Indiranagar,443050,54530,388520,0.8769213407064665,0
322,323,Indiranagar,152750,27730,125020,0.8184615384615385,0
323,324,Hoodi,88500,32240,56260,0.6357062146892656,0
324,325,CV Raman Nagar,403450,127370,276080,0.684297930350725,0
325,326,Indiranagar,390050,42110,347940,0.8920394821176773,0
326,327,Kalyan Nagar,213350,8000,205350,0.962502929458636,-1
327,328,Kammanahalli,75950,51560,24390,0.32113232389730084,1
328,329,Banaswadi,428850,91670,337180,0.7862422758540282,-1
329,330,Jalahalli,434100,86200,347900,0.8014282423404745,-1
330,331,Hebbal,225150,53720,171430,0.7614035087719299,-1
331,332,Varthur,328800,70550,258250,0.7854318734793188,0
332,333,Indiranagar,385000,33660,351340,0.9125714285714286,-1
333,334,Shivajinagar,219900,93760,126140,0.5736243747157799,0
334,335,HBR Layout,378300,38270,340030,0.8988369019296855,-1
335,336,Kalyan Nagar,210600,42780,167820,0.7968660968660969,0
336,337,Hoodi,231200,27440,203760,0.8813148788927335,0
337,338,Kammanahalli,401250,42640,358610,0.8937320872274144,-1
338,339,Horamavu,26200,53760,-27560,-1.0519083969465648,1
339,340,Horamavu,139900,68770,71130,0.5084345961401001,1
340,341,Banaswadi,377850,101790,276060,0.730607383882493,0
341,342,Horamavu,83750,33030,50720,0.6056119402985075,0
342,343,Varthur,93800,66160,27640,0.29466950959488275,1
343,344,Malleswaram,430350,67790,362560,0.842477053561055,-1
344,345,Hebbal,43900,26600,17300,0.3940774487471526,1
345,346,Kammanahalli,207100,66470,140630,0.6790439401255433,0
346,347,Malleswaram,249800,73420,176380,0.7060848678943155,-1
347,348,Hebbal,343700,48990,294710,0.8574629036950829,0
348,349,Jalahalli,164900,122300,42600,0.25833838690115224,1
349,350,Jalahalli,65100,110180,-45080,-0.6924731182795699,1
350,351,Shivajinagar,338500,79730,258770,0.7644608567208272,0
351,352,Hebbal,444850,103330,341520,0.7677194559964032,-1
352,353,Kammanahalli,264600,45650,218950,0.8274754346182918,-1
353,354,Shivajinagar,130050,53660,76390,0.5873894655901576,1
354,355,Varthur,268350,29780,238570,0.889025526364822,-1
355,356,Horamavu,42650,114090,-71440,-1.675029308323564,1
356,357,Hebbal,319100,25000,294100,0.9216546537135694,-1
357,358,Horamavu,427050,109400,317650,0.7438239082074698,-1
358,359,Indiranagar,325150,64890,260260,0.8004305705059204,0
359,360,Krishnarajapuram,79400,82700,-3300,-0.041561712846347604,1
360,361,Whitefield,225300,32580,192720,0.8553928095872171,-1
361,362,Hebbal,328200,71080,257120,0.7834247410115783,0
362,363,HBR Layout,114800,30610,84190,0.733362369337979,0
363,364,HBR Layout,50100,9810,40290,0.8041916167664671,-1
364,365,Vasanth Nagar,105200,59450,45750,0.43488593155893535,0
365,366,Rajajinagar,180350,85200,95150,0.5275852509010258,0
366,367,Horamavu,185450,60820,124630,0.6720409813966028,0
367,368,Varthur,185900,100100,85800,0.46153846153846156,1
368,369,Hoodi,168250,105060,63190,0.3755720653789004,1
369,370,Malleswaram,317900,93860,224040,0.7047499213589179,-1
370,371,Malleswaram,68300,105340,-37040,-0.5423133235724744,1
371,372,Varthur,152600,46630,105970,0.6944298820445609,0
372,373,Marathahalli,388650,45940,342710,0.8817959603756593,0
373,374,Malleswaram,298400,74820,223580,0.7492627345844504,-1
374,375,Mahadevapura,315350,69310,246040,0.7802124623434279,0
375,376,Shivajinagar,96950,45730,51220,0.528313563692625,1
376,377,Hoodi,289650,121970,167680,0.578905575694804,0
377,378,Indiranagar,60900,56460,4440,0.0729064039408867,1
378,379,Vasanth Nagar,183000,36670,146330,0.7996174863387978,0
379,380,Marathahalli,183200,84670,98530,0.5378275109170305,0
380,381,Hebbal,366850,110780,256070,0.6980237154150197,0
381,382,Horamavu,420900,88490,332410,0.78976003801378,0
382,383,Vasanth Nagar,369700,91490,278210,0.7525290776305112,-1
383,384,CV Raman Nagar,329800,44270,285530,0.865767131594906,-1
384,385,Horamavu,306450,61580,244870,0.7990536792298907,0
385,386,Kammanahalli,37700,65300,-27600,-0.7320954907161804,1
386,387,Malleswaram,354400,53750,300650,0.8483352144469526,-1
387,388,Banaswadi,149450,69420,80030,0.5354968216794914,1
388,389,Horamavu,152950,43440,109510,0.7159856162144491,-1
389,390,Horamavu,298700,65560,233140,0.780515567458989,-1
390,391,Horamavu,384350,95930,288420,0.7504097827500976,-1
391,392,Kalyan Nagar,433350,35720,397630,0.9175724010614976,-1
392,393,Hebbal,130000,51460,78540,0.6041538461538462,0
393,394,Horamavu,148550,19000,129550,0.8720969370582295,-1
394,395,Kalyan Nagar,169000,48020,120980,0.7158579881656805,-1
395,396,Kammanahalli,217500,30880,186620,0.8580229885057471,0
396,397,Krishnarajapuram,280700,71930,208770,0.7437477734235839,0
397,398,Kammanahalli,378550,58870,319680,0.844485536917184,-1
398,399,Banaswadi,111950,53270,58680,0.5241625725770434,0
399,400,Banaswadi,172200,58930,113270,0.6577816492450639,0
400,401,Whitefield,295850,93960,201890,0.6824066249788744,0
401,402,Jalahalli,45800,72720,-26920,-0.5877729257641922,1
402,403,Banaswadi,376300,89690,286610,0.7616529364868456,-1
403,404,HBR Layout,390950,57790,333160,0.8521805857526538,0
404,405,Marathahalli,193000,41230,151770,0.7863730569948186,0
405,406,Banaswadi,26500,63590,-37090,-1.399622641509434,1
406,407,Malleswaram,297500,32400,265100,0.8910924369747899,0
407,408,Kammanahalli,270150,57160,212990,0.7884138441606515,0
408,409,Jalahalli,125850,149520,-23670,-0.18808104886769964,1
409,410,Hebbal,203700,82830,120870,0.5933726067746686,0
410,411,Varthur,144650,30720,113930,0.7876253024541998,0
411,412,Shivajinagar,74150,50100,24050,0.32434254888739045,1
412,413,Banaswadi,394950,24480,370470,0.9380174705658945,-1
413,414,Banaswadi,75050,38410,36640,0.4882078614257162,0
414,415,Hoodi,267300,20710,246590,0.9225215114104003,-1
415,416,Hebbal,278400,10720,267680,0.9614942528735633,-1
416,417,Varthur,316950,84920,232030,0.7320713046221802,0
417,418,Horamavu,151600,34910,116690,0.7697229551451187,-1
418,419,Whitefield,318850,60510,258340,0.8102242433746276,-1
419,420,Krishnarajapuram,26150,74920,-48770,-1.8650095602294454,1
420,421,Rajajinagar,446050,37900,408150,0.9150319470911333,-1
421,422,Hebbal,281000,48170,232830,0.828576512455516,0
422,423,Kammanahalli,312500,150140,162360,0.519552,0
423,424,Hoodi,111250,97090,14160,0.1272808988764045,1
424,425,Kammanahalli,420150,48290,371860,0.8850648577888849,-1
425,426,Hoodi,370650,23600,347050,0.9363280723054094,-1
426,427,Banaswadi,56800,28480,28320,0.49859154929577465,0
427,428,Whitefield,219650,104190,115460,0.5256544502617801,0
428,429,Malleswaram,425200,95110,330090,0.7763170272812794,0
429,430,Kalyan Nagar,80150,43650,36500,0.45539613225202746,0
430,431,Shivajinagar,104300,75070,29230,0.28024928092042184,1
431,432,Rajajinagar,295900,54560,241340,0.8156133828996283,0
432,433,Hoodi,286900,40300,246600,0.85953293830603,0
433,434,Whitefield,140700,54930,85770,0.6095948827292111,0
434,435,Vasanth Nagar,201000,93890,107110,0.5328855721393034,0
435,436,Hebbal,252900,72180,180720,0.7145907473309608,0
436,437,Banaswadi,52600,87340,-34740,-0.6604562737642585,1
437,438,CV Raman Nagar,224750,13920,210830,0.9380645161290323,-1
438,439,Malleswaram,426600,16510,410090,0.9612986404125644,-1
439,440,Kammanahalli,132900,50280,82620,0.6216704288939052,0
440,441,Kammanahalli,242950,71360,171590,0.7062770117308088,0
441,442,Hebbal,398650,70400,328250,0.8234039884610561,-1
442,443,HBR Layout,285300,84680,200620,0.7031896249561864,-1
443,444,Horamavu,191350,63890,127460,0.6661092239351973,0
444,445,Hoodi,169100,47170,121930,0.7210526315789474,-1
445,446,HBR Layout,89550,81630,7920,0.08844221105527639,1
446,447,Kammanahalli,112550,40530,72020,0.6398933807196802,0
447,448,Hoodi,437650,47680,389970,0.8910544956015081,0
448,449,Kammanahalli,416300,66130,350170,0.8411482104251742,0
449,450,Mahadevapura,368300,107150,261150,0.7090686939994569,-1
450,451,Rajajinagar,71850,62530,9320,0.12971468336812805,1
451,452,Malleswaram,437000,46140,390860,0.89441647597254,-1
452,453,Vasanth Nagar,29650,58410,-28760,-0.9699831365935919,1
453,454,Mahadevapura,205450,31040,174410,0.8489170114383061,0
454,455,Horamavu,243750,26610,217140,0.8908307692307692,0
455,456,Krishnarajapuram,239200,55750,183450,0.7669314381270903,-1
456,457,Varthur,327700,63680,264020,0.8056759231003967,-1
457,458,Krishnarajapuram,99950,81280,18670,0.18679339669834918,1
458,459,Whitefield,302200,38730,263470,0.8718398411647915,0
459,460,Malleswaram,207100,46380,160720,0.776050217286335,0
460,461,CV Raman Nagar,303650,15450,288200,0.9491190515396015,-1
461,462,Varthur,131200,115250,15950,0.12157012195121951,1
462,463,HBR Layout,360900,86980,273920,0.7589914103629815,0
463,464,Malleswaram,246000,59980,186020,0.7561788617886179,0
464,465,Kalyan Nagar,411050,5910,405140,0.9856221870818636,-1
465,466,HBR Layout,321550,48030,273520,0.8506297620898772,0
466,467,Vasanth Nagar,401700,49810,351890,0.8760019915359721,-1
467,468,Kalyan Nagar,301150,68200,232950,0.7735347833305661,0
468,469,Mahadevapura,184400,23320,161080,0.8735357917570499,-1
469,470,Banaswadi,205450,40220,165230,0.804234606960331,0
470,471,Kalyan Nagar,180600,133340,47260,0.26168327796234775,1
471,472,Varthur,344450,37600,306850,0.8908404703149949,0
472,473,Marathahalli,290200,42040,248160,0.8551343900758098,-1
473,474,Jalahalli,273050,43160,229890,0.8419337117744002,0
474,475,Rajajinagar,105350,103290,2060,0.019553868058851447,1
475,476,Kammanahalli,443700,104060,339640,0.7654721658778454,-1
476,477,Jalahalli,392800,6370,386430,0.9837830957230143,-1
477,478,Malleswaram,25700,90410,-64710,-2.517898832684825,1
478,479,Krishnarajapuram,300650,158570,142080,0.4725760851488442,1
479,480,Horamavu,214550,86230,128320,0.5980890235376369,0
480,481,Banaswadi,138750,92410,46340,0.333981981981982,1
481,482,Kammanahalli,427550,129890,297660,0.6961992749386037,0
482,483,Horamavu,326300,65040,261260,0.8006742261722342,-1
483,484,Horamavu,244000,40400,203600,0.8344262295081967,-1
484,485,Mahadevapura,99650,62930,36720,0.3684897139989965,1
485,486,Malleswaram,169900,66810,103090,0.6067686874632137,0
486,487,Marathahalli,158300,77050,81250,0.5132659507264687,0
487,488,Marathahalli,242200,55450,186750,0.7710569777043765,-1
488,489,Krishnarajapuram,308700,72220,236480,0.766051182377713,-1
489,490,Banaswadi,224450,35530,188920,0.8417019380708398,-1
490,491,Shivajinagar,53400,22800,30600,0.5730337078651685,1
491,492,Varthur,369150,68950,300200,0.8132195584450765,-1
492,493,Horamavu,396200,55370,340830,0.8602473498233215,-1
493,494,Kalyan Nagar,64350,58290,6060,0.09417249417249417,1
494,495,Malleswaram,449400,15820,433580,0.964797507788162,-1
495,496,Kammanahalli,69350,15590,53760,0.7751982696467196,0
496,497,Whitefield,398250,24160,374090,0.9393345888261142,-1
497,498,Mahadevapura,164900,53900,111000,0.6731352334748333,0
498,499,Kalyan Nagar,125750,80460,45290,0.3601590457256461,1
499,500,Mahadevapura,166450,51790,114660,0.6888555121658155,0
500,501,Banaswadi,244350,104700,139650,0.5715162676488643,1
501,502,Malleswaram,321550,102990,218560,0.6797076659928472,0
502,503,Malleswaram,321600,76150,245450,0.7632151741293532,0
503,504,Hebbal,401100,63430,337670,0.8418598853153827,-1
504,505,Hoodi,62700,85060,-22360,-0.3566188197767145,1
505,506,Malleswaram,149800,60650,89150,0.5951268357810414,0
506,507,Krishnarajapuram,278450,43970,234480,0.8420901418567067,0
507,508,Kammanahalli,281950,55430,226520,0.8034048590175563,0
508,509,Jalahalli,178850,16470,162380,0.9079116578138104,-1
509,510,Kammanahalli,251200,53990,197210,0.7850716560509554,-1
510,511,Kalyan Nagar,266000,50850,215150,0.8088345864661655,-1
511,512,Krishnarajapuram,442700,59300,383400,0.8660492432798735,-1
512,513,Malleswaram,222200,64460,157740,0.7099009900990099,0
513,514,Hoodi,115700,63520,52180,0.45099394987035435,0
514,515,Horamavu,152450,91040,61410,0.402820596917022,0
515,516,Hebbal,227600,82380,145220,0.6380492091388401,0
516,517,Malleswaram,26750,56580,-29830,-1.115140186915888,1
517,518,Malleswaram,334250,80280,253970,0.7598204936424832,0
518,519,Horamavu,208350,33630,174720,0.838588912886969,-1
519,520,Vasanth Nagar,212900,42430,170470,0.8007045561296383,-1
520,521,Kalyan Nagar,197850,80950,116900,0.590851655294415,0
521,522,CV Raman Nagar,191350,82420,108930,0.5692709694277502,0
522,523,Whitefield,63350,77550,-14200,-0.22415153906866614,1
523,524,Malleswaram,172950,89900,83050,0.4801965886094247,1
524,525,Whitefield,380850,58240,322610,0.8470789024550348,0
525,526,Kalyan Nagar,430150,115110,315040,0.7323956759270022,0
526,527,Malleswaram,161600,43200,118400,0.7326732673267327,-1
527,528,CV Raman Nagar,99400,121760,-22360,-0.22494969818913482,1
528,529,Vasanth Nagar,134450,91510,42940,0.31937523242841204,1
529,530,Malleswaram,183400,23420,159980,0.8723009814612868,-1
530,531,CV Raman Nagar,438800,58820,379980,0.8659525979945305,-1
531,532,CV Raman Nagar,170100,65450,104650,0.6152263374485597,0
532,533,Shivajinagar,287100,68270,218830,0.7622082897944967,0
533,534,Kalyan Nagar,171100,65200,105900,0.6189362945645821,0
534,535,Indiranagar,248300,57500,190800,0.7684252919855014,0
535,536,HBR Layout,435150,66200,368950,0.8478685510743422,-1
536,537,Mahadevapura,356400,59300,297100,0.8336139169472503,-1
537,538,Marathahalli,48500,20530,27970,0.5767010309278351,0
538,539,Malleswaram,146050,38510,107540,0.73632317699418,0
539,540,Marathahalli,440550,37370,403180,0.9151742140506185,-1
540,541,Kammanahalli,324750,64220,260530,0.802247882986913,0
541,542,Mahadevapura,294800,58470,236330,0.801662143826323,0
542,543,Vasanth Nagar,338250,27590,310660,0.9184331116038433,-1
543,544,Rajajinagar,274950,12580,262370,0.9542462265866521,-1
544,545,Horamavu,116750,113330,3420,0.029293361884368308,1
545,546,Marathahalli,322650,81040,241610,0.7488300015496668,0
546,547,Marathahalli,314250,18640,295610,0.9406841686555291,-1
547,548,Kammanahalli,422200,71860,350340,0.8297963050686878,-1
548,549,Varthur,437900,57480,380420,0.8687371546015072,0
549,550,Jalahalli,151950,10000,141950,0.9341888779203685,-1
550,551,Vasanth Nagar,406950,32330,374620,0.9205553507801941,-1
551,552,Varthur,158050,59700,98350,0.622271433090794,0
552,553,Hoodi,69150,21670,47480,0.6866232827187274,0
553,554,CV Raman Nagar,294400,48970,245430,0.8336616847826087,-1
554,555,Varthur,267200,87700,179500,0.6717814371257484,0
555,556,Varthur,295150,51040,244110,0.8270709808571912,-1
556,557,HBR Layout,79700,50340,29360,0.3683814303638645,1
557,558,Indiranagar,440250,79970,360280,0.8183532084043157,-1
558,559,Mahadevapura,55450,89550,-34100,-0.6149684400360685,1
559,560,Hoodi,53100,24090,29010,0.5463276836158192,0
560,561,Marathahalli,255950,122310,133640,0.5221332291463177,1
561,562,HBR Layout,136800,79210,57590,0.4209795321637427,1
562,563,Whitefield,331500,101180,230320,0.6947812971342383,0
563,564,Rajajinagar,79700,66190,13510,0.16951066499372647,1
564,565,Indiranagar,76700,89470,-12770,-0.1664928292046936,1
565,566,Krishnarajapuram,125750,133160,-7410,-0.05892644135188867,1
566,567,Vasanth Nagar,281250,91110,190140,0.6760533333333333,0
567,568,Kalyan Nagar,111550,47190,64360,0.5769610040340655,1
568,569,Kalyan Nagar,141850,76150,65700,0.46316531547409234,1
569,570,Whitefield,366250,95950,270300,0.7380204778156997,-1
570,571,Jalahalli,172450,54410,118040,0.6844882574659321,0
571,572,Hebbal,173150,89560,83590,0.48276061218596594,0
572,573,HBR Layout,79900,108150,-28250,-0.35356695869837296,1
573,574,Mahadevapura,54150,44370,9780,0.18060941828254848,1
574,575,Whitefield,40800,106800,-66000,-1.6176470588235294,1
575,576,CV Raman Nagar,338400,34260,304140,0.8987588652482269,0
576,577,Horamavu,422500,48810,373690,0.8844733727810651,0
577,578,Kalyan Nagar,77950,24280,53670,0.6885182809493265,0
578,579,Varthur,163350,112520,50830,0.3111723293541475,1
579,580,Kalyan Nagar,234750,70790,163960,0.6984451544195953,0
580,581,Kalyan Nagar,361600,67810,293790,0.8124723451327434,0
581,582,Jalahalli,435400,6030,429370,0.986150666054203,-1
582,583,Hoodi,53550,101470,-47920,-0.8948646125116714,1
583,584,Mahadevapura,55950,36310,19640,0.35102770330652366,1
584,585,Horamavu,430700,77960,352740,0.8189923380543301,-1
585,586,Mahadevapura,145400,33230,112170,0.7714580467675378,0
586,587,Horamavu,400750,29320,371430,0.9268371802869619,-1
587,588,Whitefield,248050,92900,155150,0.6254787341261843,0
588,589,Rajajinagar,221500,43470,178030,0.8037471783295711,0
589,590,Malleswaram,74300,77670,-3370,-0.045356662180349935,1
590,591,Vasanth Nagar,268800,69240,199560,0.7424107142857143,-1
591,592,Krishnarajapuram,103400,5460,97940,0.9471953578336557,-1
592,593,Horamavu,302350,58720,243630,0.8057879940466347,0
593,594,Krishnarajapuram,40550,31540,9010,0.2221948212083847,1
594,595,Varthur,271150,138990,132160,0.48740549511340586,0
595,596,Hebbal,301650,102420,199230,0.6604674291397314,0
596,597,Shivajinagar,407700,129520,278180,0.6823154280107923,0
597,598,Vasanth Nagar,399400,35840,363560,0.9102653980971457,-1
598,599,Hebbal,416600,85830,330770,0.7939750360057609,0
599,600,Kalyan Nagar,48750,72140,-23390,-0.4797948717948718,1
600,601,Varthur,62000,104550,-42550,-0.6862903225806452,1
601,602,Kammanahalli,282900,29560,253340,0.8955107811947685,0
602,603,Hoodi,249300,15290,234010,0.9386682711592459,-1
603,604,Banaswadi,211050,49110,161940,0.7673063255152808,-1
604,605,CV Raman Nagar,153750,141380,12370,0.08045528455284554,1
605,606,Horamavu,442600,90730,351870,0.7950067781292364,0
606,607,CV Raman Nagar,438050,61670,376380,0.8592169843625157,0
607,608,Malleswaram,439500,50640,388860,0.884778156996587,-1
608,609,Whitefield,69550,40330,29220,0.4201294033069734,0
609,610,Varthur,391400,58140,333260,0.8514563106796117,-1
610,611,Malleswaram,248200,85160,163040,0.6568896051571314,0
611,612,Kammanahalli,238550,37200,201350,0.8440578495074408,0
612,613,HBR Layout,306500,76030,230470,0.7519412724306689,-1
613,614,Horamavu,228900,45140,183760,0.8027959807776321,0
614,615,CV Raman Nagar,87850,61160,26690,0.30381331815594764,1
615,616,Jalahalli,247350,43650,203700,0.8235294117647058,-1
616,617,Marathahalli,122050,73840,48210,0.3950020483408439,1
617,618,Hebbal,211650,60220,151430,0.7154736593432554,0
618,619,Hoodi,295350,87650,207700,0.7032334518368037,0
619,620,Rajajinagar,34800,53590,-18790,-0.5399425287356322,1
620,621,Malleswaram,389950,65100,324850,0.8330555199384536,-1
621,622,Jalahalli,344150,87170,256980,0.7467092837425541,-1
622,623,Marathahalli,224650,76260,148390,0.6605386156243045,0
623,624,Malleswaram,184650,108810,75840,0.4107229894394801,1
624,625,Hebbal,120250,81260,38990,0.3242411642411642,1
625,626,Krishnarajapuram,309250,78830,230420,0.745092966855295,-1
626,627,Marathahalli,27200,66460,-39260,-1.4433823529411764,1
627,628,Hebbal,307150,80350,226800,0.738401432524825,-1
628,629,Mahadevapura,151050,19620,131430,0.8701092353525323,0
629,630,CV Raman Nagar,333900,87670,246230,0.7374363581910752,-1
630,631,Banaswadi,26450,5790,20660,0.7810964083175803,0
631,632,Banaswadi,154700,51010,103690,0.6702650290885585,0
632,633,Hebbal,121950,131660,-9710,-0.07962279622796228,1
633,634,Jalahalli,78000,40990,37010,0.4744871794871795,0
634,635,Shivajinagar,181550,51710,129840,0.7151748829523548,0
635,636,CV Raman Nagar,184450,196910,-12460,-0.06755218216318785,1
636,637,Shivajinagar,340250,15250,325000,0.9551800146950772,-1
637,638,HBR Layout,366550,54280,312270,0.8519165188923749,-1
638,639,Hoodi,295500,64160,231340,0.7828764805414552,0
639,640,Hoodi,114900,110540,4360,0.03794604003481288,1
640,641,Horamavu,232400,93290,139110,0.5985800344234079,0
641,642,HBR Layout,178950,134310,44640,0.24945515507124896,1
642,643,Banaswadi,304800,115610,189190,0.6207020997375328,0
643,644,Banaswadi,49350,44820,4530,0.09179331306990882,1
644,645,Krishnarajapuram,204800,31280,173520,0.847265625,-1
645,646,HBR Layout,96300,118250,-21950,-0.22793354101765317,1
646,647,Whitefield,338450,54690,283760,0.8384104003545575,-1
647,648,Whitefield,310750,108070,202680,0.6522284794851166,0
648,649,Horamavu,396550,82500,314050,0.7919556171983356,0
649,650,Hebbal,284550,144720,139830,0.49140748550342644,0
650,651,HBR Layout,161650,96850,64800,0.40086606866687285,1
651,652,Indiranagar,421850,63090,358760,0.8504444707834539,0
652,653,Banaswadi,353250,38850,314400,0.8900212314225053,-1
653,654,Malleswaram,439550,81700,357850,0.8141280855420316,0
654,655,Shivajinagar,400200,84480,315720,0.7889055472263868,0
655,656,Varthur,305000,62110,242890,0.7963606557377049,0
656,657,CV Raman Nagar,35400,108240,-72840,-2.057627118644068,1
657,658,Krishnarajapuram,447350,81770,365580,0.8172124734547893,-1
658,659,Indiranagar,115400,30430,84970,0.7363084922010399,0
659,660,CV Raman Nagar,119850,41570,78280,0.6531497705465165,0
660,661,Marathahalli,389500,35030,354470,0.9100641848523748,-1
661,662,Vasanth Nagar,36250,42200,-5950,-0.16413793103448276,1
662,663,Hoodi,348000,48610,299390,0.860316091954023,-1
663,664,Jalahalli,180450,58110,122340,0.6779717373233582,0
664,665,Jalahalli,210800,98080,112720,0.5347248576850094,0
665,666,Horamavu,318900,59910,258990,0.8121354656632173,-1
666,667,Shivajinagar,75900,83440,-7540,-0.09934123847167325,1
667,668,Hoodi,316150,106270,209880,0.6638620907796932,0
668,669,Marathahalli,396400,63770,332630,0.8391271442986882,0
669,670,Kalyan Nagar,41200,13520,27680,0.6718446601941748,0
670,671,Hebbal,100200,67820,32380,0.32315369261477045,1
671,672,Banaswadi,134000,26980,107020,0.7986567164179105,0
672,673,CV Raman Nagar,44900,99410,-54510,-1.214031180400891,1
673,674,CV Raman Nagar,327950,75430,252520,0.7699954261320323,-1
674,675,Hoodi,156050,154870,1180,0.00756167894905479,1
675,676,Shivajinagar,354850,134910,219940,0.6198111878258419,0
676,677,Jalahalli,449100,45020,404080,0.8997550656869294,-1
677,678,CV Raman Nagar,413350,44410,368940,0.8925607838393613,0
678,679,Krishnarajapuram,207000,50280,156720,0.7571014492753623,-1
679,680,Kammanahalli,50100,91420,-41320,-0.824750499001996,1
680,681,Banaswadi,46950,60670,-13720,-0.29222577209797657,1
681,682,Hebbal,148500,42830,105670,0.7115824915824915,0
682,683,Rajajinagar,355800,38610,317190,0.8914839797639124,-1
683,684,Mahadevapura,59950,47580,12370,0.20633861551292743,1
684,685,Horamavu,211250,116070,95180,0.4505562130177515,1
685,686,Rajajinagar,115800,7570,108230,0.9346286701208981,-1
686,687,Jalahalli,96900,71730,25170,0.2597523219814242,1
687,688,Varthur,417150,44910,372240,0.8923408845738943,-1
688,689,Whitefield,323550,14020,309530,0.9566682120228712,-1
689,690,Shivajinagar,281700,33790,247910,0.8800496982605609,-1
690,691,Hebbal,33000,56460,-23460,-0.7109090909090909,1
691,692,Whitefield,189950,47990,141960,0.7473545669913135,0
692,693,Hebbal,304900,52440,252460,0.8280091833387996,-1
693,694,Mahadevapura,383550,42740,340810,0.8885673315082779,-1
694,695,Varthur,116750,48030,68720,0.5886081370449678,0
695,696,Jalahalli,251500,38130,213370,0.848389662027833,-1
696,697,Marathahalli,233900,79310,154590,0.6609234715690466,0
697,698,Varthur,346900,23830,323070,0.9313058518304987,-1
698,699,Krishnarajapuram,271000,71320,199680,0.7368265682656826,0
699,700,Malleswaram,418400,76120,342280,0.8180688336520077,0
700,701,Vasanth Nagar,427350,53020,374330,0.8759330759330759,0
701,702,Rajajinagar,311100,76780,234320,0.7531983285117325,0
702,703,Mahadevapura,347800,103480,244320,0.7024726854514088,0
703,704,Shivajinagar,258950,13980,244970,0.9460127437729291,-1
704,705,CV Raman Nagar,347850,27270,320580,0.9216041397153946,-1
705,706,Mahadevapura,272300,35560,236740,0.8694087403598971,-1
706,707,Rajajinagar,202150,37150,165000,0.8162255750680188,0
707,708,Kammanahalli,140750,134960,5790,0.04113676731793961,1
708,709,Shivajinagar,128350,86140,42210,0.3288663809894819,1
709,710,Varthur,379700,77540,302160,0.7957861469581249,0
710,711,Vasanth Nagar,198500,45460,153040,0.7709823677581864,-1
711,712,Marathahalli,77200,74820,2380,0.030829015544041452,1
712,713,Shivajinagar,357400,55530,301870,0.8446278679350867,0
713,714,Rajajinagar,236950,92720,144230,0.6086938172610256,0
714,715,Jalahalli,389200,55800,333400,0.8566289825282631,0
715,716,Krishnarajapuram,236400,16490,219910,0.9302453468697124,-1
716,717,Rajajinagar,376450,18820,357630,0.950006640988179,-1
717,718,Krishnarajapuram,222650,87270,135380,0.6080395239164608,0
718,719,Malleswaram,278600,21430,257170,0.9230796841349606,-1
719,720,Horamavu,173250,94970,78280,0.4518326118326118,0
720,721,Whitefield,423450,80790,342660,0.8092100602196245,0
721,722,Malleswaram,269600,71380,198220,0.7352373887240357,-1
722,723,Hebbal,341700,56600,285100,0.8343576236464735,-1
723,724,Horamavu,136200,6580,129620,0.9516886930983848,-1
724,725,Shivajinagar,230950,95190,135760,0.5878328642563325,0
725,726,Whitefield,411500,6640,404860,0.9838639125151883,-1
726,727,Whitefield,165100,88780,76320,0.4622652937613568,1
727,728,Krishnarajapuram,138450,0,138450,1.0,-1
728,729,Krishnarajapuram,372400,86780,285620,0.7669709989258862,0
729,730,Marathahalli,437950,73770,364180,0.8315561137116109,-1
730,731,Kammanahalli,153300,88370,64930,0.4235485975212003,1
731,732,Varthur,348000,123260,224740,0.6458045977011494,0
732,733,HBR Layout,437350,83920,353430,0.8081170687092718,-1
733,734,Shivajinagar,75050,53990,21060,0.28061292471685545,1
734,735,Horamavu,392200,66610,325590,0.8301631820499745,-1
735,736,Indiranagar,292750,64290,228460,0.7803928266438941,0
736,737,Shivajinagar,149550,79750,69800,0.4667335339351387,1
737,738,Marathahalli,238550,36890,201660,0.8453573674282121,-1
738,739,Varthur,34450,93490,-59040,-1.713788098693759,1
739,740,Hoodi,74950,32670,42280,0.5641094062708473,0
740,741,Varthur,160550,97210,63340,0.39451884148240424,1
741,742,Mahadevapura,208450,112520,95930,0.4602062844806908,1
742,743,Horamavu,356650,28210,328440,0.9209028459273798,-1
743,744,Jalahalli,66650,77780,-11130,-0.16699174793698424,1
744,745,Kalyan Nagar,189300,101170,88130,0.46555731642894876,0
745,746,Hebbal,217000,124390,92610,0.4267741935483871,1
746,747,Hoodi,355350,78100,277250,0.7802166877726185,-1
747,748,HBR Layout,411850,100950,310900,0.754886487798956,-1
748,749,Rajajinagar,220550,35640,184910,0.8384039900249377,-1
749,750,Varthur,338850,72930,265920,0.7847720230190349,0
750,751,Horamavu,270650,109830,160820,0.5941991501939775,1
751,752,Hebbal,70400,70400,0,0.0,1
752,753,Mahadevapura,120800,96120,24680,0.20430463576158941,1
753,754,Krishnarajapuram,231750,125500,106250,0.45846817691477887,1
754,755,Whitefield,401000,17790,383210,0.955635910224439,-1
755,756,Jalahalli,118200,39160,79040,0.6686971235194585,0
756,757,Marathahalli,129400,30980,98420,0.7605873261205565,0
757,758,Varthur,180450,48490,131960,0.7312829038514824,0
758,759,Shivajinagar,366400,39040,327360,0.8934497816593886,0
759,760,Malleswaram,205500,117590,87910,0.4277858880778589,0
760,761,Hoodi,329800,43790,286010,0.8672225591267435,-1
761,762,Mahadevapura,335550,60120,275430,0.8208314707197139,-1
762,763,Vasanth Nagar,268000,70930,197070,0.7353358208955224,-1
763,764,HBR Layout,69450,34960,34490,0.49661627069834413,1
764,765,CV Raman Nagar,266600,128420,138180,0.518304576144036,0
765,766,Marathahalli,386100,69750,316350,0.8193473193473193,0
766,767,Krishnarajapuram,222250,90830,131420,0.5913160854893138,1
767,768,Malleswaram,339600,59980,279620,0.8233804475853946,-1
768,769,Horamavu,280600,96480,184120,0.6561653599429793,0
769,770,Jalahalli,181800,58450,123350,0.6784928492849285,0
770,771,Krishnarajapuram,363650,136900,226750,0.6235391172831019,0
771,772,Rajajinagar,389100,62470,326630,0.8394500128501671,-1
772,773,Vasanth Nagar,135100,27410,107690,0.7971132494448556,0
773,774,Krishnarajapuram,195300,59330,135970,0.69621095750128,0
774,775,Vasanth Nagar,164150,83030,81120,0.49418215047212916,0
775,776,Krishnarajapuram,275050,49600,225450,0.819669151063443,-1
776,777,Hoodi,102150,98660,3490,0.03416544297601566,1
777,778,Horamavu,194750,64450,130300,0.6690629011553273,0
778,779,Kammanahalli,31750,66240,-34490,-1.0862992125984252,1
779,780,Mahadevapura,209050,19650,189400,0.9060033484812245,-1
780,781,Marathahalli,320050,50240,269810,0.843024527417591,-1
781,782,Vasanth Nagar,296900,44080,252820,0.851532502526103,-1
782,783,HBR Layout,126150,97460,28690,0.227427665477606,1
783,784,Varthur,243500,59750,183750,0.7546201232032854,-1
784,785,Banaswadi,243400,53380,190020,0.7806902218570255,-1
785,786,Mahadevapura,294500,100220,194280,0.6596943972835314,0
786,787,Krishnarajapuram,147700,51820,95880,0.6491536899119837,0
787,788,Hebbal,318300,30130,288170,0.9053408733898838,-1
788,789,Mahadevapura,271150,91020,180130,0.6643186428176286,0
789,790,Mahadevapura,115550,65920,49630,0.4295110341843358,1
790,791,Kalyan Nagar,204400,143810,60590,0.29642857142857143,1
791,792,Malleswaram,219200,134630,84570,0.38581204379562045,1
792,793,Horamavu,279950,51900,228050,0.8146097517413824,-1
793,794,Mahadevapura,247400,70670,176730,0.7143492320129345,-1
794,795,Shivajinagar,269250,82710,186540,0.6928133704735376,0
795,796,Rajajinagar,302400,31900,270500,0.894510582010582,-1
796,797,Shivajinagar,333150,123270,209880,0.629986492570914,0
797,798,Marathahalli,227000,34140,192860,0.8496035242290749,-1
798,799,Kammanahalli,228900,193360,35540,0.15526430755788553,1
799,800,Mahadevapura,217100,23960,193140,0.8896361123906034,-1
800,801,Kammanahalli,56900,53160,3740,0.06572934973637962,1
801,802,Malleswaram,91950,32980,58970,0.6413268080478521,0
802,803,Rajajinagar,327200,41050,286150,0.874541564792176,-1
803,804,Shivajinagar,285600,45750,239850,0.8398109243697479,-1
804,805,Vasanth Nagar,82750,68110,14640,0.17691842900302115,1
805,806,Rajajinagar,101250,63630,37620,0.37155555555555553,1
806,807,HBR Layout,151450,37930,113520,0.7495543083525916,0
807,808,Kammanahalli,420750,76200,344550,0.8188948306595365,-1
808,809,Indiranagar,302500,59220,243280,0.8042314049586777,-1
809,810,Malleswaram,141800,88690,53110,0.37454160789844854,1
810,811,Krishnarajapuram,256000,54510,201490,0.7870703125,0
811,812,Hoodi,377450,94210,283240,0.7504040270234468,0
812,813,Varthur,172350,24900,147450,0.855526544821584,0
813,814,Malleswaram,234800,60440,174360,0.7425894378194208,0
814,815,Krishnarajapuram,301250,108770,192480,0.6389377593360995,0
815,816,Kammanahalli,43350,164090,-120740,-2.7852364475201847,1
816,817,Krishnarajapuram,168050,94730,73320,0.43629872061886343,1
817,818,Hoodi,409550,104650,304900,0.7444756439995116,-1
818,819,HBR Layout,204700,9040,195660,0.9558378114313629,-1
819,820,Banaswadi,408700,39980,368720,0.9021776364081233,-1
820,821,Kammanahalli,227350,121090,106260,0.4673850890697163,0
821,822,Krishnarajapuram,355700,20450,335250,0.9425077312341861,-1
822,823,HBR Layout,160400,36330,124070,0.773503740648379,0
823,824,Rajajinagar,260750,74150,186600,0.7156279961649089,-1
824,825,CV Raman Nagar,30600,68700,-38100,-1.2450980392156863,1
825,826,Shivajinagar,115850,26110,89740,0.7746223564954683,-1
826,827,HBR Layout,260000,75370,184630,0.7101153846153846,0
827,828,Indiranagar,401850,35530,366320,0.9115839243498818,-1
828,829,Malleswaram,34250,50020,-15770,-0.46043795620437955,1
829,830,Banaswadi,260100,34300,225800,0.8681276432141484,-1
830,831,Kalyan Nagar,211050,97520,113530,0.5379294006159678,0
831,832,Hoodi,36200,98450,-62250,-1.7196132596685083,1
832,833,Kalyan Nagar,220000,96810,123190,0.5599545454545455,0
833,834,Kammanahalli,90150,86180,3970,0.04403771491957848,1
834,835,Krishnarajapuram,248300,92560,155740,0.6272251308900524,0
835,836,CV Raman Nagar,294050,64850,229200,0.7794592756333957,0
836,837,Varthur,378900,60500,318400,0.8403272631301135,-1
837,838,Kammanahalli,413350,115950,297400,0.7194871174549413,0
838,839,Shivajinagar,51350,56490,-5140,-0.10009737098344693,1
839,840,Varthur,138350,34600,103750,0.7499096494398265,0
840,841,Kalyan Nagar,94300,100190,-5890,-0.062460233297985154,1
841,842,Whitefield,74500,58890,15610,0.20953020134228187,1
842,843,Hebbal,83200,72860,10340,0.12427884615384616,1
843,844,Mahadevapura,31250,34950,-3700,-0.1184,1
844,845,Kammanahalli,103950,36370,67580,0.6501202501202501,0
845,846,Varthur,313050,66740,246310,0.7868072192940425,0
846,847,Shivajinagar,50850,40970,9880,0.19429695181907572,1
847,848,Banaswadi,375700,48970,326730,0.8696566409369177,-1
848,849,Whitefield,118400,78500,39900,0.33699324324324326,1
849,850,Mahadevapura,293300,69900,223400,0.7616774633481077,-1
850,851,Horamavu,148950,67490,81460,0.5468949311849614,1
851,852,HBR Layout,126750,78390,48360,0.38153846153846155,1
852,853,Hebbal,371050,29440,341610,0.9206575933162646,-1
853,854,Shivajinagar,449500,63810,385690,0.8580422691879867,-1
854,855,HBR Layout,162950,24800,138150,0.8478060754832771,-1
855,856,Malleswaram,89550,75880,13670,0.15265214963707427,1
856,857,Marathahalli,351900,32170,319730,0.9085819835180449,-1
857,858,Indiranagar,264750,46780,217970,0.8233050047214353,-1
858,859,CV Raman Nagar,290650,135900,154750,0.5324273180801652,1
859,860,Mahadevapura,36850,61970,-25120,-0.6816824966078697,1
860,861,Banaswadi,427900,59510,368390,0.8609254498714652,-1
861,862,Marathahalli,412300,42320,369980,0.8973562939607083,0
862,863,Marathahalli,357400,54900,302500,0.8463905987688864,0
863,864,Kalyan Nagar,253100,29850,223250,0.8820624259186093,-1
864,865,Varthur,46750,86380,-39630,-0.8477005347593582,1
865,866,Banaswadi,427550,106380,321170,0.7511869956730207,0
866,867,HBR Layout,57000,82360,-25360,-0.44491228070175437,1
867,868,Shivajinagar,398550,53920,344630,0.8647095721992222,0
868,869,Malleswaram,28800,42000,-13200,-0.4583333333333333,1
869,870,Malleswaram,129450,67010,62440,0.48234839706450366,1
870,871,Hoodi,290300,32080,258220,0.8894936272821219,-1
871,872,Hebbal,170800,109340,61460,0.3598360655737705,1
872,873,Hoodi,27850,11970,15880,0.570197486535009,0
873,874,Varthur,174550,77100,97450,0.558292752792896,0
874,875,Vasanth Nagar,155500,51830,103670,0.6666881028938907,0
875,876,Jalahalli,248300,95610,152690,0.6149416028997181,0
876,877,Malleswaram,185950,22170,163780,0.8807744017208927,-1
877,878,HBR Layout,401200,1840,399360,0.9954137587238285,-1
878,879,Indiranagar,112050,45180,66870,0.5967871485943775,0
879,880,Hoodi,38750,43320,-4570,-0.11793548387096774,1
880,881,Malleswaram,174650,101820,72830,0.41700543945032925,1
881,882,Malleswaram,385000,83940,301060,0.781974025974026,0
882,883,Shivajinagar,37500,154530,-117030,-3.1208,1
883,884,Hebbal,151000,58080,92920,0.6153642384105961,0
884,885,Mahadevapura,259550,85760,173790,0.6695819687921403,0
885,886,Vasanth Nagar,346650,56180,290470,0.837934516082504,0
886,887,Kalyan Nagar,46300,57480,-11180,-0.24146868250539957,1
887,888,Banaswadi,304800,54420,250380,0.8214566929133859,0
888,889,Indiranagar,114150,105010,9140,0.08007008322382829,1
889,890,Whitefield,261700,69460,192240,0.734581581964081,-1
890,891,Kalyan Nagar,91900,123250,-31350,-0.3411316648531012,1
891,892,Hoodi,404250,86480,317770,0.7860729746444032,-1
892,893,Rajajinagar,300000,49300,250700,0.8356666666666667,-1
893,894,Rajajinagar,322550,67500,255050,0.7907301193613393,0
894,895,Indiranagar,149250,75400,73850,0.4948073701842546,0
895,896,Marathahalli,234350,60870,173480,0.7402602944314061,-1
896,897,Hoodi,382000,83020,298980,0.7826701570680629,0
897,898,Vasanth Nagar,249550,51040,198510,0.7954718493287918,-1
898,899,CV Raman Nagar,424950,92380,332570,0.7826097187904459,-1
899,900,Krishnarajapuram,321100,48250,272850,0.849735284957957,0
900,901,CV Raman Nagar,103000,111340,-8340,-0.08097087378640777,1
901,902,Banaswadi,300150,55460,244690,0.8152257204730968,-1
902,903,Hebbal,449300,2990,446310,0.9933452036501225,-1
903,904,Kalyan Nagar,369400,73500,295900,0.8010286951813752,-1
904,905,Kalyan Nagar,235500,48200,187300,0.7953290870488323,-1
905,906,Shivajinagar,204150,136860,67290,0.32961058045554736,1
906,907,HBR Layout,268700,103700,165000,0.6140677335318199,0
907,908,Hoodi,391550,9440,382110,0.9758906908440812,-1
908,909,Whitefield,186550,117920,68630,0.36789064593942644,1
909,910,Whitefield,259450,56870,202580,0.7808055502023511,0
910,911,Kalyan Nagar,340200,43890,296310,0.8709876543209877,-1
911,912,Hoodi,385550,34310,351240,0.9110102451043963,-1
912,913,Shivajinagar,37350,74730,-37380,-1.0008032128514057,1
913,914,Marathahalli,292050,7000,285050,0.9760315014552303,-1
914,915,Shivajinagar,259700,54540,205160,0.7899884482094724,0
915,916,Indiranagar,378300,23450,354850,0.9380121596616442,-1
916,917,Horamavu,323200,64380,258820,0.8008044554455446,0
917,918,CV Raman Nagar,339350,36990,302360,0.8909974952114337,-1
918,919,Vasanth Nagar,28550,99080,-70530,-2.4704028021015763,1
919,920,Whitefield,348100,53550,294550,0.8461648951450732,-1
920,921,Hebbal,145600,64530,81070,0.5567994505494506,1
921,922,Rajajinagar,153350,94360,58990,0.38467557874144115,1
922,923,Rajajinagar,137800,41040,96760,0.7021770682148041,0
923,924,Rajajinagar,344150,109050,235100,0.6831323550777277,0
924,925,Krishnarajapuram,284900,100110,184790,0.6486135486135486,0
925,926,Vasanth Nagar,135350,76250,59100,0.4366457332840783,1
926,927,Hoodi,254900,55520,199380,0.7821890937622598,-1
927,928,Kammanahalli,367350,10780,356570,0.9706546889887029,-1
928,929,Horamavu,202700,28380,174320,0.859990133201776,-1
929,930,Hebbal,91650,174510,-82860,-0.9040916530278232,1
930,931,Whitefield,260900,61540,199360,0.7641241855116903,0
931,932,Varthur,415850,69270,346580,0.8334255140074546,0
932,933,Marathahalli,160700,45730,114970,0.7154324828873677,0
933,934,Kammanahalli,31200,25420,5780,0.18525641025641026,1
934,935,Kammanahalli,343850,85940,257910,0.7500654355096699,0
935,936,Whitefield,293900,41640,252260,0.85831915617557,-1
936,937,Hebbal,158050,50780,107270,0.6787092692186018,0
937,938,Malleswaram,404050,47320,356730,0.8828857814626903,-1
938,939,Rajajinagar,53350,29940,23410,0.4388003748828491,0
939,940,Hoodi,344000,86870,257130,0.7474709302325582,-1
940,941,Malleswaram,228900,94850,134050,0.5856269113149847,0
941,942,Indiranagar,352500,68510,283990,0.805645390070922,0
942,943,Mahadevapura,148300,44380,103920,0.7007417397167903,-1
943,944,Banaswadi,422100,49530,372570,0.8826581378820185,0
944,945,Varthur,337400,36770,300630,0.8910195613515116,-1
945,946,Hebbal,75350,14700,60650,0.8049104180491041,-1
946,947,Kammanahalli,415350,15510,399840,0.9626579992777176,-1
947,948,Malleswaram,387800,71110,316690,0.8166322846828262,0
948,949,Vasanth Nagar,355300,48630,306670,0.8631297495074585,-1
949,950,Hebbal,246500,31610,214890,0.8717647058823529,0
950,951,CV Raman Nagar,244900,67280,177620,0.7252756227031442,0
951,952,Whitefield,434450,76710,357740,0.8234319254229485,-1
952,953,Krishnarajapuram,357350,62540,294810,0.8249895060864698,-1
953,954,Indiranagar,357150,78480,278670,0.7802603947921042,0
954,955,Vasanth Nagar,396250,91130,305120,0.7700189274447949,0
955,956,Jalahalli,421200,57760,363440,0.8628679962013296,-1
956,957,Varthur,226400,111210,115190,0.5087897526501767,0
957,958,Banaswadi,78550,69560,8990,0.11444939528962444,1
958,959,Banaswadi,137600,35300,102300,0.7434593023255814,0
959,960,CV Raman Nagar,292900,21330,271570,0.9271765107545237,-1
960,961,Jalahalli,172000,20420,151580,0.8812790697674419,-1
961,962,Kalyan Nagar,35400,67200,-31800,-0.8983050847457628,1
962,963,Indiranagar,330700,57720,272980,0.8254611430299365,-1
963,964,Shivajinagar,309950,28020,281930,0.90959832231005,-1
964,965,Marathahalli,221950,32330,189620,0.8543365622888038,-1
965,966,Jalahalli,346200,78860,267340,0.7722125938763721,-1
966,967,Vasanth Nagar,413000,33970,379030,0.9177481840193704,-1
967,968,Horamavu,117750,114260,3490,0.029639065817409768,1
968,969,Kammanahalli,197900,89150,108750,0.5495199595755432,0
969,970,Marathahalli,165800,49570,116230,0.7010253317249698,0
970,971,Malleswaram,133400,40130,93270,0.699175412293853,0
971,972,Krishnarajapuram,260850,38420,222430,0.8527122867548399,-1
972,973,Marathahalli,402000,62470,339530,0.8446019900497512,-1
973,974,Marathahalli,275550,71800,203750,0.7394302304481946,-1
974,975,Kammanahalli,173850,54330,119520,0.6874892148403796,0
975,976,Varthur,313800,52650,261150,0.8322179732313576,-1
976,977,Jalahalli,35550,32400,3150,0.08860759493670886,1
977,978,Indiranagar,259050,71020,188030,0.7258444315769157,0
978,979,Hebbal,194000,49090,144910,0.7469587628865979,0
979,980,Krishnarajapuram,184900,46050,138850,0.7509464575446188,-1
980,981,Krishnarajapuram,221800,39100,182700,0.8237150586113616,-1
981,982,Malleswaram,160200,73200,87000,0.5430711610486891,0
982,983,Whitefield,271800,47240,224560,0.8261957321559971,-1
983,984,Mahadevapura,191350,50560,140790,0.7357721452835119,0
984,985,CV Raman Nagar,383550,115910,267640,0.6977968974058141,0
985,986,Malleswaram,214300,90090,124210,0.5796080261315912,1
986,987,Malleswaram,160900,53740,107160,0.6660037290242387,0
987,988,Jalahalli,239250,5490,233760,0.9770532915360501,-1
988,989,Kammanahalli,91500,52170,39330,0.42983606557377046,1
989,990,Varthur,236350,51670,184680,0.7813835413581552,-1
990,991,HBR Layout,327950,57740,270210,0.8239365756975149,-1
991,992,Mahadevapura,286000,163440,122560,0.4285314685314685,0
992,993,Indiranagar,207300,35850,171450,0.8270622286541245,-1
993,994,Rajajinagar,377300,15790,361510,0.9581500132520541,-1
994,995,CV Raman Nagar,399200,79380,319820,0.8011523046092185,-1
995,996,Jalahalli,378650,112980,265670,0.7016241912055988,0
996,997,Horamavu,124600,23490,101110,0.8114767255216694,-1
997,998,Hoodi,149650,37500,112150,0.7494153023722018,0
998,999,Indiranagar,200700,38370,162330,0.8088191330343797,-1
999,1000,CV Raman Nagar,303550,84910,218640,0.7202767254159117,-1
1000,1001,Krishnarajapuram,118750,82770,35980,0.30298947368421053,1
1001,1002,Kammanahalli,99400,115740,-16340,-0.16438631790744468,1
1002,1003,Kalyan Nagar,384350,25830,358520,0.9327956289839989,-1
1003,1004,Rajajinagar,447750,73990,373760,0.8347515354550531,-1
1004,1005,Banaswadi,319750,41810,277940,0.8692415949960907,0
1005,1006,Kalyan Nagar,101750,96560,5190,0.05100737100737101,1
1006,1007,Marathahalli,263000,87150,175850,0.6686311787072243,0
1007,1008,Shivajinagar,347800,0,347800,1.0,-1
1008,1009,Malleswaram,161000,125950,35050,0.21770186335403727,1
1009,1010,Malleswaram,378400,26190,352210,0.9307875264270613,-1
1010,1011,Mahadevapura,372900,59390,313510,0.840734781442746,-1
1011,1012,Whitefield,300850,56340,244510,0.8127305966428453,-1
1012,1013,Vasanth Nagar,131800,50450,81350,0.6172230652503794,0
1013,1014,Horamavu,131300,90010,41290,0.3144706778370145,1
1014,1015,Hebbal,272500,96840,175660,0.6446238532110091,0
1015,1016,Horamavu,308850,104010,204840,0.663234579893152,0
1016,1017,Indiranagar,309050,49460,259590,0.8399611713314997,-1
1017,1018,Hebbal,248400,78700,169700,0.6831723027375202,0
1018,1019,Banaswadi,211550,73670,137880,0.6517608130465611,0
1019,1020,Varthur,385050,44260,340790,0.885053889105311,-1
1020,1021,Kammanahalli,47800,109250,-61450,-1.2855648535564854,1
1021,1022,Banaswadi,434600,118890,315710,0.7264381040036816,0
1022,1023,Vasanth Nagar,267450,52380,215070,0.8041503084688727,0
1023,1024,Varthur,412750,34090,378660,0.9174076317383404,-1
1024,1025,Jalahalli,390900,52530,338370,0.8656178050652341,0
1025,1026,Marathahalli,199700,25190,174510,0.8738607911867802,-1
1026,1027,Kammanahalli,193050,54390,138660,0.7182595182595183,0
1027,1028,Varthur,192000,47980,144020,0.7501041666666667,-1
1028,1029,Whitefield,244100,37370,206730,0.8469070053256862,0
1029,1030,Banaswadi,368150,11350,356800,0.969170175200326,-1
1030,1031,Horamavu,407600,60990,346610,0.8503680078508341,0
1031,1032,Krishnarajapuram,72850,65530,7320,0.10048043925875086,1
1032,1033,Whitefield,166450,29130,137320,0.8249924902373085,0
1033,1034,Whitefield,402950,76200,326750,0.8108946519419282,-1
1034,1035,Shivajinagar,125450,74930,50520,0.4027102431247509,1
1035,1036,Whitefield,95650,23280,72370,0.7566126502875066,-1
1036,1037,Horamavu,195300,94190,101110,0.5177163338453661,1
1037,1038,Shivajinagar,107650,84440,23210,0.21560613098002787,1
1038,1039,Krishnarajapuram,410550,32500,378050,0.9208379003775423,-1
1039,1040,Whitefield,168200,39320,128880,0.766230677764566,0
1040,1041,CV Raman Nagar,199600,84660,114940,0.5758517034068136,0
1041,1042,Vasanth Nagar,410900,84110,326790,0.7953029934290582,-1
1042,1043,Indiranagar,417450,56820,360630,0.8638878907653611,0
1043,1044,Marathahalli,145650,77280,68370,0.4694129763130793,1
1044,1045,CV Raman Nagar,189900,50950,138950,0.7317008952080042,-1
1045,1046,Malleswaram,311000,95370,215630,0.6933440514469453,0
1046,1047,Jalahalli,336200,93280,242920,0.7225461035098156,-1
1047,1048,Jalahalli,57800,174480,-116680,-2.0186851211072665,1
1048,1049,Vasanth Nagar,169850,58390,111460,0.6562260818369149,0
1049,1050,Vasanth Nagar,153650,27820,125830,0.8189391474129515,0
1050,1051,Indiranagar,226200,137940,88260,0.39018567639257296,1
1051,1052,Kammanahalli,107600,28260,79340,0.7373605947955391,-1
1052,1053,Krishnarajapuram,67200,145390,-78190,-1.1635416666666667,1
1053,1054,Jalahalli,107100,41100,66000,0.6162464985994398,0
1054,1055,Whitefield,48350,55020,-6670,-0.13795243019648398,1
1055,1056,Mahadevapura,194400,182910,11490,0.059104938271604936,1
1056,1057,Whitefield,416800,58800,358000,0.8589251439539347,0
1057,1058,Kammanahalli,63050,37710,25340,0.4019032513877875,1
1058,1059,Hebbal,349000,55580,293420,0.8407449856733524,-1
1059,1060,Banaswadi,231850,67490,164360,0.7089066206599094,-1
1060,1061,Malleswaram,298950,49780,249170,0.8334838601772872,0
1061,1062,Marathahalli,237150,0,237150,1.0,-1
1062,1063,Hoodi,224350,45770,178580,0.79598841096501,0
1063,1064,Hebbal,275750,84520,191230,0.6934904805077062,0
1064,1065,Shivajinagar,196400,88180,108220,0.5510183299389002,0
1065,1066,Malleswaram,92850,104020,-11170,-0.12030156165858913,1
1066,1067,Shivajinagar,46150,31220,14930,0.323510292524377,1
1067,1068,Kammanahalli,75700,26500,49200,0.6499339498018494,0
1068,1069,Hebbal,270500,82130,188370,0.6963770794824399,0
1069,1070,Marathahalli,153450,54040,99410,0.6478331704138156,0
1070,1071,Kalyan Nagar,361900,44380,317520,0.8773694390715667,-1
1071,1072,Krishnarajapuram,176000,56250,119750,0.6803977272727273,0
1072,1073,Shivajinagar,112700,79550,33150,0.29414374445430347,1
1073,1074,HBR Layout,430300,59750,370550,0.8611433883337206,-1
1074,1075,Mahadevapura,357500,26540,330960,0.9257622377622378,-1
1075,1076,Whitefield,182300,16180,166120,0.9112452002194186,-1
1076,1077,Kammanahalli,175150,13130,162020,0.925035683699686,-1
1077,1078,CV Raman Nagar,212200,82270,129930,0.6122997172478793,0
1078,1079,Marathahalli,380700,41920,338780,0.8898870501707381,0
1079,1080,Indiranagar,257850,103130,154720,0.6000387822377351,0
1080,1081,CV Raman Nagar,236950,54540,182410,0.769824857564887,-1
1081,1082,Indiranagar,179350,62110,117240,0.6536938946194591,0
1082,1083,Banaswadi,141500,41580,99920,0.706148409893993,0
1083,1084,Whitefield,408050,36460,371590,0.9106482048768533,-1
1084,1085,Mahadevapura,305900,27500,278400,0.91010134030729,-1
1085,1086,Rajajinagar,153050,107200,45850,0.29957530218882716,1
1086,1087,Kammanahalli,388250,45400,342850,0.8830650354153252,-1
1087,1088,Jalahalli,48150,97450,-49300,-1.023883696780893,1
1088,1089,Varthur,254550,44100,210450,0.8267530936947555,0
1089,1090,Varthur,287650,67710,219940,0.7646097688162697,0
1090,1091,Rajajinagar,54550,186840,-132290,-2.425114573785518,1
1091,1092,Horamavu,354950,79690,275260,0.775489505564164,0
1092,1093,Indiranagar,249250,66160,183090,0.7345636910732196,0
1093,1094,Kalyan Nagar,52450,86020,-33570,-0.6400381315538608,1
1094,1095,Krishnarajapuram,292100,43360,248740,0.8515576857240671,-1
1095,1096,Varthur,334200,82000,252200,0.7546379413524835,-1
1096,1097,Malleswaram,335900,45500,290400,0.864543018755582,0
1097,1098,Kalyan Nagar,309900,20170,289730,0.9349144885446918,-1
1098,1099,Mahadevapura,245200,112810,132390,0.539926590538336,0
1099,1100,Marathahalli,105850,43100,62750,0.5928200283419934,0
1100,1101,Krishnarajapuram,433650,41980,391670,0.9031938199008417,-1
1101,1102,Banaswadi,135450,53290,82160,0.6065706902916205,0
1102,1103,Krishnarajapuram,213950,7170,206780,0.9664874970787567,-1
1103,1104,Kammanahalli,264500,39690,224810,0.8499432892249528,-1
1104,1105,Hoodi,436600,58280,378320,0.8665139715987173,-1
1105,1106,Krishnarajapuram,427000,66910,360090,0.8433021077283372,-1
1106,1107,Shivajinagar,383200,75150,308050,0.8038883089770354,0
1107,1108,Varthur,426750,30450,396300,0.9286467486818981,-1
1108,1109,Jalahalli,293350,53380,239970,0.818033066303051,-1
1109,1110,Vasanth Nagar,347200,104580,242620,0.6987903225806451,0
1110,1111,Vasanth Nagar,210600,82700,127900,0.6073124406457739,0
1111,1112,Shivajinagar,231050,63040,168010,0.7271586236745293,0
1112,1113,Malleswaram,128050,10450,117600,0.9183912534166341,-1
1113,1114,Kalyan Nagar,117050,103960,13090,0.11183255019222554,1
1114,1115,Varthur,244700,88180,156520,0.6396403759705762,0
1115,1116,Krishnarajapuram,42150,10500,31650,0.7508896797153025,-1
1116,1117,Marathahalli,346400,88990,257410,0.7431004618937644,0
1117,1118,HBR Layout,307600,60150,247450,0.8044538361508452,0
1118,1119,Whitefield,152500,72370,80130,0.5254426229508197,0
1119,1120,CV Raman Nagar,330950,46990,283960,0.8580148058619127,0
1120,1121,Banaswadi,218350,118290,100060,0.45825509503091366,1
1121,1122,Malleswaram,185600,44940,140660,0.7578663793103448,0
1122,1123,Rajajinagar,359350,60920,298430,0.8304716849867817,-1
1123,1124,HBR Layout,305200,49450,255750,0.8379750982961992,-1
1124,1125,Hoodi,37000,91080,-54080,-1.4616216216216216,1
1125,1126,Malleswaram,209900,89220,120680,0.5749404478323011,0
1126,1127,Jalahalli,366500,126070,240430,0.6560163710777627,0
1127,1128,Banaswadi,28350,85210,-56860,-2.0056437389770725,1
1128,1129,HBR Layout,112900,65230,47670,0.4222320637732507,1
1129,1130,Whitefield,76350,63110,13240,0.17341191879502293,1
1130,1131,Whitefield,157250,61920,95330,0.6062321144674085,0
1131,1132,Varthur,346400,13990,332410,0.9596131639722864,-1
1132,1133,Hoodi,381700,43120,338580,0.8870317002881845,-1
1133,1134,Vasanth Nagar,185350,26400,158950,0.857566765578635,-1
1134,1135,Banaswadi,425100,61550,363550,0.8552105386967772,-1
1135,1136,Whitefield,274350,39210,235140,0.8570803717878622,-1
1136,1137,Rajajinagar,117300,8160,109140,0.9304347826086956,-1
1137,1138,CV Raman Nagar,89100,28920,60180,0.6754208754208754,0
1138,1139,Kalyan Nagar,262350,101580,160770,0.6128073184676959,0
1139,1140,Shivajinagar,393500,74910,318590,0.8096315120711562,-1
1140,1141,Indiranagar,442000,49040,392960,0.8890497737556561,0
1141,1142,Hebbal,436600,74130,362470,0.83021071919377,-1
1142,1143,Hoodi,285750,40700,245050,0.857567804024497,-1
1143,1144,HBR Layout,170000,72370,97630,0.5742941176470588,1
1144,1145,Malleswaram,359500,109370,250130,0.6957719054242003,0
1145,1146,Mahadevapura,391450,53400,338050,0.8635841103589219,-1
1146,1147,Banaswadi,326300,55420,270880,0.8301562978853816,0
1147,1148,Vasanth Nagar,49850,48150,1700,0.034102306920762285,1
1148,1149,Banaswadi,262550,99600,162950,0.6206436869167777,0
1149,1150,Indiranagar,81400,96640,-15240,-0.18722358722358723,1
1150,1151,HBR Layout,351350,91520,259830,0.7395189981499929,-1
1151,1152,HBR Layout,42700,100000,-57300,-1.3419203747072599,1
1152,1153,Rajajinagar,392350,63950,328400,0.8370077736714668,0
1153,1154,Rajajinagar,25150,59230,-34080,-1.3550695825049701,1
1154,1155,Indiranagar,119350,46450,72900,0.6108085462924172,0
1155,1156,Varthur,92600,31160,61440,0.6634989200863931,0
1156,1157,Whitefield,376650,77440,299210,0.7943979822116023,0
1157,1158,Marathahalli,185450,79830,105620,0.5695335669991911,0
1158,1159,Indiranagar,364450,94590,269860,0.7404582247221841,0
1159,1160,Rajajinagar,183150,39380,143770,0.784984984984985,0
1160,1161,Indiranagar,43850,62520,-18670,-0.425769669327252,1
1161,1162,Mahadevapura,282100,64650,217450,0.770825948245303,-1
1162,1163,Marathahalli,246300,80410,165890,0.6735282176207876,0
1163,1164,Hebbal,369850,60030,309820,0.837690955792889,-1
1164,1165,Malleswaram,372500,87940,284560,0.7639194630872483,-1
1165,1166,Indiranagar,160500,140620,19880,0.12386292834890966,1
1166,1167,Malleswaram,32850,79020,-46170,-1.4054794520547946,1
1167,1168,Hebbal,111800,51390,60410,0.5403398926654741,0
1168,1169,Horamavu,155050,67650,87400,0.563689132537891,0
1169,1170,Varthur,237350,75200,162150,0.6831683168316832,0
1170,1171,Hebbal,36400,18910,17490,0.4804945054945055,1
1171,1172,Krishnarajapuram,348450,54140,294310,0.8446262017506099,-1
1172,1173,Banaswadi,218500,6110,212390,0.9720366132723112,-1
1173,1174,Banaswadi,396700,5380,391320,0.9864381144441644,-1
1174,1175,Banaswadi,125750,32910,92840,0.7382902584493042,0
1175,1176,Marathahalli,289100,43310,245790,0.8501902455897613,-1
1176,1177,Kalyan Nagar,274900,76260,198640,0.7225900327391779,0
1177,1178,Rajajinagar,149600,47060,102540,0.685427807486631,0
1178,1179,Marathahalli,372900,23490,349410,0.9370072405470635,-1
1179,1180,Rajajinagar,161350,85540,75810,0.4698481561822126,1
1180,1181,Mahadevapura,248800,88200,160600,0.6454983922829582,0
1181,1182,Jalahalli,339450,106050,233400,0.687582854617764,0
1182,1183,Malleswaram,50550,32450,18100,0.3580613254203759,1
1183,1184,Hebbal,31750,39110,-7360,-0.23181102362204725,1
1184,1185,Shivajinagar,67850,97230,-29380,-0.43301400147383934,1
1185,1186,Indiranagar,254350,58910,195440,0.7683900137605661,0
1186,1187,Kalyan Nagar,187850,62780,125070,0.6657971785999468,0
1187,1188,Hebbal,345800,51020,294780,0.8524580682475419,0
1188,1189,Mahadevapura,122400,44320,78080,0.6379084967320261,0
1189,1190,Horamavu,210650,65200,145450,0.6904818419178732,0
1190,1191,Jalahalli,82600,39750,42850,0.5187651331719129,1
1191,1192,CV Raman Nagar,121150,41800,79350,0.6549731737515476,0
1192,1193,Shivajinagar,201900,32630,169270,0.8383853392768698,-1
1193,1194,Hoodi,78000,28820,49180,0.6305128205128205,0
1194,1195,Krishnarajapuram,43450,12270,31180,0.7176064441887227,0
1195,1196,Kammanahalli,267850,71590,196260,0.7327235392943812,0
1196,1197,HBR Layout,185000,102460,82540,0.44616216216216215,1
1197,1198,Hoodi,177950,82660,95290,0.5354874964877775,1
1198,1199,Vasanth Nagar,427550,84090,343460,0.8033212489767279,-1
1199,1200,Indiranagar,56500,84220,-27720,-0.4906194690265487,1
1200,1201,Vasanth Nagar,32950,22370,10580,0.321092564491654,1
1201,1202,Hoodi,418750,120730,298020,0.7116895522388059,-1
1202,1203,Hebbal,43700,61930,-18230,-0.41716247139588103,1
1203,1204,Krishnarajapuram,270750,37880,232870,0.8600923361034164,0
1204,1205,Indiranagar,426600,27440,399160,0.9356774496015002,-1
1205,1206,Banaswadi,79800,36380,43420,0.5441102756892231,0
1206,1207,Whitefield,254950,65270,189680,0.7439890174544028,-1
1207,1208,Kammanahalli,70300,65970,4330,0.06159317211948791,1
1208,1209,Whitefield,430600,42470,388130,0.9013701811425917,-1
1209,1210,Indiranagar,201900,107510,94390,0.46750866765725607,1
1210,1211,Vasanth Nagar,101250,15250,86000,0.8493827160493828,-1
1211,1212,Marathahalli,328150,19310,308840,0.941154959622124,-1
1212,1213,Kalyan Nagar,345150,47850,297300,0.8613646240764885,-1
1213,1214,Mahadevapura,306350,76870,229480,0.7490778521299167,0
1214,1215,Indiranagar,442800,48520,394280,0.8904245709123758,0
1215,1216,Hebbal,304750,88640,216110,0.7091386382280558,0
1216,1217,Malleswaram,182000,27170,154830,0.8507142857142858,-1
1217,1218,Vasanth Nagar,367600,101530,266070,0.7238030467899891,0
1218,1219,Kalyan Nagar,131900,46420,85480,0.6480667172100076,0
1219,1220,Shivajinagar,203700,132970,70730,0.34722631320569464,1
1220,1221,Vasanth Nagar,105750,71490,34260,0.32397163120567374,1
1221,1222,Jalahalli,238700,61900,176800,0.7406786761625471,0
1222,1223,Vasanth Nagar,346850,45030,301820,0.8701744269857287,-1
1223,1224,Jalahalli,295650,58690,236960,0.8014882462371047,-1
1224,1225,Marathahalli,438850,69720,369130,0.8411302267289507,0
1225,1226,Krishnarajapuram,423350,68840,354510,0.8373922286524152,0
1226,1227,Krishnarajapuram,398050,104780,293270,0.7367667378470042,-1
1227,1228,Whitefield,377550,83200,294350,0.7796318368428022,0
1228,1229,Horamavu,347350,12150,335200,0.9650208723189866,-1
1229,1230,Marathahalli,237400,86900,150500,0.6339511373209773,0
1230,1231,Whitefield,449050,76400,372650,0.8298630442044316,-1
1231,1232,Kammanahalli,190500,45280,145220,0.7623097112860893,0
1232,1233,Krishnarajapuram,204450,95310,109140,0.5338224504768893,0
1233,1234,Hebbal,36450,76570,-40120,-1.1006858710562415,1
1234,1235,Vasanth Nagar,56300,75310,-19010,-0.33765541740674954,1
1235,1236,Hoodi,170700,128680,42020,0.24616285881663738,1
1236,1237,Hoodi,144450,54270,90180,0.6242990654205608,0
1237,1238,Marathahalli,394800,65550,329250,0.833966565349544,0
1238,1239,Jalahalli,326750,66720,260030,0.7958071920428462,-1
1239,1240,Vasanth Nagar,251100,28500,222600,0.8864994026284349,0
1240,1241,Marathahalli,445350,55100,390250,0.8762770854384192,-1
1241,1242,HBR Layout,52550,49480,3070,0.058420551855375834,1
1242,1243,Horamavu,100500,57940,42560,0.4234825870646766,0
1243,1244,Malleswaram,233450,62240,171210,0.7333904476333262,-1
1244,1245,Marathahalli,143800,40440,103360,0.7187760778859527,0
1245,1246,Hebbal,66400,32730,33670,0.507078313253012,1
1246,1247,Whitefield,88650,46640,42010,0.4738860688099267,0
1247,1248,Jalahalli,302250,35300,266950,0.8832092638544251,-1
1248,1249,Mahadevapura,122900,58890,64010,0.5208299430431245,1
1249,1250,Kammanahalli,426150,48210,377940,0.8868708201337557,-1
1250,1251,Indiranagar,237750,76630,161120,0.6776866456361724,0
1251,1252,Rajajinagar,364600,31010,333590,0.9149478880965441,-1
1252,1253,Malleswaram,112850,67990,44860,0.39751883030571555,1
1253,1254,Whitefield,404750,133910,270840,0.6691537986411366,0
1254,1255,Horamavu,119400,88430,30970,0.2593802345058627,1
1255,1256,Shivajinagar,243500,43820,199680,0.820041067761807,-1
1256,1257,Whitefield,235750,85240,150510,0.6384305408271475,0
1257,1258,Kammanahalli,99550,100580,-1030,-0.010346559517830235,1
1258,1259,Banaswadi,209650,60900,148750,0.7095158597662772,0
1259,1260,Hoodi,183500,32410,151090,0.8233787465940055,0
1260,1261,CV Raman Nagar,65800,119880,-54080,-0.8218844984802431,1
1261,1262,Varthur,54500,21070,33430,0.6133944954128441,0
1262,1263,Marathahalli,324900,112990,211910,0.6522314558325638,0
1263,1264,Hoodi,73000,14150,58850,0.8061643835616439,-1
1264,1265,Jalahalli,398500,42670,355830,0.8929234629861983,-1
1265,1266,Mahadevapura,290300,61500,228800,0.7881501894591801,0
1266,1267,Varthur,258150,136360,121790,0.47177997288398216,1
1267,1268,Kalyan Nagar,234550,81950,152600,0.6506075463653805,0
1268,1269,Shivajinagar,118800,47060,71740,0.6038720538720539,0
1269,1270,Marathahalli,189500,51150,138350,0.7300791556728232,0
1270,1271,Kammanahalli,120550,189110,-68560,-0.5687266694317711,1
1271,1272,Banaswadi,266250,89260,176990,0.6647511737089202,0
1272,1273,Horamavu,349050,124350,224700,0.6437473141383756,0
1273,1274,HBR Layout,110550,42380,68170,0.616644052464948,0
1274,1275,Marathahalli,284150,44040,240110,0.8450114376209749,-1
1275,1276,Horamavu,180950,52270,128680,0.7111356728378005,0
1276,1277,HBR Layout,173250,91720,81530,0.4705916305916306,1
1277,1278,Krishnarajapuram,142450,95850,46600,0.32713232713232715,1
1278,1279,Horamavu,248000,91360,156640,0.6316129032258064,0
1279,1280,Hebbal,178750,57570,121180,0.6779300699300699,0
1280,1281,Mahadevapura,315600,58760,256840,0.8138149556400507,0
1281,1282,Horamavu,327050,110140,216910,0.663231921724507,0
1282,1283,Hebbal,163050,78760,84290,0.5169579883471328,0
1283,1284,HBR Layout,339100,23910,315190,0.9294898260100265,-1
1284,1285,Hoodi,260550,57200,203350,0.7804644022260603,0
1285,1286,Indiranagar,353250,96400,256850,0.727105449398443,0
1286,1287,Marathahalli,57250,79770,-22520,-0.39336244541484716,1
1287,1288,Hebbal,310300,64430,245870,0.7923622300999034,0
1288,1289,Hebbal,447550,82660,364890,0.81530555245224,0
1289,1290,Indiranagar,30600,51220,-20620,-0.6738562091503268,1
1290,1291,Kalyan Nagar,414650,0,414650,1.0,-1
1291,1292,HBR Layout,228950,82890,146060,0.6379558855645338,0
1292,1293,Hoodi,288600,48890,239710,0.8305959805959806,0
1293,1294,Whitefield,29400,60050,-30650,-1.0425170068027212,1
1294,1295,Indiranagar,45250,34720,10530,0.232707182320442,1
1295,1296,Jalahalli,237900,62900,175000,0.735603194619588,-1
1296,1297,Krishnarajapuram,181550,33580,147970,0.8150371798402644,0
1297,1298,Marathahalli,103200,196600,-93400,-0.9050387596899225,1
1298,1299,Horamavu,438500,61690,376810,0.8593158494868871,-1
1299,1300,Kalyan Nagar,401650,19240,382410,0.9520975974106809,-1
1300,1301,Hoodi,368050,50030,318020,0.8640673821491646,0
1301,1302,Hebbal,44600,82100,-37500,-0.8408071748878924,1
1302,1303,Rajajinagar,406500,40930,365570,0.8993111931119311,-1
1303,1304,Horamavu,224900,26240,198660,0.883325922632281,-1
1304,1305,Horamavu,341700,33180,308520,0.9028972783143108,-1
1305,1306,Indiranagar,187250,22550,164700,0.8795727636849132,-1
1306,1307,Krishnarajapuram,162150,59000,103150,0.6361393771199506,0
1307,1308,Malleswaram,398850,39120,359730,0.9019180142910869,-1
1308,1309,Malleswaram,357700,81840,275860,0.7712049203242941,0
1309,1310,Vasanth Nagar,266900,76830,190070,0.7121393780442113,-1
1310,1311,Kalyan Nagar,301000,62540,238460,0.7922259136212625,0
1311,1312,Kammanahalli,353600,0,353600,1.0,-1
1312,1313,Indiranagar,367100,75930,291170,0.7931626259874693,0
1313,1314,Hebbal,314750,65370,249380,0.7923113582208101,0
1314,1315,Rajajinagar,165950,121720,44230,0.2665260620668876,1
1315,1316,Mahadevapura,328100,83280,244820,0.7461749466626029,0
1316,1317,Jalahalli,341150,46300,294850,0.8642825736479555,-1
1317,1318,Varthur,186450,63080,123370,0.6616787342451059,0
1318,1319,Whitefield,55950,21380,34570,0.6178731009830205,0
1319,1320,Hebbal,445300,84950,360350,0.8092297327644284,-1
1320,1321,Krishnarajapuram,225600,126460,99140,0.4394503546099291,0
1321,1322,HBR Layout,244300,16470,227830,0.9325828898894801,-1
1322,1323,Varthur,361750,94260,267490,0.7394333102971665,0
1323,1324,Rajajinagar,191000,51880,139120,0.7283769633507854,0
1324,1325,Mahadevapura,148200,47520,100680,0.6793522267206478,0
1325,1326,Kammanahalli,172000,72320,99680,0.5795348837209302,0
1326,1327,Krishnarajapuram,376050,41480,334570,0.8896955192128706,-1
1327,1328,CV Raman Nagar,250100,62940,187160,0.7483406637345063,0
1328,1329,Mahadevapura,60700,125540,-64840,-1.0682042833607908,1
1329,1330,Vasanth Nagar,262050,44640,217410,0.8296508299942759,-1
1330,1331,Indiranagar,337600,39690,297910,0.8824348341232228,-1
1331,1332,Vasanth Nagar,209400,21850,187550,0.8956542502387774,-1
1332,1333,Whitefield,224850,48000,176850,0.7865243495663776,0
1333,1334,Malleswaram,243850,81620,162230,0.665286036497847,0
1334,1335,Varthur,310500,103500,207000,0.6666666666666666,0
1335,1336,Jalahalli,221200,6120,215080,0.9723327305605787,-1
1336,1337,Vasanth Nagar,275600,68540,207060,0.7513062409288824,-1
1337,1338,Horamavu,60350,49550,10800,0.17895608947804473,1
1338,1339,Horamavu,179750,37720,142030,0.7901529902642559,-1
1339,1340,Jalahalli,37950,76860,-38910,-1.0252964426877471,1
1340,1341,HBR Layout,173250,42540,130710,0.7544588744588745,0
1341,1342,Horamavu,441200,129520,311680,0.7064369900271985,0
1342,1343,Banaswadi,380050,54210,325840,0.8573608735692672,0
1343,1344,Whitefield,184700,26160,158540,0.85836491608013,-1
1344,1345,Jalahalli,425700,18880,406820,0.9556495184402161,-1
1345,1346,Jalahalli,74050,35480,38570,0.5208642808912897,1
1346,1347,Mahadevapura,222500,25850,196650,0.8838202247191012,-1
1347,1348,Varthur,342100,70320,271780,0.7944460684010524,-1
1348,1349,Shivajinagar,340500,51960,288540,0.8474008810572687,-1
1349,1350,Rajajinagar,367000,73350,293650,0.8001362397820163,-1
1350,1351,Jalahalli,33550,100850,-67300,-2.005961251862891,1
1351,1352,Kalyan Nagar,433550,66520,367030,0.8465690231807174,0
1352,1353,Marathahalli,105200,95050,10150,0.09648288973384031,1
1353,1354,Banaswadi,175050,66250,108800,0.6215367037989146,0
1354,1355,Varthur,410700,4230,406470,0.989700511322133,-1
1355,1356,Vasanth Nagar,68200,99830,-31630,-0.46378299120234606,1
1356,1357,Indiranagar,225450,60480,164970,0.7317365269461078,-1
1357,1358,CV Raman Nagar,308200,101620,206580,0.6702790395846853,0
1358,1359,Kalyan Nagar,93350,8810,84540,0.9056239957150509,-1
1359,1360,Hoodi,160450,87710,72740,0.4533499532564662,1
1360,1361,Krishnarajapuram,184400,33060,151340,0.8207158351409979,-1
1361,1362,Marathahalli,362100,64280,297820,0.8224799779066556,-1
1362,1363,CV Raman Nagar,282950,92180,190770,0.6742180597278671,0
1363,1364,CV Raman Nagar,113250,65290,47960,0.4234878587196468,0
1364,1365,Hoodi,428850,39290,389560,0.9083828844584354,-1
1365,1366,HBR Layout,399100,121310,277790,0.6960410924580306,0
1366,1367,Shivajinagar,65200,66300,-1100,-0.01687116564417178,1
1367,1368,Shivajinagar,88400,59890,28510,0.3225113122171946,1
1368,1369,Whitefield,359650,48340,311310,0.8655915473376894,-1
1369,1370,Malleswaram,172100,88420,83680,0.4862289366647298,0
1370,1371,CV Raman Nagar,243650,31840,211810,0.8693207469731172,0
1371,1372,Jalahalli,290950,74360,216590,0.7444234404536862,-1
1372,1373,Malleswaram,419400,43950,375450,0.8952074391988555,0
1373,1374,Kammanahalli,343800,117020,226780,0.6596276905177428,0
1374,1375,Horamavu,280200,43890,236310,0.8433618843683084,0
1375,1376,Marathahalli,215800,57020,158780,0.7357738646895273,0
1376,1377,Marathahalli,265500,75260,190240,0.7165348399246705,0
1377,1378,Vasanth Nagar,436000,113700,322300,0.7392201834862385,0
1378,1379,Jalahalli,292850,21640,271210,0.9261055147686529,-1
1379,1380,Jalahalli,288550,69490,219060,0.7591751862762086,0
1380,1381,HBR Layout,308250,60650,247600,0.8032441200324412,-1
1381,1382,Vasanth Nagar,296550,65090,231460,0.7805091890069128,-1
1382,1383,Vasanth Nagar,413650,38220,375430,0.9076030460534268,-1
1383,1384,HBR Layout,186800,42850,143950,0.770610278372591,-1
1384,1385,Vasanth Nagar,235200,25890,209310,0.8899234693877551,-1
1385,1386,Jalahalli,164000,103580,60420,0.36841463414634146,1
1386,1387,Whitefield,76950,93520,-16570,-0.21533463287849253,1
1387,1388,Malleswaram,372300,67860,304440,0.8177276390008058,0
1388,1389,Marathahalli,297050,65980,231070,0.7778825113617236,0
1389,1390,Malleswaram,309350,108160,201190,0.6503636657507678,0
1390,1391,Malleswaram,153750,34650,119100,0.7746341463414634,-1
1391,1392,Banaswadi,349700,85380,264320,0.7558478696025165,-1
1392,1393,Kalyan Nagar,71750,72660,-910,-0.012682926829268294,1
1393,1394,Jalahalli,96450,29740,66710,0.6916537065837222,0
1394,1395,Malleswaram,372600,35500,337100,0.904723564143854,-1
1395,1396,Kalyan Nagar,426500,80320,346180,0.8116764361078547,0
1396,1397,Marathahalli,175300,29270,146030,0.833029092983457,-1
1397,1398,Mahadevapura,197650,50220,147430,0.7459144953200101,0
1398,1399,Krishnarajapuram,190150,58330,131820,0.6932421772285038,0
1399,1400,Hoodi,389650,46970,342680,0.8794559219812652,0
1400,1401,Hebbal,250650,54170,196480,0.7838819070416916,0
1401,1402,Horamavu,215550,37330,178220,0.8268151241011367,-1
1402,1403,Whitefield,227300,24070,203230,0.8941047074351078,-1
1403,1404,Vasanth Nagar,225950,37200,188750,0.8353618057092277,-1
1404,1405,Banaswadi,366000,53000,313000,0.855191256830601,-1
1405,1406,Malleswaram,190300,60480,129820,0.6821860220704151,0
1406,1407,Hebbal,173050,14910,158140,0.9138399306558798,-1
1407,1408,Krishnarajapuram,169200,63190,106010,0.6265366430260048,0
1408,1409,Kalyan Nagar,402350,57390,344960,0.8573629924195353,0
1409,1410,CV Raman Nagar,218500,53790,164710,0.7538215102974828,0
1410,1411,Shivajinagar,371700,38980,332720,0.8951304815711595,-1
1411,1412,Indiranagar,144050,65850,78200,0.5428670600485942,0
1412,1413,Marathahalli,143050,80630,62420,0.43635092624956306,1
1413,1414,Jalahalli,219100,36170,182930,0.8349155636695573,-1
1414,1415,Shivajinagar,137450,2880,134570,0.9790469261549655,-1
1415,1416,Hebbal,343550,68000,275550,0.8020666569640518,-1
1416,1417,HBR Layout,411950,54840,357110,0.8668770481854594,-1
1417,1418,Vasanth Nagar,326000,49250,276750,0.8489263803680982,0
1418,1419,Vasanth Nagar,150700,71240,79460,0.5272727272727272,1
1419,1420,Mahadevapura,428650,22850,405800,0.9466931062638516,-1
1420,1421,Jalahalli,39450,52630,-13180,-0.33409378960709757,1
1421,1422,Varthur,167900,45470,122430,0.7291840381179273,0
1422,1423,HBR Layout,220900,76320,144580,0.6545043005885016,0
1423,1424,Jalahalli,88750,62100,26650,0.30028169014084505,1
1424,1425,Varthur,47700,141870,-94170,-1.9742138364779873,1
1425,1426,Shivajinagar,61450,47970,13480,0.2193653376729048,1
1426,1427,Marathahalli,215050,52680,162370,0.755033713089979,0
1427,1428,Whitefield,197900,48310,149590,0.7558868115209701,0
1428,1429,Whitefield,117150,69860,47290,0.40367050789586,1
1429,1430,Krishnarajapuram,244450,113080,131370,0.5374105133974227,1
1430,1431,Shivajinagar,357800,63070,294730,0.8237283398546674,0
1431,1432,Kalyan Nagar,427400,44560,382840,0.8957416939635002,-1
1432,1433,Hoodi,250850,96310,154540,0.6160653777157664,0
1433,1434,Indiranagar,183350,37640,145710,0.7947095718571039,-1
1434,1435,Indiranagar,413400,93100,320300,0.7747943880019351,0
1435,1436,Shivajinagar,361450,58060,303390,0.8393692073592475,0
1436,1437,HBR Layout,252650,22790,229860,0.9097961606966158,-1
1437,1438,Horamavu,201700,5040,196660,0.9750123946455131,-1
1438,1439,Banaswadi,143550,74630,68920,0.4801114594218043,0
1439,1440,Krishnarajapuram,434400,129380,305020,0.7021639042357274,0
1440,1441,Shivajinagar,448550,57050,391500,0.8728123954966002,-1
1441,1442,Mahadevapura,325900,50190,275710,0.8459957042037435,-1
1442,1443,Mahadevapura,398400,9850,388550,0.9752761044176707,-1
1443,1444,Horamavu,57300,50170,7130,0.1244328097731239,1
1444,1445,Malleswaram,276900,83820,193080,0.6972914409534128,0
1445,1446,Hebbal,62600,60950,1650,0.026357827476038338,1
1446,1447,Hoodi,238850,102980,135870,0.5688507431442328,1
1447,1448,HBR Layout,389950,79500,310450,0.7961277086806001,0
1448,1449,Vasanth Nagar,100800,67030,33770,0.33501984126984125,1
1449,1450,Rajajinagar,447350,52110,395240,0.8835140270481726,0
1450,1451,Marathahalli,212350,40900,171450,0.8073934542029668,0
1451,1452,Shivajinagar,153050,39720,113330,0.7404769683110095,0
1452,1453,CV Raman Nagar,192750,33020,159730,0.8286900129701686,-1
1453,1454,Marathahalli,270600,44340,226260,0.8361419068736142,-1
1454,1455,CV Raman Nagar,74900,89690,-14790,-0.19746328437917224,1
1455,1456,Mahadevapura,376100,0,376100,1.0,-1
1456,1457,Rajajinagar,121100,40850,80250,0.6626754748142032,0
1457,1458,Kammanahalli,240250,59710,180540,0.7514672216441207,-1
1458,1459,Krishnarajapuram,197950,70070,127880,0.6460217226572367,0
1459,1460,Rajajinagar,50000,58730,-8730,-0.1746,1
1460,1461,HBR Layout,404000,44210,359790,0.890569306930693,0
1461,1462,Marathahalli,131000,111710,19290,0.14725190839694657,1
1462,1463,Kalyan Nagar,176800,59310,117490,0.6645361990950226,0
1463,1464,Krishnarajapuram,408900,43390,365510,0.8938860357055515,-1
1464,1465,Rajajinagar,30700,91900,-61200,-1.993485342019544,1
1465,1466,Varthur,423600,38260,385340,0.9096789423984891,-1
1466,1467,Kalyan Nagar,302550,83200,219350,0.7250041315485044,-1
1467,1468,Varthur,217750,43120,174630,0.8019747416762342,-1
1468,1469,Horamavu,448500,32540,415960,0.9274470457079153,-1
1469,1470,Hebbal,298250,91150,207100,0.6943839061190277,0
1470,1471,Hebbal,79200,60170,19030,0.24027777777777778,1
1471,1472,Malleswaram,35350,31570,3780,0.10693069306930693,1
1472,1473,Jalahalli,30800,86240,-55440,-1.8,1
1473,1474,Hebbal,326150,24840,301310,0.9238387245132608,-1
1474,1475,Vasanth Nagar,423300,32360,390940,0.9235530356721001,-1
1475,1476,Hebbal,144500,119490,25010,0.1730795847750865,1
1476,1477,Indiranagar,251900,36090,215810,0.8567288606589917,-1
1477,1478,Mahadevapura,432100,31150,400950,0.9279102059708401,-1
1478,1479,Hoodi,66750,96950,-30200,-0.45243445692883894,1
1479,1480,Varthur,70700,66060,4640,0.06562942008486564,1
1480,1481,Hoodi,312350,105230,207120,0.6631022890987675,0
1481,1482,Mahadevapura,219000,30650,188350,0.8600456621004566,-1
1482,1483,Kammanahalli,407050,42600,364450,0.8953445522663064,0
1483,1484,Hebbal,316250,49210,267040,0.844395256916996,0
1484,1485,Shivajinagar,405550,53160,352390,0.8689187523116755,0
1485,1486,Kammanahalli,152050,29930,122120,0.8031568562972706,-1
1486,1487,Indiranagar,76550,85980,-9430,-0.12318745917700849,1
1487,1488,Banaswadi,108650,82770,25880,0.23819604233778185,1
1488,1489,Horamavu,402650,45740,356910,0.8864025828883646,0
1489,1490,Jalahalli,318950,40230,278720,0.8738673773318703,-1
1490,1491,Whitefield,125000,28470,96530,0.77224,0
1491,1492,Jalahalli,152400,78670,73730,0.48379265091863516,1
1492,1493,Whitefield,249000,59680,189320,0.7603212851405623,-1
1493,1494,Hebbal,439250,39130,400120,0.9109163346613546,-1
1494,1495,Banaswadi,221750,109720,112030,0.5052085682074409,0
1495,1496,HBR Layout,28850,54630,-25780,-0.8935875216637782,1
1496,1497,CV Raman Nagar,361250,69200,292050,0.8084429065743944,-1
1497,1498,Kammanahalli,405450,52750,352700,0.8698976445924281,-1
1498,1499,CV Raman Nagar,164750,55650,109100,0.6622154779969651,0
1499,1500,Marathahalli,361050,32850,328200,0.9090153718321562,-1
1500,1501,Whitefield,261300,80140,181160,0.6933027171833142,0
1501,1502,Horamavu,29950,114190,-84240,-2.812687813021703,1
1502,1503,Kammanahalli,100700,32280,68420,0.6794438927507448,0
1503,1504,Mahadevapura,276900,32240,244660,0.8835680751173709,-1
1504,1505,HBR Layout,288400,21430,266970,0.9256934812760056,-1
1505,1506,Jalahalli,334900,64110,270790,0.8085697223051658,-1
1506,1507,Hoodi,91850,60220,31630,0.3443658138268917,1
1507,1508,Shivajinagar,80600,51800,28800,0.3573200992555831,1
1508,1509,Mahadevapura,296700,110760,185940,0.6266936299292214,0
1509,1510,Hebbal,131950,118280,13670,0.10359984842743464,1
1510,1511,Vasanth Nagar,237850,113760,124090,0.5217153668278327,0
1511,1512,Whitefield,355200,29710,325490,0.916356981981982,-1
1512,1513,Kalyan Nagar,175900,100970,74930,0.4259806708357021,0
1513,1514,Whitefield,48300,69330,-21030,-0.43540372670807453,1
1514,1515,Varthur,86500,59080,27420,0.3169942196531792,1
1515,1516,Rajajinagar,43300,60500,-17200,-0.3972286374133949,1
1516,1517,Hoodi,173400,45960,127440,0.7349480968858132,0
1517,1518,Kammanahalli,367750,74120,293630,0.7984500339904826,0
1518,1519,Kalyan Nagar,245850,96830,149020,0.606141956477527,0
1519,1520,Vasanth Nagar,256750,20080,236670,0.9217916260954235,-1
1520,1521,Vasanth Nagar,288100,61170,226930,0.7876778896216592,-1
1521,1522,CV Raman Nagar,332450,39030,293420,0.8825988870506843,0
1522,1523,Horamavu,108050,94170,13880,0.12845904673762149,1
1523,1524,Kalyan Nagar,166950,27840,139110,0.8332434860736747,0
1524,1525,Hoodi,393450,8570,384880,0.9782183250730715,-1
1525,1526,Hebbal,255550,89600,165950,0.649383682253962,0
1526,1527,Indiranagar,85900,14540,71360,0.8307334109429569,-1
1527,1528,Krishnarajapuram,142850,48050,94800,0.6636331816590829,0
1528,1529,Horamavu,80200,27450,52750,0.6577306733167082,0
1529,1530,Kammanahalli,150200,42320,107880,0.718242343541944,0
1530,1531,Kalyan Nagar,171500,28240,143260,0.83533527696793,0
1531,1532,Varthur,386700,48940,337760,0.8734419446599431,-1
1532,1533,Krishnarajapuram,351000,50030,300970,0.8574643874643875,0
1533,1534,Vasanth Nagar,349300,35890,313410,0.8972516461494418,0
1534,1535,Varthur,85100,33610,51490,0.6050528789659224,0
1535,1536,Hebbal,68000,28080,39920,0.5870588235294117,0
1536,1537,Whitefield,159150,23830,135320,0.8502670436694942,0
1537,1538,Whitefield,58000,60340,-2340,-0.040344827586206895,1
1538,1539,Krishnarajapuram,355550,38680,316870,0.8912108001687526,-1
1539,1540,Shivajinagar,81100,19670,61430,0.7574599260172626,0
1540,1541,Malleswaram,216400,35440,180960,0.8362292051756007,-1
1541,1542,Mahadevapura,322950,123220,199730,0.6184548691747949,0
1542,1543,Jalahalli,400600,40270,360330,0.8994757863205192,0
1543,1544,Indiranagar,185300,85840,99460,0.5367512142471668,0
1544,1545,CV Raman Nagar,289000,64650,224350,0.7762975778546712,0
1545,1546,Hoodi,314900,47760,267140,0.8483328040647825,0
1546,1547,Rajajinagar,427350,99250,328100,0.7677547677547678,-1
1547,1548,Whitefield,361000,44630,316370,0.876371191135734,-1
1548,1549,CV Raman Nagar,97650,90050,7600,0.07782898105478751,1
1549,1550,Hoodi,181250,43380,137870,0.7606620689655172,0
1550,1551,Kammanahalli,272700,55810,216890,0.7953428676200953,0
1551,1552,Banaswadi,55450,57250,-1800,-0.032461677186654644,1
1552,1553,Shivajinagar,63450,80180,-16730,-0.263672182821119,1
1553,1554,Kammanahalli,449650,34770,414880,0.9226731902590904,-1
1554,1555,Marathahalli,243200,102960,140240,0.5766447368421053,0
1555,1556,Hebbal,276450,79980,196470,0.7106890938686924,0
1556,1557,Hoodi,268500,12040,256460,0.9551582867783985,-1
1557,1558,Malleswaram,159050,126270,32780,0.20609871109713926,1
1558,1559,Hoodi,93550,22050,71500,0.7642971672902191,0
1559,1560,CV Raman Nagar,299000,28390,270610,0.9050501672240803,-1
1560,1561,Rajajinagar,429650,64560,365090,0.8497381589666008,-1
1561,1562,Marathahalli,165350,34110,131240,0.7937103114605383,-1
1562,1563,Shivajinagar,76900,38780,38120,0.49570871261378413,1
1563,1564,Banaswadi,427850,40350,387500,0.905691246932336,-1
1564,1565,HBR Layout,138850,23920,114930,0.8277277637738567,-1
1565,1566,Krishnarajapuram,304450,120620,183830,0.6038101494498276,0
1566,1567,Shivajinagar,295800,20750,275050,0.9298512508451656,-1
1567,1568,Shivajinagar,318050,37120,280930,0.8832887910705863,0
1568,1569,Whitefield,249700,150600,99100,0.39687625150180217,1
1569,1570,Rajajinagar,72100,35310,36790,0.5102635228848821,0
1570,1571,Banaswadi,324550,61280,263270,0.8111847173008782,0
1571,1572,Indiranagar,185050,49420,135630,0.7329370440421508,-1
1572,1573,Horamavu,282100,58030,224070,0.7942928039702233,0
1573,1574,Whitefield,304350,72570,231780,0.7615574174470182,0
1574,1575,Indiranagar,302150,71100,231050,0.7646864140327652,0
1575,1576,HBR Layout,136850,68200,68650,0.5016441359152357,0
1576,1577,Marathahalli,440850,86410,354440,0.8039922876261767,0
1577,1578,Kalyan Nagar,285150,68350,216800,0.7603015956514115,0
1578,1579,Hebbal,358050,43600,314450,0.8782292975841363,0
1579,1580,Whitefield,404600,25540,379060,0.9368759268413248,-1
1580,1581,Shivajinagar,144050,32490,111560,0.7744533148212426,0
1581,1582,Malleswaram,210450,59270,151180,0.7183654074602043,0
1582,1583,Mahadevapura,102650,88580,14070,0.13706770579639552,1
1583,1584,Shivajinagar,37200,45690,-8490,-0.22822580645161292,1
1584,1585,Hebbal,260550,79660,180890,0.6942621377854539,0
1585,1586,Hebbal,156650,48160,108490,0.6925630386211299,0
1586,1587,Indiranagar,247850,52440,195410,0.7884204155739358,0
1587,1588,Shivajinagar,218850,54990,163860,0.7487320082248116,0
1588,1589,Whitefield,92950,16480,76470,0.8227003765465304,-1
1589,1590,Malleswaram,396300,77550,318750,0.8043149129447388,-1
1590,1591,Kammanahalli,54300,62230,-7930,-0.14604051565377532,1
1591,1592,HBR Layout,105000,77320,27680,0.26361904761904764,1
1592,1593,Kalyan Nagar,70300,66390,3910,0.05561877667140825,1
1593,1594,Malleswaram,290950,78220,212730,0.7311565561092971,0
1594,1595,Shivajinagar,360800,134550,226250,0.6270787139689579,0
1595,1596,Varthur,419800,17520,402280,0.9582658408766079,-1
1596,1597,Jalahalli,252200,75340,176860,0.7012688342585249,0
1597,1598,Kammanahalli,185250,79570,105680,0.570472334682861,1
1598,1599,Kalyan Nagar,119850,71790,48060,0.4010012515644556,1
1599,1600,Shivajinagar,128750,10100,118650,0.9215533980582524,-1
1600,1601,Marathahalli,169900,41160,128740,0.7577398469688051,0
1601,1602,Jalahalli,167850,46000,121850,0.7259457849270182,-1
1602,1603,Jalahalli,366100,95510,270590,0.7391149959027589,0
1603,1604,Banaswadi,316800,79730,237070,0.7483270202020202,-1
1604,1605,Hoodi,52650,61030,-8380,-0.15916429249762584,1
1605,1606,Krishnarajapuram,395700,43280,352420,0.8906242102602983,0
1606,1607,Krishnarajapuram,107250,96670,10580,0.09864801864801864,1
1607,1608,Vasanth Nagar,215200,68160,147040,0.683271375464684,0
1608,1609,Kammanahalli,313900,69820,244080,0.7775724753106085,0
1609,1610,Hebbal,78650,85560,-6910,-0.08785759694850603,1
1610,1611,CV Raman Nagar,305250,73940,231310,0.7577723177723178,-1
1611,1612,Krishnarajapuram,250900,26190,224710,0.89561578318055,-1
1612,1613,Kammanahalli,49750,114670,-64920,-1.304924623115578,1
1613,1614,Rajajinagar,139250,14720,124530,0.8942908438061041,-1
1614,1615,Indiranagar,83700,97210,-13510,-0.16140979689366786,1
1615,1616,Whitefield,256700,74230,182470,0.7108297623685236,-1
1616,1617,Jalahalli,287850,84460,203390,0.7065832899079382,0
1617,1618,Hebbal,269050,43560,225490,0.8380970079910798,0
1618,1619,Krishnarajapuram,202850,36280,166570,0.8211486319940843,0
1619,1620,CV Raman Nagar,397000,49350,347650,0.8756926952141058,-1
1620,1621,Indiranagar,159350,68310,91040,0.5713209915280828,0
1621,1622,Shivajinagar,32900,15620,17280,0.5252279635258359,0
1622,1623,Vasanth Nagar,227400,12580,214820,0.9446789797713281,-1
1623,1624,Vasanth Nagar,112750,80890,31860,0.2825720620842572,1
1624,1625,Malleswaram,152200,36630,115570,0.7593298291721419,-1
1625,1626,Horamavu,249350,9830,239520,0.9605775015039102,-1
1626,1627,Whitefield,435100,62780,372320,0.8557113307285682,-1
1627,1628,Kalyan Nagar,322100,140760,181340,0.5629928593604471,0
1628,1629,Jalahalli,99150,17610,81540,0.8223903177004539,0
1629,1630,Malleswaram,44950,67830,-22880,-0.5090100111234706,1
1630,1631,Whitefield,162650,59920,102730,0.631601598524439,0
1631,1632,Rajajinagar,148800,45330,103470,0.6953629032258064,0
1632,1633,Kalyan Nagar,94800,51810,42990,0.4534810126582278,1
1633,1634,Vasanth Nagar,151700,24230,127470,0.8402768622280817,-1
1634,1635,Hoodi,384400,59340,325060,0.8456295525494277,0
1635,1636,Indiranagar,435600,68090,367510,0.8436868686868687,-1
1636,1637,Jalahalli,103550,69060,34490,0.3330758087880251,1
1637,1638,Hoodi,317250,33060,284190,0.895791962174941,-1
1638,1639,Kalyan Nagar,420600,61340,359260,0.8541607227769853,-1
1639,1640,Malleswaram,147400,29430,117970,0.8003392130257801,0
1640,1641,HBR Layout,316150,48960,267190,0.8451368021508777,-1
1641,1642,Rajajinagar,389350,46570,342780,0.8803903942468216,-1
1642,1643,Shivajinagar,256950,87730,169220,0.658571706557696,0
1643,1644,Mahadevapura,140450,84650,55800,0.3972944108223567,1
1644,1645,Kalyan Nagar,254850,84650,170200,0.6678438297037473,0
1645,1646,HBR Layout,163250,48810,114440,0.701010719754977,-1
1646,1647,Banaswadi,273650,22100,251550,0.9192399049881235,-1
1647,1648,Rajajinagar,237100,101760,135340,0.5708140025305778,0
1648,1649,Whitefield,44200,86510,-42310,-0.9572398190045249,1
1649,1650,CV Raman Nagar,342500,37900,304600,0.8893430656934307,0
1650,1651,Hebbal,84700,51220,33480,0.39527744982290436,1
1651,1652,Vasanth Nagar,263750,78480,185270,0.7024454976303317,-1
1652,1653,Varthur,193750,116660,77090,0.3978838709677419,1
1653,1654,Horamavu,383800,93590,290210,0.7561490359562272,0
1654,1655,HBR Layout,300950,55140,245810,0.8167801960458548,0
1655,1656,Kalyan Nagar,69350,62400,6950,0.10021629416005767,1
1656,1657,Hoodi,319550,65550,254000,0.79486778281959,0
1657,1658,Vasanth Nagar,111450,22370,89080,0.7992821893225662,0
1658,1659,Rajajinagar,297900,72300,225600,0.75730110775428,0
1659,1660,Jalahalli,134050,50650,83400,0.6221559119731443,0
1660,1661,Varthur,368400,47500,320900,0.8710640608034745,-1
1661,1662,Horamavu,442950,82080,360870,0.8146969183880799,0
1662,1663,Kammanahalli,364000,55450,308550,0.8476648351648352,-1
1663,1664,Kalyan Nagar,368300,49320,318980,0.8660874287265816,-1
1664,1665,Rajajinagar,433600,70450,363150,0.8375230627306273,-1
1665,1666,Whitefield,80600,51340,29260,0.3630272952853598,1
1666,1667,Vasanth Nagar,248500,72250,176250,0.7092555331991952,0
1667,1668,Jalahalli,383800,73920,309880,0.8073996873371547,0
1668,1669,HBR Layout,232000,113280,118720,0.5117241379310344,0
1669,1670,Kammanahalli,257050,24710,232340,0.9038708422485898,-1
1670,1671,Krishnarajapuram,26250,107710,-81460,-3.1032380952380954,1
1671,1672,Varthur,347450,49690,297760,0.8569866167793927,0
1672,1673,Vasanth Nagar,181600,95390,86210,0.4747246696035242,0
1673,1674,Rajajinagar,443050,40160,402890,0.9093556032050558,-1
1674,1675,Mahadevapura,28050,91870,-63820,-2.275222816399287,1
1675,1676,Varthur,195100,61850,133250,0.6829830855971297,0
1676,1677,Kammanahalli,89900,75320,14580,0.1621802002224694,1
1677,1678,CV Raman Nagar,103400,64640,38760,0.37485493230174083,1
1678,1679,Malleswaram,268450,60590,207860,0.7742968895511269,0
1679,1680,Horamavu,148000,27920,120080,0.8113513513513514,-1
1680,1681,CV Raman Nagar,36700,48860,-12160,-0.3313351498637602,1
1681,1682,Hebbal,338350,46650,291700,0.8621250184719964,0
1682,1683,Hebbal,146400,74080,72320,0.49398907103825135,1
1683,1684,CV Raman Nagar,418050,27810,390240,0.9334768568353068,-1
1684,1685,Hoodi,228900,34310,194590,0.8501092179991263,-1
1685,1686,Horamavu,324400,142930,181470,0.5594019728729963,0
1686,1687,Whitefield,144900,37250,107650,0.7429261559696342,0
1687,1688,Vasanth Nagar,78850,128830,-49980,-0.6338617628408371,1
1688,1689,HBR Layout,407750,41180,366570,0.8990067443286327,0
1689,1690,Banaswadi,241200,41170,200030,0.8293117744610282,-1
1690,1691,Jalahalli,413300,122900,290400,0.7026373094604403,0
1691,1692,Vasanth Nagar,167650,108540,59110,0.3525797793021175,1
1692,1693,Banaswadi,290000,50050,239950,0.8274137931034483,0
1693,1694,Krishnarajapuram,446150,36400,409750,0.9184130897680153,-1
1694,1695,Kammanahalli,406850,30550,376300,0.9249109008233993,-1
1695,1696,Krishnarajapuram,101950,119370,-17420,-0.1708680725846003,1
1696,1697,Banaswadi,161350,57350,104000,0.644561512240471,0
1697,1698,Kammanahalli,118300,134500,-16200,-0.13693998309382924,1
1698,1699,Marathahalli,186250,120840,65410,0.3511946308724832,1
1699,1700,Vasanth Nagar,346700,48080,298620,0.8613210268243439,-1
1700,1701,Horamavu,195200,25720,169480,0.8682377049180328,-1
1701,1702,Kammanahalli,241300,56940,184360,0.7640281806879403,0
1702,1703,Jalahalli,267950,66930,201020,0.7502145922746781,-1
1703,1704,Rajajinagar,442550,116250,326300,0.737317817195797,-1
1704,1705,Mahadevapura,420400,100770,319630,0.7602997145575642,0
1705,1706,Mahadevapura,56350,19880,36470,0.6472049689440994,0
1706,1707,Malleswaram,169050,50150,118900,0.7033422064477965,-1
1707,1708,HBR Layout,112500,37460,75040,0.6670222222222222,0
1708,1709,Shivajinagar,75050,46760,28290,0.3769487008660893,1
1709,1710,Krishnarajapuram,230650,31180,199470,0.8648168220247128,0
1710,1711,Mahadevapura,111000,35630,75370,0.679009009009009,0
1711,1712,CV Raman Nagar,422750,43440,379310,0.897244234180958,-1
1712,1713,Mahadevapura,205950,34250,171700,0.8336974993930566,-1
1713,1714,Kalyan Nagar,70600,59800,10800,0.1529745042492918,1
1714,1715,Krishnarajapuram,405500,53830,351670,0.8672503082614057,-1
1715,1716,Indiranagar,425350,112260,313090,0.736076172563771,0
1716,1717,Krishnarajapuram,174700,98460,76240,0.4364052661705781,0
1717,1718,Kammanahalli,339050,45680,293370,0.8652706090547116,0
1718,1719,Malleswaram,345300,41820,303480,0.8788879235447437,-1
1719,1720,Varthur,153650,44730,108920,0.7088838268792711,-1
1720,1721,Jalahalli,425350,48210,377140,0.8866580463147996,0
1721,1722,Hoodi,286450,73970,212480,0.7417699423983243,0
1722,1723,Banaswadi,261700,73970,187730,0.7173481085212075,0
1723,1724,Malleswaram,70400,39790,30610,0.4348011363636364,1
1724,1725,Varthur,325850,69470,256380,0.7868037440540125,0
1725,1726,CV Raman Nagar,369850,11640,358210,0.968527781533054,-1
1726,1727,Vasanth Nagar,68350,46830,21520,0.3148500365764448,1
1727,1728,HBR Layout,38250,82530,-44280,-1.1576470588235295,1
1728,1729,Krishnarajapuram,274950,58850,216100,0.7859610838334242,0
1729,1730,Varthur,245200,74000,171200,0.6982055464926591,0
1730,1731,Kammanahalli,27550,27610,-60,-0.002177858439201452,1
1731,1732,Whitefield,85150,52830,32320,0.3795654726952437,1
1732,1733,Shivajinagar,274850,62630,212220,0.7721302528651992,-1
1733,1734,Hoodi,268850,138300,130550,0.48558675841547333,1
1734,1735,Marathahalli,342800,79300,263500,0.7686697782963827,0
1735,1736,Hoodi,176750,88990,87760,0.4965205091937765,1
1736,1737,Jalahalli,307700,55100,252600,0.8209294767630809,-1
1737,1738,Banaswadi,425850,63760,362090,0.8502759187507338,-1
1738,1739,Rajajinagar,337800,69840,267960,0.7932504440497335,-1
1739,1740,Jalahalli,392750,30120,362630,0.9233099936346276,-1
1740,1741,Marathahalli,425950,114090,311860,0.7321516609930743,-1
1741,1742,Rajajinagar,260400,42930,217470,0.8351382488479263,-1
1742,1743,Banaswadi,372950,55640,317310,0.8508111006837378,-1
1743,1744,Horamavu,447500,1540,445960,0.9965586592178771,-1
1744,1745,Whitefield,55500,117650,-62150,-1.11981981981982,1
1745,1746,Varthur,399300,48130,351170,0.8794640621086902,0
1746,1747,Shivajinagar,227850,22460,205390,0.9014263770024139,-1
1747,1748,Krishnarajapuram,52250,81920,-29670,-0.5678468899521532,1
1748,1749,Kalyan Nagar,263600,38660,224940,0.8533383915022762,-1
1749,1750,Horamavu,201650,92170,109480,0.5429209025539301,0
1750,1751,Vasanth Nagar,59850,88520,-28670,-0.479030910609858,1
1751,1752,Kammanahalli,68950,44210,24740,0.35881073241479333,1
1752,1753,Marathahalli,144400,29470,114930,0.7959141274238227,0
1753,1754,HBR Layout,36150,60160,-24010,-0.66417704011065,1
1754,1755,Horamavu,408150,34650,373500,0.9151047409040793,-1
1755,1756,Rajajinagar,314700,28110,286590,0.9106768350810296,-1
1756,1757,Kalyan Nagar,280400,82710,197690,0.7050285306704708,-1
1757,1758,Rajajinagar,93700,49470,44230,0.4720384204909285,0
1758,1759,Hebbal,339500,59300,280200,0.8253313696612665,0
1759,1760,Hebbal,186100,50410,135690,0.7291241268135411,0
1760,1761,Marathahalli,147650,46910,100740,0.6822891974263461,0
1761,1762,Horamavu,261950,35740,226210,0.863561748425272,-1
1762,1763,Horamavu,210850,55390,155460,0.7373013990988855,0
1763,1764,Whitefield,252450,92750,159700,0.6326005149534562,0
1764,1765,Shivajinagar,108750,90410,18340,0.16864367816091955,1
1765,1766,Mahadevapura,412350,63110,349240,0.8469504062083182,-1
1766,1767,Kammanahalli,173850,26650,147200,0.8467069312625827,-1
1767,1768,Mahadevapura,411100,67680,343420,0.8353685234736073,-1
1768,1769,CV Raman Nagar,40400,80260,-39860,-0.9866336633663366,1
1769,1770,Hebbal,257800,18120,239680,0.9297129557796742,-1
1770,1771,Horamavu,432300,24080,408220,0.9442979412445062,-1
1771,1772,Jalahalli,368300,80470,287830,0.7815096388813467,0
1772,1773,Krishnarajapuram,410950,12520,398430,0.9695340065701423,-1
1773,1774,HBR Layout,378400,61380,317020,0.8377906976744186,0
1774,1775,CV Raman Nagar,403700,55700,348000,0.862026257121625,0
1775,1776,CV Raman Nagar,426600,82380,344220,0.8068917018284106,-1
1776,1777,Kalyan Nagar,196400,50240,146160,0.7441955193482689,0
1777,1778,Whitefield,184750,109440,75310,0.4076319350473613,0
1778,1779,Shivajinagar,297050,39760,257290,0.8661504797172194,-1
1779,1780,Varthur,342950,67030,275920,0.8045487680419886,0
1780,1781,Hebbal,111650,14390,97260,0.871115091804747,-1
1781,1782,CV Raman Nagar,363550,68370,295180,0.8119378352358685,0
1782,1783,Rajajinagar,248300,64450,183850,0.7404349577124446,0
1783,1784,Marathahalli,349750,59380,290370,0.8302215868477484,0
1784,1785,Marathahalli,388650,99320,289330,0.7444487327930014,0
1785,1786,Varthur,29350,41560,-12210,-0.4160136286201022,1
1786,1787,Whitefield,268400,113950,154450,0.5754470938897168,0
1787,1788,Rajajinagar,201200,63330,137870,0.6852385685884692,0
1788,1789,Shivajinagar,425400,40840,384560,0.9039962388340386,-1
1789,1790,Hebbal,38700,110950,-72250,-1.8669250645994833,1
1790,1791,Jalahalli,447150,56270,390880,0.8741585597674159,0
1791,1792,Malleswaram,123400,56050,67350,0.5457860615883307,0
1792,1793,Hoodi,283250,34540,248710,0.8780582524271845,0
1793,1794,Indiranagar,448350,82270,366080,0.816504962640794,-1
1794,1795,CV Raman Nagar,413700,97840,315860,0.763500120860527,-1
1795,1796,Mahadevapura,79450,111870,-32420,-0.4080553807426054,1
1796,1797,Rajajinagar,145300,78510,66790,0.4596696490020647,0
1797,1798,Shivajinagar,409250,41870,367380,0.8976908979841173,0
1798,1799,Krishnarajapuram,374050,66460,307590,0.8223232188210132,-1
1799,1800,Krishnarajapuram,336650,81780,254870,0.7570770830239121,0
1800,1801,Banaswadi,447450,73900,373550,0.8348418817744999,0
1801,1802,Malleswaram,216150,52720,163430,0.7560953041869073,0
1802,1803,Jalahalli,258500,27410,231090,0.8939651837524178,-1
1803,1804,Indiranagar,191650,118690,72960,0.38069397338899036,1
1804,1805,Horamavu,183850,51210,132640,0.7214577100897471,-1
1805,1806,Marathahalli,331400,57960,273440,0.8251056125528062,0
1806,1807,Jalahalli,163650,53860,109790,0.6708829819737244,0
1807,1808,Varthur,348250,39030,309220,0.8879253409906677,0
1808,1809,Whitefield,117800,1210,116590,0.9897283531409168,-1
1809,1810,Jalahalli,332650,167760,164890,0.4956861566210732,1
1810,1811,Horamavu,262450,32000,230450,0.8780720137168985,-1
1811,1812,Malleswaram,54050,81150,-27100,-0.5013876040703052,1
1812,1813,Varthur,433500,20230,413270,0.9533333333333334,-1
1813,1814,Banaswadi,257650,7230,250420,0.9719386764991267,-1
1814,1815,Jalahalli,354150,49070,305080,0.8614428914301849,-1
1815,1816,Indiranagar,396350,60890,335460,0.8463731550397376,-1
1816,1817,Hebbal,273700,80510,193190,0.7058458165875046,-1
1817,1818,CV Raman Nagar,89500,94380,-4880,-0.05452513966480447,1
1818,1819,Hoodi,363400,63740,299660,0.8246009906439186,0
1819,1820,Kammanahalli,204300,103520,100780,0.49329417523250124,1
1820,1821,Jalahalli,99850,34160,65690,0.6578868302453681,0
1821,1822,Hebbal,340600,58990,281610,0.8268056371109807,0
1822,1823,Krishnarajapuram,392500,34640,357860,0.9117452229299363,-1
1823,1824,Vasanth Nagar,281450,41090,240360,0.8540060401492272,-1
1824,1825,Indiranagar,81450,67790,13660,0.16771025168815223,1
1825,1826,CV Raman Nagar,86600,65640,20960,0.2420323325635104,1
1826,1827,Kalyan Nagar,394550,112240,282310,0.7155240147002915,0
1827,1828,Hoodi,371550,96400,275150,0.7405463598438972,0
1828,1829,HBR Layout,237900,57580,180320,0.7579655317360235,0
1829,1830,Kammanahalli,428550,43790,384760,0.8978182242445456,0
1830,1831,Vasanth Nagar,244450,48270,196180,0.8025363059930456,-1
1831,1832,Rajajinagar,63300,133310,-70010,-1.1060031595576618,1
1832,1833,HBR Layout,161900,33020,128880,0.796046942557134,0
1833,1834,Krishnarajapuram,250700,22320,228380,0.9109692859992022,-1
1834,1835,Vasanth Nagar,184950,73200,111750,0.6042173560421735,0
1835,1836,Varthur,242350,45870,196480,0.8107282855374458,-1
1836,1837,Malleswaram,158300,67600,90700,0.572962728995578,1
1837,1838,Banaswadi,404250,7120,397130,0.9823871366728509,-1
1838,1839,Mahadevapura,59800,20010,39790,0.6653846153846154,0
1839,1840,Kammanahalli,361150,31200,329950,0.913609303613457,-1
1840,1841,Vasanth Nagar,89600,0,89600,1.0,-1
1841,1842,Shivajinagar,311150,35540,275610,0.8857785633938615,-1
1842,1843,Krishnarajapuram,188250,52430,135820,0.7214873837981408,0
1843,1844,Hoodi,328650,90810,237840,0.7236878137836604,0
1844,1845,Shivajinagar,365800,40120,325680,0.8903225806451613,0
1845,1846,Kammanahalli,394050,56550,337500,0.8564902931100115,0
1846,1847,Kalyan Nagar,300700,83070,217630,0.7237445959428002,0
1847,1848,Banaswadi,80250,26900,53350,0.664797507788162,0
1848,1849,HBR Layout,446650,67970,378680,0.8478226799507445,-1
1849,1850,Horamavu,420500,37760,382740,0.9102021403091558,-1
1850,1851,Indiranagar,116700,101220,15480,0.1326478149100257,1
1851,1852,Horamavu,50900,65040,-14140,-0.2777996070726916,1
1852,1853,Vasanth Nagar,142700,28240,114460,0.8021023125437982,0
1853,1854,Banaswadi,319300,52730,266570,0.8348575007829627,-1
1854,1855,Krishnarajapuram,71300,80810,-9510,-0.13338008415147265,1
1855,1856,Varthur,204000,128510,75490,0.37004901960784314,1
1856,1857,Varthur,138300,69370,68930,0.49840925524222707,0
1857,1858,Hoodi,80400,72630,7770,0.09664179104477612,1
1858,1859,Whitefield,348750,66680,282070,0.8088028673835126,0
1859,1860,Mahadevapura,260350,99000,161350,0.6197426541194546,0
1860,1861,Shivajinagar,447600,44750,402850,0.9000223413762288,-1
1861,1862,Shivajinagar,432450,15620,416830,0.9638802173661695,-1
1862,1863,Banaswadi,397700,30020,367680,0.9245159668091526,-1
1863,1864,Shivajinagar,277500,46470,231030,0.8325405405405405,-1
1864,1865,Kammanahalli,350350,55870,294480,0.8405308976737548,0
1865,1866,Malleswaram,277350,11350,266000,0.9590769785469623,-1
1866,1867,Horamavu,193600,17840,175760,0.9078512396694215,-1
1867,1868,Shivajinagar,176400,6670,169730,0.96218820861678,-1
1868,1869,Mahadevapura,38900,34770,4130,0.10616966580976864,1
1869,1870,Whitefield,110200,83840,26360,0.23920145190562614,1
1870,1871,Banaswadi,259600,124880,134720,0.5189522342064715,0
1871,1872,HBR Layout,320100,3040,317060,0.9905029678225554,-1
1872,1873,Krishnarajapuram,161700,24940,136760,0.8457637600494743,0
1873,1874,Rajajinagar,357450,58560,298890,0.8361728913134704,0
1874,1875,Banaswadi,158950,67020,91930,0.5783579742057251,0
1875,1876,Banaswadi,158750,20380,138370,0.8716220472440945,-1
1876,1877,Vasanth Nagar,322050,91400,230650,0.7161931377115355,0
1877,1878,Indiranagar,92450,73280,19170,0.207355327203894,1
1878,1879,Hebbal,426350,35610,390740,0.9164770728274891,-1
1879,1880,Kammanahalli,292800,38930,253870,0.867042349726776,-1
1880,1881,Kammanahalli,121250,59180,62070,0.5119175257731958,1
1881,1882,Indiranagar,210850,84870,125980,0.5974863647142519,0
1882,1883,Horamavu,158750,68030,90720,0.5714645669291338,0
1883,1884,Kalyan Nagar,187500,102380,85120,0.45397333333333334,1
1884,1885,Shivajinagar,121200,73410,47790,0.3943069306930693,1
1885,1886,Rajajinagar,440100,67710,372390,0.8461486025903204,0
1886,1887,Horamavu,40750,127610,-86860,-2.1315337423312886,1
1887,1888,CV Raman Nagar,100000,77450,22550,0.2255,1
1888,1889,Varthur,417900,18470,399430,0.9558028236420196,-1
1889,1890,Banaswadi,158600,59310,99290,0.6260403530895334,0
1890,1891,Krishnarajapuram,378450,89300,289150,0.7640375214691505,-1
1891,1892,Jalahalli,37750,104680,-66930,-1.7729801324503311,1
1892,1893,Malleswaram,434650,41470,393180,0.9045898999194755,-1
1893,1894,Marathahalli,58450,53220,5230,0.08947818648417451,1
1894,1895,Kalyan Nagar,219150,68010,151140,0.6896646132785763,0
1895,1896,Banaswadi,403050,33390,369660,0.9171566803126163,-1
1896,1897,Jalahalli,36550,40940,-4390,-0.120109439124487,1
1897,1898,Whitefield,422800,106500,316300,0.7481078524124882,0
1898,1899,Indiranagar,76900,75310,1590,0.020676202860858257,1
1899,1900,Varthur,267600,79370,188230,0.7034005979073243,0
1900,1901,Kammanahalli,100500,54720,45780,0.45552238805970147,1
1901,1902,Shivajinagar,338650,95580,243070,0.7177617008711059,-1
1902,1903,HBR Layout,419750,88160,331590,0.7899702203692675,0
1903,1904,Shivajinagar,84700,41810,42890,0.5063754427390791,0
1904,1905,Rajajinagar,449600,79960,369640,0.822153024911032,0
1905,1906,CV Raman Nagar,259350,78290,181060,0.6981299402352034,0
1906,1907,Jalahalli,334750,46000,288750,0.8625840179238238,-1
1907,1908,Kammanahalli,352000,124080,227920,0.6475,0
1908,1909,Rajajinagar,339800,77080,262720,0.7731606827545615,-1
1909,1910,Whitefield,421700,76330,345370,0.8189945458857008,-1
1910,1911,Mahadevapura,367500,103000,264500,0.7197278911564626,0
1911,1912,Hoodi,319850,59860,259990,0.812849773331249,-1
1912,1913,CV Raman Nagar,297600,106190,191410,0.6431787634408602,0
1913,1914,Kalyan Nagar,238250,74590,163660,0.6869254984260231,0
1914,1915,Indiranagar,185100,75480,109620,0.5922204213938411,0
1915,1916,CV Raman Nagar,383050,21130,361920,0.9448374885785146,-1
1916,1917,Hebbal,256450,42960,213490,0.8324819652953792,0
1917,1918,Hebbal,69750,12030,57720,0.8275268817204301,0
1918,1919,Rajajinagar,347350,69620,277730,0.7995681589175183,0
1919,1920,Rajajinagar,343700,65150,278550,0.810445155659005,-1
1920,1921,Kalyan Nagar,348900,34800,314100,0.9002579535683577,-1
1921,1922,Rajajinagar,34850,39250,-4400,-0.12625538020086083,1
1922,1923,Whitefield,51600,62370,-10770,-0.20872093023255814,1
1923,1924,Krishnarajapuram,372150,77740,294410,0.791105736934032,-1
1924,1925,Vasanth Nagar,274500,34620,239880,0.8738797814207651,-1
1925,1926,Indiranagar,29400,69400,-40000,-1.3605442176870748,1
1926,1927,Shivajinagar,261650,153880,107770,0.4118861073953755,1
1927,1928,HBR Layout,447150,18760,428390,0.9580453986358045,-1
1928,1929,Krishnarajapuram,243000,117550,125450,0.5162551440329218,0
1929,1930,CV Raman Nagar,190750,22100,168650,0.8841415465268676,0
1930,1931,Hebbal,406300,26650,379650,0.934408072852572,-1
1931,1932,Kalyan Nagar,349950,79920,270030,0.7716245177882555,0
1932,1933,Varthur,260850,100380,160470,0.6151811385853939,0
1933,1934,Kammanahalli,368600,33190,335410,0.9099565925122084,-1
1934,1935,Shivajinagar,162900,60380,102520,0.6293431553100062,0
1935,1936,Malleswaram,52400,68800,-16400,-0.31297709923664124,1
1936,1937,Marathahalli,157650,128890,28760,0.18242943228671107,1
1937,1938,Rajajinagar,162550,48160,114390,0.703721931713319,0
1938,1939,Marathahalli,274300,70120,204180,0.7443674808603719,0
1939,1940,Varthur,398800,61880,336920,0.8448345035105316,-1
1940,1941,Shivajinagar,282950,76390,206560,0.7300229722565824,0
1941,1942,Banaswadi,383800,7870,375930,0.9794945284002085,-1
1942,1943,Banaswadi,299850,79070,220780,0.736301484075371,0
1943,1944,Rajajinagar,265050,27520,237530,0.8961705338615356,0
1944,1945,CV Raman Nagar,340550,127170,213380,0.6265746586404346,0
1945,1946,Indiranagar,149250,80570,68680,0.4601675041876047,1
1946,1947,Banaswadi,239250,43160,196090,0.8196029258098224,0
1947,1948,Rajajinagar,125200,44920,80280,0.6412140575079872,0
1948,1949,Rajajinagar,126200,69910,56290,0.4460380348652932,1
1949,1950,Jalahalli,287950,70590,217360,0.7548532731376976,0
1950,1951,Krishnarajapuram,181750,19010,162740,0.8954057771664374,-1
1951,1952,Malleswaram,152900,70100,82800,0.5415304120340092,0
1952,1953,Jalahalli,239650,19170,220480,0.9200083455038598,-1
1953,1954,Kammanahalli,33100,152060,-118960,-3.5939577039274924,1
1954,1955,Kalyan Nagar,275750,54910,220840,0.8008703535811423,0
1955,1956,HBR Layout,175650,58040,117610,0.6695701679476231,0
1956,1957,Kalyan Nagar,114100,111810,2290,0.02007011393514461,1
1957,1958,Kammanahalli,359850,115040,244810,0.6803112407947756,0
1958,1959,HBR Layout,399400,205560,193840,0.485327991987982,1
1959,1960,Hebbal,444850,8740,436110,0.9803529279532427,-1
1960,1961,Horamavu,156150,50350,105800,0.6775536343259686,0
1961,1962,Banaswadi,213550,980,212570,0.9954109107937251,-1
1962,1963,Vasanth Nagar,188750,99950,88800,0.4704635761589404,0
1963,1964,Marathahalli,244800,106320,138480,0.5656862745098039,1
1964,1965,Krishnarajapuram,97550,81660,15890,0.16289082521783702,1
1965,1966,Malleswaram,237250,122510,114740,0.48362486828240253,1
1966,1967,Indiranagar,31100,44110,-13010,-0.41832797427652735,1
1967,1968,Hebbal,358100,6150,351950,0.982826026249651,-1
1968,1969,Mahadevapura,82050,101890,-19840,-0.24180377818403412,1
1969,1970,Krishnarajapuram,408050,102650,305400,0.74843769145938,0
1970,1971,Hoodi,179750,84480,95270,0.5300139082058415,0
1971,1972,Varthur,46050,83190,-37140,-0.8065146579804561,1
1972,1973,Marathahalli,76500,118000,-41500,-0.5424836601307189,1
1973,1974,Kalyan Nagar,146250,92670,53580,0.36635897435897435,1
1974,1975,Shivajinagar,376350,65840,310510,0.8250564633984323,-1
1975,1976,Shivajinagar,420000,80680,339320,0.8079047619047619,-1
1976,1977,Hoodi,74200,59800,14400,0.1940700808625337,1
1977,1978,Mahadevapura,185000,29650,155350,0.8397297297297297,-1
1978,1979,Kammanahalli,297500,52520,244980,0.8234621848739496,0
1979,1980,Shivajinagar,223400,18550,204850,0.916965085049239,-1
1980,1981,Jalahalli,143850,120370,23480,0.16322558220368438,1
1981,1982,Kammanahalli,285150,26480,258670,0.90713659477468,-1
1982,1983,Varthur,175150,98230,76920,0.4391664287753354,0
1983,1984,Kammanahalli,442400,85490,356910,0.806758589511754,-1
1984,1985,Indiranagar,210500,38830,171670,0.8155344418052256,-1
1985,1986,Horamavu,368650,104180,264470,0.7174013291740133,0
1986,1987,Banaswadi,186400,63010,123390,0.6619635193133048,0
1987,1988,Shivajinagar,53700,68930,-15230,-0.2836126629422719,1
1988,1989,Jalahalli,95800,22650,73150,0.7635699373695198,-1
1989,1990,Marathahalli,55950,27260,28690,0.5127792672028597,0
1990,1991,Krishnarajapuram,273000,65930,207070,0.7584981684981685,-1
1991,1992,Whitefield,289850,41600,248250,0.8564774883560462,-1
1992,1993,Varthur,302750,136700,166050,0.5484723369116433,1
1993,1994,Banaswadi,444800,25940,418860,0.941681654676259,-1
1994,1995,Whitefield,316150,71770,244380,0.7729875059307291,0
1995,1996,Shivajinagar,156150,52360,103790,0.6646813960934999,0
1996,1997,Hoodi,392400,47650,344750,0.8785677879714577,0
1997,1998,Kammanahalli,296900,99630,197270,0.6644324688447288,0
1998,1999,Kalyan Nagar,263300,33780,229520,0.8717052791492594,0
1999,2000,Jalahalli,285250,44960,240290,0.8423838737949167,0
2000,2001,Whitefield,126750,11800,114950,0.9069033530571992,-1
2001,2002,Hebbal,342550,56000,286550,0.8365202160268574,0
2002,2003,Hoodi,93300,43870,49430,0.529796355841372,0
2003,2004,Whitefield,132050,92430,39620,0.30003786444528585,1
2004,2005,Indiranagar,301750,87620,214130,0.7096271748135874,-1
2005,2006,Shivajinagar,67750,55890,11860,0.17505535055350555,1
2006,2007,Horamavu,136250,117360,18890,0.1386422018348624,1
2007,2008,Rajajinagar,307200,10030,297170,0.9673502604166667,-1
2008,2009,Mahadevapura,174800,73940,100860,0.5770022883295195,1
2009,2010,Whitefield,108500,95960,12540,0.11557603686635945,1
2010,2011,Indiranagar,38800,32810,5990,0.15438144329896908,1
2011,2012,Hoodi,132150,45790,86360,0.6534998108210367,0
2012,2013,Banaswadi,384200,39040,345160,0.8983862571577304,-1
2013,2014,Whitefield,62450,90430,-27980,-0.44803843074459565,1
2014,2015,Banaswadi,398800,68720,330080,0.8276830491474423,-1
2015,2016,Whitefield,203950,41420,162530,0.796911007599902,-1
2016,2017,Marathahalli,369900,26740,343160,0.9277101919437686,-1
2017,2018,Krishnarajapuram,390100,34560,355540,0.9114073314534735,-1
2018,2019,Jalahalli,216900,46080,170820,0.787551867219917,0
2019,2020,Shivajinagar,295700,58310,237390,0.802806898884004,-1
2020,2021,Varthur,94950,76010,18940,0.19947340705634545,1
2021,2022,Rajajinagar,45800,90350,-44550,-0.972707423580786,1
2022,2023,Malleswaram,83900,18470,65430,0.7798569725864124,0
2023,2024,Shivajinagar,77050,105760,-28710,-0.372615184944841,1
2024,2025,Malleswaram,133950,62910,71040,0.5303471444568869,0
2025,2026,Horamavu,219300,16880,202420,0.9230278157774737,-1
2026,2027,Whitefield,307600,127780,179820,0.5845903771131339,0
2027,2028,Marathahalli,370700,58840,311860,0.8412732667925547,0
2028,2029,Kalyan Nagar,110300,120810,-10510,-0.09528558476881233,1
2029,2030,Vasanth Nagar,281250,117960,163290,0.5805866666666667,0
2030,2031,Hebbal,302600,109710,192890,0.6374421678783873,0
2031,2032,Mahadevapura,254250,20090,234160,0.9209832841691249,-1
2032,2033,Varthur,437100,43770,393330,0.8998627316403569,-1
2033,2034,Kalyan Nagar,156950,55120,101830,0.6488053520229372,0
2034,2035,Kalyan Nagar,437600,24020,413580,0.9451096892138939,-1
2035,2036,Horamavu,368300,41880,326420,0.8862883518870486,0
2036,2037,HBR Layout,109300,129800,-20500,-0.18755718206770358,1
2037,2038,Hoodi,194800,77810,116990,0.600564681724846,0
2038,2039,HBR Layout,99450,13350,86100,0.8657616892911011,0
2039,2040,Horamavu,45750,112850,-67100,-1.4666666666666666,1
2040,2041,Mahadevapura,107950,13220,94730,0.8775358962482631,-1
2041,2042,Vasanth Nagar,350800,111600,239200,0.6818700114025086,0
2042,2043,Mahadevapura,107450,64080,43370,0.4036295951605398,0
2043,2044,Indiranagar,309050,60420,248630,0.8044976541012782,-1
2044,2045,Horamavu,328600,57950,270650,0.8236457699330493,-1
2045,2046,Krishnarajapuram,241350,117050,124300,0.5150196809612596,0
2046,2047,Hebbal,165150,101400,63750,0.3860127157129882,1
2047,2048,Marathahalli,63200,110980,-47780,-0.7560126582278481,1
2048,2049,Indiranagar,55900,85160,-29260,-0.5234347048300537,1
2049,2050,Jalahalli,117200,108010,9190,0.07841296928327646,1
2050,2051,Marathahalli,41650,65930,-24280,-0.5829531812725091,1
2051,2052,Kammanahalli,334000,57180,276820,0.8288023952095809,-1
2052,2053,Kammanahalli,217850,3780,214070,0.9826486114298829,-1
2053,2054,Kammanahalli,106900,102100,4800,0.04490177736202058,1
2054,2055,Shivajinagar,204900,27340,177560,0.8665690580771108,-1
2055,2056,Indiranagar,51900,84910,-33010,-0.6360308285163776,1
2056,2057,Kammanahalli,42950,68600,-25650,-0.5972060535506403,1
2057,2058,Krishnarajapuram,55400,83620,-28220,-0.5093862815884477,1
2058,2059,Shivajinagar,31700,73320,-41620,-1.3129337539432178,1
2059,2060,Horamavu,175650,78910,96740,0.5507543410190721,0
2060,2061,Banaswadi,161150,31410,129740,0.8050884269314303,0
2061,2062,Rajajinagar,286800,84550,202250,0.7051952580195258,0
2062,2063,Mahadevapura,262600,53330,209270,0.7969154607768469,0
2063,2064,Rajajinagar,273600,128360,145240,0.5308479532163742,1
2064,2065,Shivajinagar,336050,59160,276890,0.8239547686356197,0
2065,2066,Shivajinagar,316450,26750,289700,0.9154684784326118,-1
2066,2067,Vasanth Nagar,75450,78320,-2870,-0.03803843605036448,1
2067,2068,Marathahalli,288300,46730,241570,0.837911897329171,0
2068,2069,Hoodi,281350,102880,178470,0.6343344588590724,0
2069,2070,HBR Layout,45300,47460,-2160,-0.04768211920529802,1
2070,2071,Banaswadi,240150,84600,155550,0.6477201748906933,0
2071,2072,Horamavu,418450,89120,329330,0.7870235392520014,0
2072,2073,Hoodi,41500,46880,-5380,-0.12963855421686746,1
2073,2074,Banaswadi,143250,44420,98830,0.689912739965096,0
2074,2075,Malleswaram,375700,42970,332730,0.8856268299174873,-1
2075,2076,Varthur,288250,62330,225920,0.7837640936686904,0
2076,2077,Mahadevapura,399450,84100,315350,0.7894605081987733,0
2077,2078,CV Raman Nagar,114200,21430,92770,0.8123467600700526,-1
2078,2079,Varthur,183300,93590,89710,0.48941625750136386,0
2079,2080,Hoodi,65400,117860,-52460,-0.8021406727828746,1
2080,2081,Rajajinagar,432200,34850,397350,0.9193660342434058,-1
2081,2082,HBR Layout,113700,75170,38530,0.33887423043095866,1
2082,2083,Hoodi,448950,23990,424960,0.9465642053680811,-1
2083,2084,Shivajinagar,406300,72050,334250,0.8226679793256214,-1
2084,2085,HBR Layout,380850,56950,323900,0.8504660627543652,-1
2085,2086,Indiranagar,156250,47160,109090,0.698176,0
2086,2087,Malleswaram,268700,47140,221560,0.8245627093412728,-1
2087,2088,Kalyan Nagar,297800,77470,220330,0.7398589657488247,-1
2088,2089,Rajajinagar,146300,55020,91280,0.6239234449760765,0
2089,2090,HBR Layout,252050,79350,172700,0.6851815116048403,0
2090,2091,Krishnarajapuram,332700,97770,234930,0.706131650135257,-1
2091,2092,HBR Layout,357550,66000,291550,0.8154104321073976,-1
2092,2093,HBR Layout,66200,34520,31680,0.47854984894259817,1
2093,2094,Marathahalli,346550,38000,308550,0.8903477131727023,-1
2094,2095,Mahadevapura,318450,61910,256540,0.8055895745014916,0
2095,2096,Kalyan Nagar,141000,74520,66480,0.4714893617021277,1
2096,2097,Malleswaram,169800,78230,91570,0.539281507656066,0
2097,2098,Varthur,241950,104560,137390,0.5678445959909072,0
2098,2099,Krishnarajapuram,212500,125760,86740,0.40818823529411763,1
2099,2100,Shivajinagar,92250,70130,22120,0.23978319783197832,1
2100,2101,Malleswaram,42450,85360,-42910,-1.0108362779740871,1
2101,2102,Varthur,227950,83880,144070,0.632024566790963,0
2102,2103,Indiranagar,38800,59640,-20840,-0.5371134020618556,1
2103,2104,Horamavu,87550,50180,37370,0.4268418046830383,0
2104,2105,Indiranagar,96750,47060,49690,0.5135917312661499,0
2105,2106,Jalahalli,361750,5500,356250,0.9847961299239807,-1
2106,2107,Indiranagar,316500,21440,295060,0.932259083728278,-1
2107,2108,Krishnarajapuram,111650,48930,62720,0.561755485893417,0
2108,2109,Krishnarajapuram,230350,37550,192800,0.8369871934013458,0
2109,2110,Shivajinagar,411600,34280,377320,0.9167152575315841,-1
2110,2111,Banaswadi,74350,23590,50760,0.6827168796234028,0
2111,2112,Shivajinagar,134550,87450,47100,0.3500557413600892,1
2112,2113,Rajajinagar,163700,53310,110390,0.6743433109346365,0
2113,2114,Hoodi,325900,15280,310620,0.9531144522859772,-1
2114,2115,Mahadevapura,394950,59630,335320,0.8490188631472338,0
2115,2116,Marathahalli,58000,48600,9400,0.16206896551724137,1
2116,2117,Jalahalli,138650,83560,55090,0.3973314100252434,1
2117,2118,HBR Layout,143200,119400,23800,0.16620111731843576,1
2118,2119,Banaswadi,263900,24650,239250,0.9065934065934066,-1
2119,2120,Hoodi,267050,32250,234800,0.8792360981089684,-1
2120,2121,Horamavu,145850,35660,110190,0.7555022283167638,-1
2121,2122,Hoodi,313650,83290,230360,0.7344492268452096,0
2122,2123,CV Raman Nagar,256300,96530,159770,0.6233710495513071,0
2123,2124,Hoodi,271250,34850,236400,0.8715207373271889,-1
2124,2125,Hebbal,186950,24990,161960,0.8663278951591334,-1
2125,2126,Rajajinagar,48500,75740,-27240,-0.5616494845360824,1
2126,2127,Hoodi,410550,34450,376100,0.9160881744001949,-1
2127,2128,Jalahalli,358100,92590,265510,0.7414409382853951,0
2128,2129,Jalahalli,424350,103440,320910,0.7562389536938847,-1
2129,2130,Indiranagar,49600,28550,21050,0.42439516129032256,1
2130,2131,CV Raman Nagar,188500,33930,154570,0.82,0
2131,2132,Jalahalli,356800,60150,296650,0.8314181614349776,-1
2132,2133,Kammanahalli,306450,67910,238540,0.7783977810409528,0
2133,2134,Hebbal,245750,58100,187650,0.7635808748728382,-1
2134,2135,Hebbal,349550,101860,247690,0.7085967672722071,0
2135,2136,Hebbal,429100,37700,391400,0.912141691913307,-1
2136,2137,Krishnarajapuram,111350,129510,-18160,-0.1630893578805568,1
2137,2138,HBR Layout,174450,128500,45950,0.2633992548008025,1
2138,2139,Krishnarajapuram,439350,80190,359160,0.8174803687265279,-1
2139,2140,Hebbal,264400,48940,215460,0.8149016641452345,-1
2140,2141,Horamavu,109350,45620,63730,0.5828074988568815,0
2141,2142,Hebbal,244850,23060,221790,0.9058198897284051,-1
2142,2143,Varthur,399300,111220,288080,0.7214625594790884,0
2143,2144,CV Raman Nagar,178600,65500,113100,0.6332586786114222,0
2144,2145,Indiranagar,322150,77920,244230,0.758125097004501,0
2145,2146,Kammanahalli,105500,82190,23310,0.2209478672985782,1
2146,2147,Mahadevapura,25200,53480,-28280,-1.1222222222222222,1
2147,2148,Banaswadi,364800,66220,298580,0.8184758771929824,-1
2148,2149,Banaswadi,277150,54040,223110,0.8050153346563232,-1
2149,2150,Vasanth Nagar,215350,58140,157210,0.7300208962154632,0
2150,2151,Kalyan Nagar,129850,49160,80690,0.6214093184443589,0
2151,2152,HBR Layout,127550,36360,91190,0.7149353194825558,-1
2152,2153,Jalahalli,42150,92080,-49930,-1.1845788849347567,1
2153,2154,Kammanahalli,335700,97160,238540,0.7105749180816205,0
2154,2155,Whitefield,67550,38110,29440,0.43582531458179125,1
2155,2156,Whitefield,217950,60940,157010,0.7203945859142005,0
2156,2157,Indiranagar,60700,46690,14010,0.23080724876441516,1
2157,2158,Banaswadi,402900,2310,400590,0.9942665673864483,-1
2158,2159,Shivajinagar,410700,40820,369880,0.900608716824933,-1
2159,2160,CV Raman Nagar,131100,46960,84140,0.6418001525553013,0
2160,2161,Kammanahalli,275200,56430,218770,0.7949491279069767,0
2161,2162,Rajajinagar,164450,140020,24430,0.1485557920340529,1
2162,2163,Mahadevapura,149850,64260,85590,0.5711711711711712,0
2163,2164,Marathahalli,140150,61020,79130,0.5646093471280771,0
2164,2165,Vasanth Nagar,108550,80560,27990,0.2578535237217872,1
2165,2166,Kammanahalli,341700,35790,305910,0.8952589991220369,0
2166,2167,Horamavu,258400,92890,165510,0.6405185758513932,0
2167,2168,Shivajinagar,184700,47990,136710,0.7401732539252842,0
2168,2169,Malleswaram,212300,50390,161910,0.7626471973622233,0
2169,2170,CV Raman Nagar,446000,144160,301840,0.6767713004484305,0
2170,2171,Mahadevapura,52250,16580,35670,0.6826794258373206,0
2171,2172,Hoodi,314200,79800,234400,0.7460216422660726,0
2172,2173,Indiranagar,332750,45630,287120,0.862870022539444,-1
2173,2174,Krishnarajapuram,343550,35590,307960,0.8964051811963324,-1
2174,2175,Hoodi,336900,31220,305680,0.9073315523894331,-1
2175,2176,Mahadevapura,388650,173720,214930,0.5530168532098289,0
2176,2177,Whitefield,197950,85800,112150,0.5665572114170245,1
2177,2178,Krishnarajapuram,332500,27850,304650,0.9162406015037594,-1
2178,2179,Indiranagar,309800,44170,265630,0.8574241446094254,-1
2179,2180,HBR Layout,227900,12450,215450,0.9453707766564282,-1
2180,2181,Banaswadi,365900,96620,269280,0.7359387810877289,0
2181,2182,Hebbal,322200,47470,274730,0.8526691495965238,-1
2182,2183,Shivajinagar,203300,30670,172630,0.849139203148057,0
2183,2184,Indiranagar,77650,26230,51420,0.6622021893110109,0
2184,2185,Vasanth Nagar,396750,19790,376960,0.950119722747322,-1
2185,2186,Marathahalli,427150,52140,375010,0.8779351515860939,-1
2186,2187,HBR Layout,64000,33760,30240,0.4725,1
2187,2188,Kammanahalli,328600,83010,245590,0.7473828362751065,-1
2188,2189,HBR Layout,212150,93450,118700,0.5595097808154608,0
2189,2190,Shivajinagar,163250,106980,56270,0.3446860643185299,1
2190,2191,HBR Layout,259150,103960,155190,0.5988423692841983,0
2191,2192,Banaswadi,436200,73380,362820,0.8317744154057771,-1
2192,2193,Kalyan Nagar,42350,60520,-18170,-0.42904368358913814,1
2193,2194,Krishnarajapuram,370150,136690,233460,0.6307172767796839,0
2194,2195,CV Raman Nagar,260900,79820,181080,0.6940590264469145,0
2195,2196,Whitefield,315850,100940,214910,0.680417919898686,0
2196,2197,Jalahalli,115150,9760,105390,0.9152409900130265,-1
2197,2198,Rajajinagar,317650,89160,228490,0.7193137100582402,0
2198,2199,Rajajinagar,402850,82030,320820,0.7963758222663523,0
2199,2200,Whitefield,171850,136130,35720,0.20785568810008728,1
2200,2201,Malleswaram,393150,22470,370680,0.9428462418924075,-1
2201,2202,Mahadevapura,119400,76500,42900,0.3592964824120603,1
2202,2203,Shivajinagar,256150,67700,188450,0.7357017372633222,0
2203,2204,Kalyan Nagar,151200,102890,48310,0.319510582010582,1
2204,2205,Mahadevapura,55800,74470,-18670,-0.3345878136200717,1
2205,2206,Mahadevapura,410950,53600,357350,0.8695705073609928,-1
2206,2207,Kalyan Nagar,271450,3890,267560,0.9856695524037576,-1
2207,2208,Kalyan Nagar,415550,106300,309250,0.7441944411021538,0
2208,2209,HBR Layout,442400,56610,385790,0.8720388788426763,-1
2209,2210,Marathahalli,162850,72530,90320,0.554620816702487,0
2210,2211,HBR Layout,415200,67990,347210,0.836247591522158,0
2211,2212,Varthur,77300,68700,8600,0.111254851228978,1
2212,2213,Banaswadi,140100,55840,84260,0.6014275517487508,0
2213,2214,Rajajinagar,74500,56980,17520,0.23516778523489934,1
2214,2215,Hoodi,344800,113510,231290,0.6707946635730858,0
2215,2216,Indiranagar,231150,18190,212960,0.9213065109236427,-1
2216,2217,HBR Layout,407450,184310,223140,0.5476500184071665,0
2217,2218,Krishnarajapuram,25350,80470,-55120,-2.174358974358974,1
2218,2219,Hoodi,364050,56130,307920,0.8458178821590441,0
2219,2220,HBR Layout,150350,63840,86510,0.5753907549052212,0
2220,2221,Kalyan Nagar,25950,62960,-37010,-1.426204238921002,1
2221,2222,Rajajinagar,356450,50830,305620,0.8573993547482115,-1
2222,2223,Marathahalli,185050,112850,72200,0.39016482031883276,1
2223,2224,Horamavu,196400,37180,159220,0.8106924643584521,-1
2224,2225,HBR Layout,187050,53780,133270,0.7124832932371024,0
2225,2226,Banaswadi,431600,30920,400680,0.9283595922150139,-1
2226,2227,Marathahalli,32950,67470,-34520,-1.0476479514415782,1
2227,2228,Hoodi,337350,58570,278780,0.8263820957462576,-1
2228,2229,Hoodi,294800,120020,174780,0.592876526458616,0
2229,2230,Jalahalli,272750,39970,232780,0.853455545371219,-1
2230,2231,Marathahalli,161900,64530,97370,0.60142063001853,0
2231,2232,Rajajinagar,35500,66620,-31120,-0.8766197183098592,1
2232,2233,Rajajinagar,137700,125780,11920,0.08656499636891794,1
2233,2234,Kalyan Nagar,346150,106900,239250,0.6911743463816264,0
2234,2235,Indiranagar,76950,42230,34720,0.4512020792722547,1
2235,2236,Malleswaram,260100,64840,195260,0.7507112648981161,0
2236,2237,Vasanth Nagar,28400,60150,-31750,-1.1179577464788732,1
2237,2238,Krishnarajapuram,35500,72940,-37440,-1.0546478873239438,1
2238,2239,Rajajinagar,113400,36800,76600,0.6754850088183422,0
2239,2240,Vasanth Nagar,285600,85180,200420,0.701750700280112,0
2240,2241,Kammanahalli,67050,77100,-10050,-0.14988814317673377,1
2241,2242,Indiranagar,107550,25820,81730,0.7599256159925616,0
2242,2243,CV Raman Nagar,84850,126790,-41940,-0.49428403064230997,1
2243,2244,Shivajinagar,195850,48100,147750,0.7544038805208068,0
2244,2245,Banaswadi,143200,57100,86100,0.6012569832402235,0
2245,2246,Marathahalli,312150,105730,206420,0.6612846387954509,0
2246,2247,Malleswaram,36700,67310,-30610,-0.8340599455040872,1
2247,2248,Horamavu,367900,58380,309520,0.8413155748844795,0
2248,2249,HBR Layout,303850,69100,234750,0.7725851571499095,0
2249,2250,Vasanth Nagar,363050,103390,259660,0.7152182894918055,-1
2250,2251,Shivajinagar,211900,132270,79630,0.37579046720151016,1
2251,2252,Hebbal,306750,88210,218540,0.7124368378158109,0
2252,2253,Indiranagar,70050,56790,13260,0.18929336188436832,1
2253,2254,Banaswadi,240000,34270,205730,0.8572083333333333,-1
2254,2255,Shivajinagar,240100,78510,161590,0.6730112453144523,0
2255,2256,Jalahalli,53600,45180,8420,0.15708955223880597,1
2256,2257,Varthur,50800,72970,-22170,-0.4364173228346457,1
2257,2258,Hoodi,207650,59570,148080,0.7131230435829521,0
2258,2259,Jalahalli,415300,28920,386380,0.9303635925836744,-1
2259,2260,HBR Layout,197600,57600,140000,0.708502024291498,-1
2260,2261,Rajajinagar,136650,33390,103260,0.7556531284302964,0
2261,2262,Hebbal,267400,29860,237540,0.8883320867614062,-1
2262,2263,Whitefield,383350,56590,326760,0.852380331289944,-1
2263,2264,Krishnarajapuram,422250,74830,347420,0.8227827116637063,-1
2264,2265,Kammanahalli,279050,145760,133290,0.4776563339903243,0
2265,2266,Kammanahalli,331550,86980,244570,0.7376564620720857,0
2266,2267,CV Raman Nagar,70100,83810,-13710,-0.19557774607703282,1
2267,2268,Kalyan Nagar,69100,77570,-8470,-0.12257597684515195,1
2268,2269,Varthur,292550,79210,213340,0.7292428644676123,-1
2269,2270,Kalyan Nagar,204050,45360,158690,0.7777015437392796,0
2270,2271,Kammanahalli,110750,91480,19270,0.17399548532731376,1
2271,2272,Rajajinagar,270300,12910,257390,0.9522382537920828,-1
2272,2273,Kammanahalli,362150,49770,312380,0.8625707579732155,-1
2273,2274,Jalahalli,288900,58040,230860,0.7991000346140533,0
2274,2275,Hebbal,282350,127960,154390,0.5468036125376305,1
2275,2276,Varthur,296250,104980,191270,0.6456371308016877,0
2276,2277,Horamavu,396600,45160,351440,0.8861321230458901,0
2277,2278,Krishnarajapuram,382050,39950,342100,0.8954325350085067,-1
2278,2279,CV Raman Nagar,130100,57910,72190,0.554880860876249,1
2279,2280,Marathahalli,432000,60510,371490,0.8599305555555555,-1
2280,2281,HBR Layout,405900,20220,385680,0.9501847745750185,-1
2281,2282,Varthur,101800,95630,6170,0.0606090373280943,1
2282,2283,Varthur,396150,58800,337350,0.8515713744793639,-1
2283,2284,HBR Layout,115550,111130,4420,0.03825183903072263,1
2284,2285,Jalahalli,49100,47650,1450,0.029531568228105907,1
2285,2286,Hoodi,26500,98060,-71560,-2.700377358490566,1
2286,2287,Rajajinagar,108550,38720,69830,0.6432980193459236,0
2287,2288,Vasanth Nagar,273850,45250,228600,0.8347635566916195,-1
2288,2289,Shivajinagar,447150,112910,334240,0.747489656714749,-1
2289,2290,Hoodi,352600,13870,338730,0.9606636415201362,-1
2290,2291,Jalahalli,148000,12280,135720,0.917027027027027,-1
2291,2292,Malleswaram,91000,83630,7370,0.08098901098901098,1
2292,2293,Horamavu,152550,49660,102890,0.674467387741724,0
2293,2294,Indiranagar,99550,114140,-14590,-0.14655951783023607,1
2294,2295,Krishnarajapuram,400600,16720,383880,0.9582626060908637,-1
2295,2296,Rajajinagar,72350,61060,11290,0.15604699378023498,1
2296,2297,Banaswadi,294950,60400,234550,0.7952195287336836,-1
2297,2298,Indiranagar,174900,85580,89320,0.5106918238993711,1
2298,2299,Banaswadi,344550,50390,294160,0.8537512697721666,0
2299,2300,Vasanth Nagar,428300,66160,362140,0.8455288349287883,0
2300,2301,Krishnarajapuram,33100,38080,-4980,-0.15045317220543808,1
2301,2302,Malleswaram,367150,88830,278320,0.7580552907530982,0
2302,2303,Hebbal,49500,44120,5380,0.10868686868686869,1
2303,2304,Horamavu,288200,30230,257970,0.8951075641915337,0
2304,2305,Malleswaram,79400,114780,-35380,-0.4455919395465995,1
2305,2306,Vasanth Nagar,444450,58010,386440,0.8694791315108561,-1
2306,2307,HBR Layout,411250,34740,376510,0.9155258358662614,-1
2307,2308,Malleswaram,192900,127260,65640,0.34027993779160187,1
2308,2309,Jalahalli,27250,56480,-29230,-1.0726605504587157,1
2309,2310,Kalyan Nagar,280400,28010,252390,0.9001069900142653,-1
2310,2311,Malleswaram,29400,27120,2280,0.07755102040816327,1
2311,2312,Rajajinagar,252850,99450,153400,0.6066838046272494,0
2312,2313,Varthur,237300,22240,215060,0.9062789717656974,-1
2313,2314,Jalahalli,193450,61840,131610,0.6803308348410442,0
2314,2315,Kammanahalli,32400,48690,-16290,-0.5027777777777778,1
2315,2316,Mahadevapura,335550,35830,299720,0.893220086425272,0
2316,2317,Malleswaram,232650,19070,213580,0.9180313776058457,-1
2317,2318,Hoodi,307300,15830,291470,0.9484868206963879,-1
2318,2319,Mahadevapura,246250,82640,163610,0.6644060913705584,0
2319,2320,Hoodi,138650,53960,84690,0.6108186080057699,0
2320,2321,Shivajinagar,271600,87400,184200,0.6782032400589102,0
2321,2322,HBR Layout,209750,40970,168780,0.8046722288438617,-1
2322,2323,HBR Layout,81850,29750,52100,0.6365302382406842,0
2323,2324,Krishnarajapuram,384600,45910,338690,0.8806292251690068,0
2324,2325,Marathahalli,433150,47350,385800,0.8906845203740044,0
2325,2326,Hoodi,371350,111910,259440,0.6986400969435842,0
2326,2327,Kalyan Nagar,362050,58430,303620,0.8386134511807761,-1
2327,2328,Banaswadi,163400,117550,45850,0.2805997552019584,1
2328,2329,Krishnarajapuram,425300,42150,383150,0.900893486950388,-1
2329,2330,Hebbal,448000,81810,366190,0.8173883928571428,-1
2330,2331,Rajajinagar,371250,89620,281630,0.7585993265993266,0
2331,2332,HBR Layout,63250,63980,-730,-0.011541501976284585,1
2332,2333,Kalyan Nagar,38800,25980,12820,0.3304123711340206,1
2333,2334,Kalyan Nagar,54800,33540,21260,0.387956204379562,1
2334,2335,CV Raman Nagar,30000,6840,23160,0.772,0
2335,2336,Whitefield,176300,12670,163630,0.9281338627339761,-1
2336,2337,Mahadevapura,81950,59310,22640,0.2762660158633313,1
2337,2338,Varthur,192500,64430,128070,0.6652987012987013,0
2338,2339,Hoodi,184050,41070,142980,0.7768541157294213,0
2339,2340,Banaswadi,349700,38880,310820,0.8888189877037461,-1
2340,2341,Jalahalli,234900,3960,230940,0.9831417624521073,-1
2341,2342,Varthur,292200,81760,210440,0.7201916495550993,0
2342,2343,Vasanth Nagar,390600,121460,269140,0.6890424987199181,0
2343,2344,Malleswaram,349200,123170,226030,0.6472794959908362,0
2344,2345,Kalyan Nagar,400750,52390,348360,0.8692701185277605,-1
2345,2346,Shivajinagar,58950,69300,-10350,-0.17557251908396945,1
2346,2347,Marathahalli,151400,38300,113100,0.7470277410832232,0
2347,2348,HBR Layout,219100,67180,151920,0.6933820173436787,0
2348,2349,Krishnarajapuram,162750,137880,24870,0.1528110599078341,1
2349,2350,HBR Layout,378850,35030,343820,0.9075359641018873,-1
2350,2351,Indiranagar,180800,55080,125720,0.695353982300885,0
2351,2352,Malleswaram,138500,54310,84190,0.607870036101083,0
2352,2353,Rajajinagar,414100,33870,380230,0.9182081622796426,-1
2353,2354,Jalahalli,245700,45410,200290,0.8151811151811151,0
2354,2355,Marathahalli,276500,45400,231100,0.8358047016274864,0
2355,2356,Marathahalli,312700,89810,222890,0.7127918132395267,0
2356,2357,Hoodi,211650,30290,181360,0.8568863690054335,0
2357,2358,Hebbal,315800,45570,270230,0.8556998100063331,0
2358,2359,Shivajinagar,210600,39900,170700,0.8105413105413105,-1
2359,2360,Vasanth Nagar,109600,20360,89240,0.8142335766423358,-1
2360,2361,Jalahalli,244100,46170,197930,0.810856206472757,-1
2361,2362,Jalahalli,205850,56140,149710,0.7272771435511295,0
2362,2363,Varthur,279750,48220,231530,0.8276318141197497,0
2363,2364,Shivajinagar,104700,91070,13630,0.13018147086914994,1
2364,2365,Vasanth Nagar,200450,50280,150170,0.7491643801446745,-1
2365,2366,Whitefield,370550,8890,361660,0.9760086358116313,-1
2366,2367,Malleswaram,42550,35690,6860,0.16122209165687426,1
2367,2368,Horamavu,374600,59100,315500,0.8422317138280833,-1
2368,2369,Marathahalli,48800,65460,-16660,-0.3413934426229508,1
2369,2370,Kammanahalli,306400,19120,287280,0.9375979112271541,-1
2370,2371,Indiranagar,362800,35930,326870,0.9009647188533627,-1
2371,2372,Malleswaram,302700,72640,230060,0.7600264288074,-1
2372,2373,Rajajinagar,430100,45110,384990,0.8951174145547547,-1
2373,2374,Shivajinagar,415500,0,415500,1.0,-1
2374,2375,Whitefield,333250,78800,254450,0.7635408852213054,0
2375,2376,Banaswadi,172600,26910,145690,0.844090382387022,-1
2376,2377,CV Raman Nagar,237700,30910,206790,0.8699621371476651,-1
2377,2378,Hebbal,59150,120540,-61390,-1.0378698224852072,1
2378,2379,Jalahalli,160450,60310,100140,0.6241196634465566,0
2379,2380,Kalyan Nagar,438250,51930,386320,0.8815059897318882,0
2380,2381,Whitefield,258150,32700,225450,0.873329459616502,0
2381,2382,Kalyan Nagar,357400,46210,311190,0.8707050923335199,0
2382,2383,Varthur,103400,127330,-23930,-0.23143133462282398,1
2383,2384,Kammanahalli,190300,51200,139100,0.7309511297950604,0
2384,2385,Marathahalli,41950,52950,-11000,-0.2622169249106079,1
2385,2386,Whitefield,356750,47090,309660,0.8680028030833917,-1
2386,2387,Mahadevapura,396500,54240,342260,0.863203026481715,-1
2387,2388,Shivajinagar,432400,35480,396920,0.9179463459759482,-1
2388,2389,Mahadevapura,325000,48520,276480,0.8507076923076923,-1
2389,2390,Marathahalli,54750,94450,-39700,-0.7251141552511415,1
2390,2391,Kalyan Nagar,324900,24360,300540,0.9250230840258541,-1
2391,2392,Mahadevapura,385900,66770,319130,0.8269759004923556,-1
2392,2393,Jalahalli,211200,66990,144210,0.6828125,0
2393,2394,Shivajinagar,305050,61950,243100,0.7969185379445992,0
2394,2395,CV Raman Nagar,268000,51830,216170,0.8066044776119403,-1
2395,2396,Whitefield,369950,34540,335410,0.9066360318962022,-1
2396,2397,Hebbal,39400,44040,-4640,-0.11776649746192894,1
2397,2398,Vasanth Nagar,145950,51620,94330,0.6463172319287427,0
2398,2399,Shivajinagar,122050,25100,96950,0.7943465792707907,0
2399,2400,Kammanahalli,431650,56050,375600,0.8701494266187884,0
2400,2401,Indiranagar,188950,33970,154980,0.8202169886213284,0
2401,2402,Kalyan Nagar,265800,110880,154920,0.582844243792325,1
2402,2403,Kammanahalli,178700,52680,126020,0.7052042529378847,0
2403,2404,Malleswaram,199050,56620,142430,0.7155488570710876,0
2404,2405,Banaswadi,306450,82880,223570,0.729548050252896,0
2405,2406,Rajajinagar,49750,55190,-5440,-0.1093467336683417,1
2406,2407,Vasanth Nagar,174150,58900,115250,0.6617858168245765,0
2407,2408,Whitefield,57950,57210,740,0.01276962899050906,1
2408,2409,Banaswadi,118350,61690,56660,0.47874947190536543,1
2409,2410,Krishnarajapuram,447700,77200,370500,0.827563100290373,0
2410,2411,Hebbal,307600,125150,182450,0.5931404421326398,1
2411,2412,Mahadevapura,201500,107370,94130,0.46714640198511165,1
2412,2413,Marathahalli,360600,3990,356610,0.9889351081530782,-1
2413,2414,Banaswadi,180300,35840,144460,0.8012201885745979,0
2414,2415,Whitefield,156550,84480,72070,0.46036410092622165,1
2415,2416,Vasanth Nagar,153600,84670,68930,0.44876302083333336,1
2416,2417,Banaswadi,269450,128430,141020,0.5233624048988681,0
2417,2418,Malleswaram,375900,63690,312210,0.8305666400638467,0
2418,2419,Hoodi,98450,52240,46210,0.46937531742001015,0
2419,2420,Krishnarajapuram,375500,12150,363350,0.9676431424766977,-1
2420,2421,CV Raman Nagar,276050,73440,202610,0.7339612389059953,0
2421,2422,Kalyan Nagar,401050,104180,296870,0.7402318912853759,-1
2422,2423,Jalahalli,385750,20840,364910,0.9459753726506805,-1
2423,2424,Vasanth Nagar,32150,141200,-109050,-3.3919129082426127,1
2424,2425,Jalahalli,426400,23190,403210,0.9456144465290807,-1
2425,2426,Krishnarajapuram,89200,94440,-5240,-0.05874439461883408,1
2426,2427,Banaswadi,295700,82100,213600,0.7223537368955022,-1
2427,2428,Krishnarajapuram,386800,20990,365810,0.9457342295760083,-1
2428,2429,Kammanahalli,87750,23320,64430,0.7342450142450142,0
2429,2430,Kammanahalli,315950,66890,249060,0.7882892862794746,-1
2430,2431,Marathahalli,401350,133700,267650,0.6668742992400648,0
2431,2432,Marathahalli,44650,92150,-47500,-1.0638297872340425,1
2432,2433,Mahadevapura,424000,33620,390380,0.9207075471698113,-1
2433,2434,Horamavu,401250,52680,348570,0.8687102803738318,-1
2434,2435,Vasanth Nagar,30500,41640,-11140,-0.3652459016393443,1
2435,2436,Krishnarajapuram,199450,114820,84630,0.42431687139633995,1
2436,2437,Kammanahalli,340650,113790,226860,0.665962131219727,0
2437,2438,Krishnarajapuram,151700,49470,102230,0.6738958470665788,0
2438,2439,Kammanahalli,213300,12390,200910,0.9419127988748242,-1
2439,2440,HBR Layout,325000,64120,260880,0.8027076923076923,-1
2440,2441,Kalyan Nagar,267350,64600,202750,0.7583691789788667,0
2441,2442,Whitefield,439500,27920,411580,0.9364732650739477,-1
2442,2443,Kammanahalli,343550,47260,296290,0.862436326590016,0
2443,2444,HBR Layout,194750,72810,121940,0.6261360718870347,0
2444,2445,Kammanahalli,299400,77520,221880,0.7410821643286574,0
2445,2446,Hebbal,67650,64400,3250,0.04804138950480414,1
2446,2447,Hoodi,200400,26580,173820,0.8673652694610778,-1
2447,2448,Malleswaram,387950,29760,358190,0.9232890836447996,-1
2448,2449,Horamavu,109600,104160,5440,0.049635036496350364,1
2449,2450,CV Raman Nagar,271800,24740,247060,0.9089771891096394,-1
2450,2451,HBR Layout,371350,13170,358180,0.9645348054396122,-1
2451,2452,Marathahalli,178700,75010,103690,0.5802462227196419,0
2452,2453,HBR Layout,443800,19450,424350,0.9561739522307345,-1
2453,2454,Rajajinagar,155450,125640,29810,0.1917658411064651,1
2454,2455,Malleswaram,210600,71650,138950,0.6597815764482431,0
2455,2456,Vasanth Nagar,421150,111140,310010,0.7361035260595987,-1
2456,2457,Kammanahalli,222700,100140,122560,0.5503367759317468,0
2457,2458,Krishnarajapuram,375350,189290,186060,0.49569734914080193,1
2458,2459,HBR Layout,417050,18320,398730,0.9560724133796907,-1
2459,2460,Rajajinagar,175450,44440,131010,0.7467084639498432,0
2460,2461,Varthur,196200,118920,77280,0.39388379204892965,1
2461,2462,Hebbal,243400,98140,145260,0.5967953985209532,0
2462,2463,Malleswaram,291850,8860,282990,0.9696419393524071,-1
2463,2464,Indiranagar,124950,49190,75760,0.6063225290116047,0
2464,2465,HBR Layout,124600,26880,97720,0.7842696629213484,0
2465,2466,Banaswadi,251300,32970,218330,0.8688022284122563,-1
2466,2467,Shivajinagar,137150,65860,71290,0.5197958439664601,0
2467,2468,CV Raman Nagar,218900,68070,150830,0.6890360895386021,0
2468,2469,Banaswadi,326250,77660,248590,0.7619616858237548,0
2469,2470,HBR Layout,79850,85000,-5150,-0.06449592986850344,1
2470,2471,HBR Layout,107700,107890,-190,-0.001764159702878366,1
2471,2472,Hebbal,243500,27090,216410,0.888747433264887,-1
2472,2473,HBR Layout,262600,44350,218250,0.8311119573495811,-1
2473,2474,HBR Layout,423000,80870,342130,0.8088179669030733,-1
2474,2475,Shivajinagar,323950,62570,261380,0.8068529093995988,0
2475,2476,Vasanth Nagar,122800,44650,78150,0.636400651465798,0
2476,2477,Krishnarajapuram,270200,46500,223700,0.8279052553663953,-1
2477,2478,Kammanahalli,214950,56140,158810,0.7388229820888579,0
2478,2479,Kammanahalli,423500,77640,345860,0.8166706021251475,-1
2479,2480,Hoodi,301750,19030,282720,0.9369345484672742,-1
2480,2481,Vasanth Nagar,118750,74680,44070,0.37111578947368423,1
2481,2482,Krishnarajapuram,204150,90820,113330,0.55513103110458,1
2482,2483,Hoodi,319600,77980,241620,0.7560075093867334,0
2483,2484,HBR Layout,392650,89960,302690,0.7708901056920922,0
2484,2485,Mahadevapura,121900,104260,17640,0.14470877768662838,1
2485,2486,Rajajinagar,417200,53480,363720,0.8718120805369127,-1
2486,2487,Malleswaram,444200,67140,377060,0.8488518685276902,-1
2487,2488,Rajajinagar,185650,14290,171360,0.9230272017236736,-1
2488,2489,Horamavu,319250,30580,288670,0.9042129992169147,-1
2489,2490,Krishnarajapuram,153000,34770,118230,0.7727450980392156,0
2490,2491,Vasanth Nagar,201800,67480,134320,0.6656095143706641,0
2491,2492,Indiranagar,255150,71290,183860,0.7205957280031354,-1
2492,2493,Indiranagar,269300,54940,214360,0.7959896026735982,-1
2493,2494,Kalyan Nagar,393150,53660,339490,0.8635126542032303,-1
2494,2495,Banaswadi,420400,110260,310140,0.7377259752616556,0
2495,2496,Vasanth Nagar,190900,94030,96870,0.5074384494499738,1
2496,2497,Marathahalli,96400,72970,23430,0.24304979253112033,1
2497,2498,Krishnarajapuram,298500,85820,212680,0.7124958123953099,0
2498,2499,Rajajinagar,237600,111400,126200,0.5311447811447811,0
2499,2500,Whitefield,423200,126550,296650,0.700968809073724,0
2500,2501,Horamavu,271050,57520,213530,0.7877882309536985,0
2501,2502,Shivajinagar,380000,89720,290280,0.7638947368421053,-1
2502,2503,Malleswaram,249050,66240,182810,0.7340293113832563,0
2503,2504,Hebbal,209300,73810,135490,0.647348303870043,0
2504,2505,Hebbal,179700,75500,104200,0.5798553144129104,0
2505,2506,Horamavu,82600,60240,22360,0.27070217917675543,1
2506,2507,Indiranagar,261050,15660,245390,0.9400114920513312,-1
2507,2508,Mahadevapura,437650,71760,365890,0.8360333599908603,-1
2508,2509,Kammanahalli,236350,93890,142460,0.6027501586629997,0
2509,2510,Varthur,261750,57460,204290,0.7804775549188157,0
2510,2511,Whitefield,101250,24590,76660,0.7571358024691358,0
2511,2512,Malleswaram,130950,73680,57270,0.43734249713631157,0
2512,2513,Marathahalli,57950,35250,22700,0.3917169974115617,1
2513,2514,Jalahalli,176600,58900,117700,0.6664779161947905,0
2514,2515,Varthur,38100,19080,19020,0.49921259842519683,1
2515,2516,Varthur,279750,84260,195490,0.6988025022341376,0
2516,2517,Kammanahalli,261800,32990,228810,0.8739877769289534,0
2517,2518,Horamavu,30450,104330,-73880,-2.426272577996716,1
2518,2519,Krishnarajapuram,90950,101510,-10560,-0.11610775151181968,1
2519,2520,Varthur,97400,7430,89970,0.9237166324435319,-1
2520,2521,Varthur,291650,69970,221680,0.7600891479513116,0
2521,2522,HBR Layout,251500,43700,207800,0.8262425447316103,-1
2522,2523,Whitefield,229500,32400,197100,0.8588235294117647,-1
2523,2524,HBR Layout,232550,56170,176380,0.7584605461191142,0
2524,2525,Horamavu,160650,16720,143930,0.8959228135698724,0
2525,2526,Rajajinagar,384200,72550,311650,0.8111660593440916,0
2526,2527,Hoodi,78450,22270,56180,0.7161249203314213,0
2527,2528,Kalyan Nagar,145400,73390,72010,0.4952544704264099,1
2528,2529,Banaswadi,46900,22600,24300,0.5181236673773987,0
2529,2530,Malleswaram,99250,94280,4970,0.05007556675062972,1
2530,2531,Vasanth Nagar,436050,34120,401930,0.9217520926499254,-1
2531,2532,Rajajinagar,341250,25750,315500,0.9245421245421246,-1
2532,2533,Hebbal,329100,58640,270460,0.8218170768763294,-1
2533,2534,Mahadevapura,32150,50750,-18600,-0.578538102643857,1
2534,2535,Indiranagar,252100,58460,193640,0.7681078936929789,0
2535,2536,Malleswaram,444150,58400,385750,0.8685128897894855,-1
2536,2537,Vasanth Nagar,210400,49310,161090,0.7656368821292776,-1
2537,2538,Hoodi,415850,106470,309380,0.7439701815558495,0
2538,2539,Jalahalli,68250,60030,8220,0.12043956043956044,1
2539,2540,Vasanth Nagar,158300,52310,105990,0.6695514845230575,0
2540,2541,Hoodi,101900,90690,11210,0.1100098135426889,1
2541,2542,Banaswadi,434400,32330,402070,0.9255755064456722,-1
2542,2543,Malleswaram,360950,76050,284900,0.7893059980606733,-1
2543,2544,Vasanth Nagar,144650,29450,115200,0.7964051157967508,0
2544,2545,Hoodi,166000,59930,106070,0.6389759036144579,0
2545,2546,Kalyan Nagar,380050,76310,303740,0.7992106301802394,0
2546,2547,Varthur,268900,24040,244860,0.9105987355894385,-1
2547,2548,Horamavu,97200,172650,-75450,-0.7762345679012346,1
2548,2549,Kammanahalli,238450,59270,179180,0.7514363598238625,0
2549,2550,Whitefield,99400,58190,41210,0.4145875251509054,1
2550,2551,Hebbal,328900,26930,301970,0.9181210094253572,-1
2551,2552,HBR Layout,37500,54140,-16640,-0.4437333333333333,1
2552,2553,Jalahalli,97600,46430,51170,0.5242827868852459,1
2553,2554,Mahadevapura,350250,41540,308710,0.8813990007137759,-1
2554,2555,Whitefield,217550,33460,184090,0.8461962767179959,-1
2555,2556,Horamavu,260650,134680,125970,0.4832917705735661,0
2556,2557,Varthur,445950,55770,390180,0.8749411368987554,-1
2557,2558,Horamavu,275150,86570,188580,0.6853716154824641,0
2558,2559,Hebbal,39250,16970,22280,0.5676433121019109,1
2559,2560,Krishnarajapuram,99400,78940,20460,0.20583501006036217,1
2560,2561,Indiranagar,79400,20840,58560,0.7375314861460958,0
2561,2562,Hebbal,375700,55020,320680,0.8535533670481767,-1
2562,2563,Kammanahalli,121250,24570,96680,0.797360824742268,0
2563,2564,Indiranagar,170550,88170,82380,0.4830255057167986,1
2564,2565,Marathahalli,201900,37610,164290,0.8137196631996038,-1
2565,2566,Banaswadi,348200,58250,289950,0.8327110855829982,-1
2566,2567,Whitefield,264200,3270,260930,0.9876230128690386,-1
2567,2568,Mahadevapura,170000,69090,100910,0.5935882352941176,1
2568,2569,Jalahalli,142100,74560,67540,0.4752990851513019,1
2569,2570,Marathahalli,421450,82920,338530,0.8032506821687033,-1
2570,2571,Whitefield,320650,55380,265270,0.8272883205987838,-1
2571,2572,Varthur,256200,81800,174400,0.6807181889149102,0
2572,2573,Jalahalli,137000,48280,88720,0.6475912408759124,0
2573,2574,Malleswaram,156050,31150,124900,0.8003844921499519,-1
2574,2575,Malleswaram,170150,76170,93980,0.5523361739641492,0
2575,2576,Krishnarajapuram,423000,156450,266550,0.6301418439716312,0
2576,2577,Kammanahalli,361000,37750,323250,0.8954293628808865,0
2577,2578,Banaswadi,436150,84490,351660,0.8062822423478161,0
2578,2579,Horamavu,126450,71740,54710,0.43266113088177144,1
2579,2580,Shivajinagar,196550,85520,111030,0.5648944288984991,1
2580,2581,Horamavu,150500,125210,25290,0.16803986710963456,1
2581,2582,Horamavu,278800,35950,242850,0.8710545193687231,0
2582,2583,Shivajinagar,218150,62210,155940,0.7148292459316984,0
2583,2584,HBR Layout,139000,100360,38640,0.2779856115107914,1
2584,2585,Banaswadi,394150,93120,301030,0.7637447672206013,-1
2585,2586,HBR Layout,257050,55810,201240,0.7828827076444271,-1
2586,2587,CV Raman Nagar,312750,39540,273210,0.8735731414868105,-1
2587,2588,Jalahalli,48450,27690,20760,0.4284829721362229,0
2588,2589,Horamavu,215400,40650,174750,0.8112813370473537,0
2589,2590,Horamavu,444150,84690,359460,0.8093211752786221,-1
2590,2591,Hoodi,305900,88510,217390,0.7106570774762995,-1
2591,2592,Kalyan Nagar,418000,57630,360370,0.8621291866028709,-1
2592,2593,Jalahalli,385250,55910,329340,0.8548734587929916,-1
2593,2594,Horamavu,378600,58620,319980,0.8451664025356577,-1
2594,2595,Varthur,47650,23300,24350,0.5110178384050367,0
2595,2596,Krishnarajapuram,405150,32020,373130,0.9209675428853511,-1
2596,2597,Kammanahalli,49150,91750,-42600,-0.866734486266531,1
2597,2598,Horamavu,432000,44280,387720,0.8975,-1
2598,2599,Vasanth Nagar,390200,23270,366930,0.9403639159405434,-1
2599,2600,Mahadevapura,339550,68130,271420,0.7993520836401119,0
2600,2601,Shivajinagar,209350,96260,113090,0.5401958442799141,1
2601,2602,Shivajinagar,242500,49170,193330,0.7972371134020618,-1
2602,2603,Hoodi,386700,110730,275970,0.7136539953452289,0
2603,2604,Jalahalli,210050,104140,105910,0.5042132825517733,0
2604,2605,Mahadevapura,230250,37350,192900,0.8377850162866449,0
2605,2606,HBR Layout,137450,12490,124960,0.9091305929428883,-1
2606,2607,Malleswaram,177250,17780,159470,0.8996897038081806,-1
2607,2608,HBR Layout,132950,33380,99570,0.7489281684843926,-1
2608,2609,Hebbal,220750,0,220750,1.0,-1
2609,2610,Malleswaram,257150,31510,225640,0.8774645148745868,-1
2610,2611,Whitefield,434700,35460,399240,0.9184265010351967,-1
2611,2612,Malleswaram,337050,55800,281250,0.8344459279038718,0
2612,2613,Shivajinagar,217750,83680,134070,0.6157060849598163,0
2613,2614,Horamavu,312050,67360,244690,0.7841371575068098,0
2614,2615,Marathahalli,205150,92450,112700,0.5493541311235681,1
2615,2616,Mahadevapura,223350,26250,197100,0.8824714573539288,0
2616,2617,Indiranagar,372850,50360,322490,0.8649322783961378,-1
2617,2618,Hoodi,42650,36490,6160,0.14443141852286048,1
2618,2619,CV Raman Nagar,335000,130530,204470,0.6103582089552239,0
2619,2620,Marathahalli,185350,60300,125050,0.6746695441057459,0
2620,2621,Banaswadi,197900,64450,133450,0.6743304699343102,0
2621,2622,Banaswadi,218250,60630,157620,0.7221993127147767,0
2622,2623,Indiranagar,292700,81850,210850,0.7203621455415101,-1
2623,2624,Malleswaram,56050,28250,27800,0.495985727029438,1
2624,2625,Hebbal,338600,31910,306690,0.9057590076786769,-1
2625,2626,Indiranagar,374500,64670,309830,0.8273164218958612,0
2626,2627,Varthur,90250,78630,11620,0.12875346260387813,1
2627,2628,Kalyan Nagar,272850,84800,188050,0.6892065237309877,0
2628,2629,Rajajinagar,419850,27160,392690,0.9353102298439919,-1
2629,2630,Kammanahalli,378700,33790,344910,0.9107736994982836,-1
2630,2631,Krishnarajapuram,160500,30620,129880,0.809221183800623,-1
2631,2632,Mahadevapura,427650,67470,360180,0.8422307962118555,-1
2632,2633,HBR Layout,239400,101120,138280,0.5776106934001671,0
2633,2634,Marathahalli,391450,63550,327900,0.8376548729084174,-1
2634,2635,Malleswaram,25250,118890,-93640,-3.7085148514851487,1
2635,2636,Malleswaram,431300,49270,382030,0.8857639693948528,-1
2636,2637,Krishnarajapuram,256400,58460,197940,0.771996879875195,0
2637,2638,Jalahalli,358950,78340,280610,0.7817523331940381,0
2638,2639,Shivajinagar,192300,101000,91300,0.4747789911596464,1
2639,2640,Indiranagar,438500,64480,374020,0.8529532497149372,0
2640,2641,HBR Layout,43250,28210,15040,0.3477456647398844,1
2641,2642,Krishnarajapuram,173200,24650,148550,0.8576789838337182,-1
2642,2643,Jalahalli,274950,30590,244360,0.8887434078923441,-1
2643,2644,Krishnarajapuram,416750,51830,364920,0.8756328734253149,-1
2644,2645,Kammanahalli,326650,70830,255820,0.7831624062452166,-1
2645,2646,Indiranagar,318900,38510,280390,0.8792411414236437,-1
2646,2647,Kalyan Nagar,108300,77140,31160,0.28771929824561404,1
2647,2648,Hoodi,402150,53650,348500,0.866592067636454,-1
2648,2649,Banaswadi,72450,51310,21140,0.29178743961352654,1
2649,2650,Hoodi,77900,35900,42000,0.5391527599486521,0
2650,2651,HBR Layout,280050,26310,253740,0.9060524906266738,-1
2651,2652,Rajajinagar,325550,59570,265980,0.8170173552449701,-1
2652,2653,Kalyan Nagar,134100,88720,45380,0.3384041759880686,1
2653,2654,Horamavu,280700,75280,205420,0.7318133238332739,-1
2654,2655,Whitefield,68400,47990,20410,0.2983918128654971,1
2655,2656,Vasanth Nagar,59250,35220,24030,0.40556962025316456,0
2656,2657,Varthur,76100,42960,33140,0.4354796320630749,1
2657,2658,CV Raman Nagar,279950,31970,247980,0.8858010358992677,-1
2658,2659,Malleswaram,404900,58650,346250,0.8551494196097802,0
2659,2660,HBR Layout,421650,61520,360130,0.8540969998814182,-1
2660,2661,Malleswaram,43600,94340,-50740,-1.1637614678899082,1
2661,2662,Krishnarajapuram,325000,52210,272790,0.8393538461538461,-1
2662,2663,Banaswadi,165300,58600,106700,0.6454930429522081,0
2663,2664,Kammanahalli,285150,51000,234150,0.8211467648605997,-1
2664,2665,Kammanahalli,300150,86740,213410,0.7110111610861236,0
2665,2666,Mahadevapura,272500,20800,251700,0.9236697247706422,-1
2666,2667,Mahadevapura,172500,30220,142280,0.8248115942028985,0
2667,2668,CV Raman Nagar,361650,45440,316210,0.8743536568505461,0
2668,2669,Krishnarajapuram,209950,40310,169640,0.8080019052155275,-1
2669,2670,Kalyan Nagar,183750,31640,152110,0.8278095238095238,-1
2670,2671,Vasanth Nagar,241200,116100,125100,0.5186567164179104,0
2671,2672,Rajajinagar,440900,80910,359990,0.8164889997731912,0
2672,2673,Krishnarajapuram,59650,16740,42910,0.7193629505448449,0
2673,2674,Banaswadi,282000,88270,193730,0.6869858156028369,0
2674,2675,Shivajinagar,424100,43570,380530,0.8972647960386702,-1
2675,2676,Indiranagar,349300,56250,293050,0.838963641568852,0
2676,2677,Marathahalli,446800,76420,370380,0.8289615040286482,0
2677,2678,Varthur,138500,39050,99450,0.7180505415162455,0
2678,2679,Kalyan Nagar,311400,106730,204670,0.6572575465639049,0
2679,2680,Malleswaram,116850,23890,92960,0.7955498502353444,0
2680,2681,Hoodi,349000,23020,325980,0.9340401146131805,-1
2681,2682,HBR Layout,428700,32370,396330,0.9244926522043387,-1
2682,2683,Kalyan Nagar,238950,40800,198150,0.8292529817953547,-1
2683,2684,Shivajinagar,438950,25270,413680,0.9424308007745756,-1
2684,2685,Krishnarajapuram,53500,42510,10990,0.20542056074766354,1
2685,2686,Vasanth Nagar,444200,40310,403890,0.9092525889239081,-1
2686,2687,Hebbal,198200,62690,135510,0.6837033299697276,0
2687,2688,Hoodi,374400,25950,348450,0.9306891025641025,-1
2688,2689,Rajajinagar,419000,96280,322720,0.7702147971360381,0
2689,2690,Rajajinagar,296400,79170,217230,0.7328947368421053,0
2690,2691,Hebbal,292150,0,292150,1.0,-1
2691,2692,Vasanth Nagar,144800,65830,78970,0.5453729281767956,0
2692,2693,CV Raman Nagar,62200,85450,-23250,-0.3737942122186495,1
2693,2694,HBR Layout,90600,123990,-33390,-0.36854304635761587,1
2694,2695,Varthur,125750,137470,-11720,-0.09320079522862823,1
2695,2696,Varthur,399850,87380,312470,0.7814680505189446,0
2696,2697,Varthur,173250,58130,115120,0.6644733044733044,0
2697,2698,Varthur,248950,56330,192620,0.7737296645912833,0
2698,2699,Kammanahalli,399950,133020,266930,0.6674084260532567,0
2699,2700,CV Raman Nagar,342050,25770,316280,0.9246601374068119,-1
2700,2701,Indiranagar,242400,28170,214230,0.8837871287128712,-1
2701,2702,Shivajinagar,56800,54720,2080,0.036619718309859155,1
2702,2703,Hebbal,178250,7750,170500,0.9565217391304348,-1
2703,2704,Kalyan Nagar,323750,65400,258350,0.797992277992278,0
2704,2705,Marathahalli,33000,41190,-8190,-0.24818181818181817,1
2705,2706,Rajajinagar,293350,93470,199880,0.681370376683143,0
2706,2707,Vasanth Nagar,111700,44240,67460,0.6039391226499552,0
2707,2708,CV Raman Nagar,275500,102500,173000,0.6279491833030852,0
2708,2709,Hoodi,160350,110330,50020,0.3119426255067041,1
2709,2710,Indiranagar,422450,97420,325030,0.7693928275535566,-1
2710,2711,CV Raman Nagar,121600,50610,70990,0.5837993421052632,1
2711,2712,Banaswadi,304150,46870,257280,0.8458984053920763,0
2712,2713,Jalahalli,241800,0,241800,1.0,-1
2713,2714,Rajajinagar,368050,0,368050,1.0,-1
2714,2715,Malleswaram,381200,43730,337470,0.885283315844701,-1
2715,2716,CV Raman Nagar,233850,1890,231960,0.9919178960872355,-1
2716,2717,Vasanth Nagar,209250,57370,151880,0.7258303464755078,0
2717,2718,Jalahalli,417350,35790,381560,0.9142446387923805,-1
2718,2719,Hoodi,179250,64480,114770,0.640278940027894,0
2719,2720,Malleswaram,112700,59110,53590,0.47551020408163264,1
2720,2721,Whitefield,373000,33410,339590,0.9104289544235925,-1
2721,2722,Malleswaram,385750,205750,180000,0.4666234607906675,1
2722,2723,Banaswadi,110200,50940,59260,0.5377495462794918,1
2723,2724,HBR Layout,134150,69550,64600,0.4815505031680954,1
2724,2725,Hoodi,323900,52950,270950,0.836523618400741,0
2725,2726,Hebbal,209500,58900,150600,0.718854415274463,0
2726,2727,Banaswadi,324400,89150,235250,0.7251849568434032,0
2727,2728,Kammanahalli,167700,67040,100660,0.6002385211687538,0
2728,2729,Jalahalli,356250,77740,278510,0.7817824561403509,-1
2729,2730,Hoodi,350850,50530,300320,0.85597833832122,0
2730,2731,Whitefield,44300,65090,-20790,-0.46930022573363434,1
2731,2732,Whitefield,399900,80310,319590,0.7991747936984246,-1
2732,2733,HBR Layout,390250,123550,266700,0.683408071748879,0
2733,2734,Hoodi,304300,58350,245950,0.8082484390404207,0
2734,2735,Kammanahalli,311850,36340,275510,0.8834696168029501,-1
2735,2736,Kammanahalli,296700,129710,166990,0.5628244017526121,0
2736,2737,Kammanahalli,408050,7300,400750,0.9821100355348609,-1
2737,2738,Rajajinagar,303400,28710,274690,0.9053724456163481,-1
2738,2739,Banaswadi,430050,16810,413240,0.9609115219160562,-1
2739,2740,Kalyan Nagar,192950,107680,85270,0.4419279606115574,1
2740,2741,Whitefield,348950,0,348950,1.0,-1
2741,2742,Marathahalli,221300,55970,165330,0.7470854044283778,0
2742,2743,Hebbal,256850,58030,198820,0.7740704691454157,0
2743,2744,Mahadevapura,44000,34360,9640,0.2190909090909091,1
2744,2745,Whitefield,447450,146000,301450,0.6737065593921109,0
2745,2746,HBR Layout,127050,74850,52200,0.41086186540731995,1
2746,2747,Varthur,137050,24320,112730,0.8225465158701204,-1
2747,2748,Hebbal,129450,58870,70580,0.5452298184627269,0
2748,2749,HBR Layout,388600,31090,357510,0.9199948533196088,-1
2749,2750,Horamavu,96300,45460,50840,0.5279335410176532,0
2750,2751,Jalahalli,431150,94830,336320,0.7800533457033515,0
2751,2752,Kammanahalli,417600,41680,375920,0.900191570881226,-1
2752,2753,Hebbal,254650,24750,229900,0.9028077753779697,-1
2753,2754,Krishnarajapuram,416100,43840,372260,0.8946407113674597,0
2754,2755,Jalahalli,167450,69020,98430,0.5878172588832488,0
2755,2756,Indiranagar,412500,46530,365970,0.8872,-1
2756,2757,Horamavu,237650,49170,188480,0.7930990953082264,-1
2757,2758,Hoodi,385900,59530,326370,0.845737237626328,-1
2758,2759,Horamavu,340450,61030,279420,0.8207372595094727,-1
2759,2760,Kalyan Nagar,395850,24690,371160,0.9376278893520272,-1
2760,2761,Marathahalli,244150,29890,214260,0.8775752611099734,0
2761,2762,Rajajinagar,264400,77950,186450,0.7051815431164902,-1
2762,2763,Krishnarajapuram,388850,69970,318880,0.82005914877202,0
2763,2764,Mahadevapura,104850,54320,50530,0.48192656175488796,1
2764,2765,HBR Layout,154850,86850,68000,0.439134646432031,1
2765,2766,HBR Layout,270650,76900,193750,0.715869203768705,0
2766,2767,HBR Layout,43400,100940,-57540,-1.3258064516129033,1
2767,2768,HBR Layout,392650,67370,325280,0.8284222590092958,-1
2768,2769,HBR Layout,428350,83940,344410,0.8040387533559006,-1
2769,2770,Varthur,133450,39800,93650,0.7017609591607343,-1
2770,2771,Rajajinagar,369450,78620,290830,0.7871971850047368,-1
2771,2772,Shivajinagar,85500,0,85500,1.0,-1
2772,2773,Malleswaram,444850,106680,338170,0.7601888276947285,0
2773,2774,Marathahalli,125400,86380,39020,0.31116427432216903,1
2774,2775,Marathahalli,265200,38520,226680,0.8547511312217194,0
2775,2776,Indiranagar,417800,45810,371990,0.8903542364767831,-1
2776,2777,Marathahalli,148750,133300,15450,0.1038655462184874,1
2777,2778,HBR Layout,172650,52180,120470,0.6977700550246163,0
2778,2779,Marathahalli,445450,33730,411720,0.9242788191716242,-1
2779,2780,Rajajinagar,387350,95970,291380,0.7522395766103007,0
2780,2781,Mahadevapura,279400,70340,209060,0.7482462419470294,-1
2781,2782,Malleswaram,68900,35250,33650,0.488388969521045,1
2782,2783,Varthur,77650,85590,-7940,-0.10225370251126852,1
2783,2784,Rajajinagar,38050,81780,-43730,-1.1492772667542708,1
2784,2785,Kalyan Nagar,380350,65640,314710,0.8274221112133561,-1
2785,2786,Varthur,157050,114150,42900,0.2731614135625597,1
2786,2787,HBR Layout,392000,68040,323960,0.8264285714285714,-1
2787,2788,Rajajinagar,254800,73240,181560,0.7125588697017269,0
2788,2789,Malleswaram,316950,46350,270600,0.8537624230951254,-1
2789,2790,Mahadevapura,74950,75630,-680,-0.009072715143428953,1
2790,2791,Varthur,196150,130850,65300,0.33290848840173337,1
2791,2792,Malleswaram,100400,30660,69740,0.6946215139442231,0
2792,2793,Mahadevapura,396350,96080,300270,0.7575879904125142,-1
2793,2794,Kammanahalli,322550,129440,193110,0.5986978762982483,0
2794,2795,Whitefield,317850,86590,231260,0.7275759005820356,0
2795,2796,Whitefield,370600,96100,274500,0.7406907717215326,0
2796,2797,Krishnarajapuram,374000,32230,341770,0.9138235294117647,-1
2797,2798,Whitefield,191150,74490,116660,0.6103060423750981,0
2798,2799,Malleswaram,377900,26610,351290,0.9295845461762371,-1
2799,2800,Shivajinagar,306050,42700,263350,0.8604803136742363,-1
2800,2801,Banaswadi,340700,44210,296490,0.8702377458174347,-1
2801,2802,Vasanth Nagar,116750,107500,9250,0.07922912205567452,1
2802,2803,HBR Layout,204950,43420,161530,0.788143449621859,-1
2803,2804,Malleswaram,77400,54070,23330,0.30142118863049094,1
2804,2805,Rajajinagar,317650,61130,256520,0.8075554855973556,0
2805,2806,Hebbal,437550,80630,356920,0.8157239172665981,-1
2806,2807,Jalahalli,198150,106240,91910,0.4638405248549079,1
2807,2808,Malleswaram,450000,113400,336600,0.748,0
2808,2809,Marathahalli,370050,14540,355510,0.9607080124307527,-1
2809,2810,Vasanth Nagar,252300,71360,180940,0.7171621086008719,0
2810,2811,Kammanahalli,388150,98540,289610,0.7461290738116707,0
2811,2812,CV Raman Nagar,59350,88290,-28940,-0.48761583824768323,1
2812,2813,HBR Layout,173600,15600,158000,0.9101382488479263,-1
2813,2814,Indiranagar,352150,39400,312750,0.8881158597188697,0
2814,2815,Marathahalli,325200,40620,284580,0.8750922509225092,-1
2815,2816,Banaswadi,239300,79090,160210,0.6694943585457585,0
2816,2817,Horamavu,277550,58230,219320,0.7901999639704558,0
2817,2818,Jalahalli,321650,21420,300230,0.9334058759521219,-1
2818,2819,Vasanth Nagar,369150,61590,307560,0.8331572531491264,-1
2819,2820,Shivajinagar,349150,6120,343030,0.9824717170270657,-1
2820,2821,Jalahalli,310600,92800,217800,0.7012234385061172,-1
2821,2822,Banaswadi,369150,24740,344410,0.9329811729649194,-1
2822,2823,CV Raman Nagar,303000,55200,247800,0.8178217821782178,-1
2823,2824,Kalyan Nagar,237450,110020,127430,0.5366603495472732,0
2824,2825,Hebbal,46350,33010,13340,0.2878101402373247,1
2825,2826,Horamavu,237900,64890,173010,0.7272383354350568,0
2826,2827,Varthur,273250,48850,224400,0.8212259835315645,0
2827,2828,Krishnarajapuram,250500,17090,233410,0.9317764471057884,-1
2828,2829,Jalahalli,357850,54280,303570,0.8483163336593544,0
2829,2830,Jalahalli,83050,16320,66730,0.8034918723660446,0
2830,2831,Kalyan Nagar,351050,31510,319540,0.9102407064520723,-1
2831,2832,Kalyan Nagar,284300,60470,223830,0.7873021456208231,-1
2832,2833,CV Raman Nagar,249600,83260,166340,0.6664262820512821,0
2833,2834,Marathahalli,140850,57600,83250,0.5910543130990416,0
2834,2835,CV Raman Nagar,406650,98380,308270,0.7580720521332841,0
2835,2836,Jalahalli,243000,76530,166470,0.6850617283950617,0
2836,2837,Horamavu,113700,82500,31200,0.27440633245382584,1
2837,2838,Horamavu,36300,93790,-57490,-1.5837465564738291,1
2838,2839,HBR Layout,129150,90500,38650,0.29926442121564073,1
2839,2840,Whitefield,29200,43670,-14470,-0.49554794520547946,1
2840,2841,Krishnarajapuram,115900,43330,72570,0.6261432269197584,0
2841,2842,HBR Layout,317900,139060,178840,0.5625668449197861,1
2842,2843,Horamavu,335200,86280,248920,0.7426014319809069,0
2843,2844,Vasanth Nagar,201750,15150,186600,0.924907063197026,-1
2844,2845,Indiranagar,138350,76440,61910,0.44748825442717743,1
2845,2846,Marathahalli,225600,71610,153990,0.6825797872340426,0
2846,2847,Marathahalli,298650,72020,226630,0.758848150008371,0
2847,2848,Shivajinagar,121050,107000,14050,0.1160677406030566,1
2848,2849,Mahadevapura,165900,79550,86350,0.5204942736588306,1
2849,2850,Malleswaram,428900,53350,375550,0.8756120307764047,0
2850,2851,Kammanahalli,359050,41680,317370,0.8839158891519286,-1
2851,2852,Kammanahalli,282900,43450,239450,0.8464121597737716,-1
2852,2853,Kalyan Nagar,220100,74450,145650,0.661744661517492,0
2853,2854,CV Raman Nagar,77200,87990,-10790,-0.13976683937823833,1
2854,2855,Marathahalli,177100,127840,49260,0.27814793901750423,1
2855,2856,Marathahalli,334650,70420,264230,0.789571193784551,0
2856,2857,CV Raman Nagar,339450,84230,255220,0.7518633082928267,0
2857,2858,Varthur,208450,58060,150390,0.7214679779323578,0
2858,2859,Jalahalli,131550,87310,44240,0.3362979855568225,1
2859,2860,Malleswaram,214550,52610,161940,0.7547890934514099,0
2860,2861,Varthur,205300,80010,125290,0.6102776424744276,0
2861,2862,Krishnarajapuram,345100,46910,298190,0.8640683859750797,0
2862,2863,CV Raman Nagar,312700,86810,225890,0.7223856731691717,0
2863,2864,Malleswaram,195650,7090,188560,0.9637618195757731,-1
2864,2865,Hoodi,342200,44200,298000,0.8708357685563998,-1
2865,2866,Kammanahalli,110200,33780,76420,0.6934664246823956,0
2866,2867,Hoodi,200450,124960,75490,0.3766026440508855,1
2867,2868,Shivajinagar,368900,78080,290820,0.7883437245866088,0
2868,2869,Mahadevapura,212900,52220,160680,0.7547205260685768,-1
2869,2870,Indiranagar,348950,139780,209170,0.599426851984525,1
2870,2871,Mahadevapura,37450,79760,-42310,-1.1297730307076101,1
2871,2872,Krishnarajapuram,110900,76350,34550,0.31154192966636607,1
2872,2873,Krishnarajapuram,53150,36560,16590,0.3121354656632173,1
2873,2874,Rajajinagar,419700,29750,389950,0.9291160352632833,-1
2874,2875,CV Raman Nagar,271150,138430,132720,0.4894707726350728,1
2875,2876,Kalyan Nagar,418750,33370,385380,0.9203104477611941,-1
2876,2877,Vasanth Nagar,396750,46630,350120,0.8824700693131695,-1
2877,2878,Horamavu,322700,22680,300020,0.9297180043383948,-1
2878,2879,Kalyan Nagar,261000,94400,166600,0.6383141762452107,0
2879,2880,Mahadevapura,93200,111640,-18440,-0.19785407725321888,1
2880,2881,Vasanth Nagar,246500,71900,174600,0.708316430020284,0
2881,2882,Varthur,306500,100900,205600,0.6707993474714519,0
2882,2883,Horamavu,131200,98770,32430,0.2471798780487805,1
2883,2884,Kalyan Nagar,40600,95250,-54650,-1.3460591133004927,1
2884,2885,Mahadevapura,402500,45380,357120,0.8872546583850932,0
2885,2886,Marathahalli,348300,48340,299960,0.8612115991960954,0
2886,2887,Krishnarajapuram,187950,115780,72170,0.3839851024208566,1
2887,2888,Varthur,193500,16660,176840,0.9139018087855297,-1
2888,2889,Hoodi,123350,70560,52790,0.4279691933522497,1
2889,2890,Kalyan Nagar,184850,40720,144130,0.77971328103868,-1
2890,2891,Varthur,238000,63150,174850,0.7346638655462185,0
2891,2892,CV Raman Nagar,428800,35620,393180,0.9169309701492537,-1
2892,2893,HBR Layout,323600,54150,269450,0.832663782447466,-1
2893,2894,Rajajinagar,352400,54020,298380,0.8467082860385925,-1
2894,2895,Malleswaram,60100,63390,-3290,-0.05474209650582363,1
2895,2896,CV Raman Nagar,230700,89620,141080,0.6115301257043779,0
2896,2897,Banaswadi,296300,16390,279910,0.9446844414444819,-1
2897,2898,CV Raman Nagar,200350,115030,85320,0.4258547541801847,1
2898,2899,Banaswadi,447650,85040,362610,0.8100301574891098,-1
2899,2900,Malleswaram,343150,47540,295610,0.8614600029141775,-1
2900,2901,Indiranagar,308200,123450,184750,0.5994484101232965,0
2901,2902,Indiranagar,394250,52360,341890,0.8671908687381104,0
2902,2903,CV Raman Nagar,167100,71840,95260,0.5700777977259126,1
2903,2904,Vasanth Nagar,336200,115840,220360,0.6554431885782273,0
2904,2905,Hoodi,174600,100970,73630,0.42170675830469645,0
2905,2906,Malleswaram,315500,122430,193070,0.6119492868462757,0
2906,2907,Marathahalli,348600,101730,246870,0.7081755593803787,-1
2907,2908,Shivajinagar,378100,92970,285130,0.7541126686061889,0
2908,2909,Hebbal,406950,115790,291160,0.7154687308023099,-1
2909,2910,Horamavu,314350,57910,256440,0.8157785907428026,0
2910,2911,Kammanahalli,243900,80980,162920,0.6679786797867978,0
2911,2912,Malleswaram,333350,52160,281190,0.8435278236088195,-1
2912,2913,Kammanahalli,391400,19200,372200,0.9509453244762391,-1
2913,2914,Shivajinagar,180200,60770,119430,0.6627635960044395,0
2914,2915,Mahadevapura,69400,15530,53870,0.7762247838616715,0
2915,2916,Shivajinagar,128900,80310,48590,0.3769588828549263,1
2916,2917,Shivajinagar,440950,6480,434470,0.9853044562875609,-1
2917,2918,Malleswaram,328200,67030,261170,0.7957647775746496,-1
2918,2919,Mahadevapura,438650,74200,364450,0.8308446369542916,-1
2919,2920,Mahadevapura,93200,61470,31730,0.34045064377682405,1
2920,2921,Horamavu,371700,85520,286180,0.7699219800914716,0
2921,2922,Vasanth Nagar,131450,65530,65920,0.501483453784709,0
2922,2923,Indiranagar,264700,43820,220880,0.8344540989799774,-1
2923,2924,Kalyan Nagar,106550,9670,96880,0.9092444861567339,-1
2924,2925,Whitefield,83700,54090,29610,0.35376344086021505,1
2925,2926,Shivajinagar,308950,36980,271970,0.8803042563521606,-1
2926,2927,Kalyan Nagar,107950,114340,-6390,-0.05919407132931913,1
2927,2928,HBR Layout,275300,90920,184380,0.6697420995277878,0
2928,2929,Varthur,393350,8650,384700,0.9780094063810856,-1
2929,2930,Mahadevapura,124950,61220,63730,0.5100440176070428,0
2930,2931,Shivajinagar,387750,84610,303140,0.7817923920051579,0
2931,2932,CV Raman Nagar,295000,56890,238110,0.8071525423728814,-1
2932,2933,Kalyan Nagar,373900,86770,287130,0.7679326023000802,-1
2933,2934,Indiranagar,103400,30620,72780,0.7038684719535784,0
2934,2935,Rajajinagar,337550,48070,289480,0.857591467930677,-1
2935,2936,Rajajinagar,243150,54800,188350,0.7746247172527246,0
2936,2937,Horamavu,443900,33730,410170,0.9240144176616355,-1
2937,2938,Shivajinagar,67650,24630,43020,0.635920177383592,0
2938,2939,Shivajinagar,376850,35490,341360,0.9058245986466764,-1
2939,2940,Rajajinagar,365750,76260,289490,0.791496924128503,0
2940,2941,Kammanahalli,288700,44300,244400,0.8465535157603048,-1
2941,2942,Hebbal,171400,68610,102790,0.599708284714119,0
2942,2943,Shivajinagar,231450,84940,146510,0.6330092892633398,0
2943,2944,Whitefield,405750,80370,325380,0.8019223659889094,-1
2944,2945,Jalahalli,66400,84810,-18410,-0.2772590361445783,1
2945,2946,Vasanth Nagar,85450,84740,710,0.008308952603861908,1
2946,2947,Kalyan Nagar,157600,34300,123300,0.7823604060913706,0
2947,2948,HBR Layout,372400,44040,328360,0.8817400644468314,-1
2948,2949,Kalyan Nagar,70850,21900,48950,0.6908962597035991,0
2949,2950,Kalyan Nagar,235250,64090,171160,0.7275664187035069,-1
2950,2951,Jalahalli,247600,61060,186540,0.7533925686591276,0
2951,2952,Hoodi,375100,112320,262780,0.7005598507064783,0
2952,2953,Varthur,100550,58840,41710,0.41481849825957234,1
2953,2954,Varthur,63150,66170,-3020,-0.04782264449722882,1
2954,2955,Mahadevapura,203500,86100,117400,0.576904176904177,1
2955,2956,Krishnarajapuram,51800,97040,-45240,-0.8733590733590734,1
2956,2957,Vasanth Nagar,236200,86900,149300,0.6320914479254869,0
2957,2958,Indiranagar,225200,57260,167940,0.7457371225577265,0
2958,2959,Hebbal,318000,162560,155440,0.48880503144654086,0
2959,2960,Hebbal,312350,62680,249670,0.7993276772850968,-1
2960,2961,Banaswadi,375400,126260,249140,0.6636654235482152,0
2961,2962,Vasanth Nagar,354500,70210,284290,0.8019464033850494,0
2962,2963,Hebbal,126700,48290,78410,0.618863456985004,0
2963,2964,Varthur,410350,63020,347330,0.846423784574144,-1
2964,2965,Mahadevapura,119450,48580,70870,0.5933026370866471,0
2965,2966,Varthur,31400,52730,-21330,-0.6792993630573249,1
2966,2967,Kalyan Nagar,293500,4710,288790,0.9839522998296423,-1
2967,2968,Malleswaram,387100,12380,374720,0.9680185998450013,-1
2968,2969,Horamavu,174250,60950,113300,0.6502152080344333,0
2969,2970,Whitefield,317400,7850,309550,0.9752678008821676,-1
2970,2971,Whitefield,137750,116640,21110,0.1532486388384755,1
2971,2972,Marathahalli,59650,49190,10460,0.17535624476110645,1
2972,2973,Varthur,288350,55330,233020,0.8081151378533032,0
2973,2974,Indiranagar,283450,55590,227860,0.8038807549832422,-1
2974,2975,Banaswadi,202200,35960,166240,0.8221562809099902,-1
2975,2976,Vasanth Nagar,53800,27250,26550,0.49349442379182157,1
2976,2977,Mahadevapura,400850,108750,292100,0.7287015092927529,-1
2977,2978,Indiranagar,346400,71290,275110,0.7941974595842957,-1
2978,2979,Jalahalli,287450,50570,236880,0.824073751956862,-1
2979,2980,Shivajinagar,52200,10700,41500,0.7950191570881227,0
2980,2981,Mahadevapura,302650,26580,276070,0.9121757806046589,-1
2981,2982,Banaswadi,140750,113180,27570,0.19587921847246892,1
2982,2983,Varthur,143950,121450,22500,0.15630427231677665,1
2983,2984,Varthur,325800,36950,288850,0.8865868631062002,-1
2984,2985,Kammanahalli,332550,101270,231280,0.6954743647571794,0
2985,2986,Hebbal,102700,57810,44890,0.4370983446932814,0
2986,2987,Hebbal,400950,63280,337670,0.8421748347674274,-1
2987,2988,Hoodi,318050,41990,276060,0.8679767332180475,-1
2988,2989,Whitefield,76650,82420,-5770,-0.07527723418134377,1
2989,2990,Vasanth Nagar,29450,68950,-39500,-1.3412563667232598,1
2990,2991,Shivajinagar,244200,67660,176540,0.722932022932023,0
2991,2992,Whitefield,375150,84350,290800,0.7751566040250566,0
2992,2993,Horamavu,298050,35930,262120,0.8794497567522228,-1
2993,2994,Marathahalli,90750,60640,30110,0.33179063360881544,1
2994,2995,Jalahalli,375800,63380,312420,0.8313464608834487,-1
2995,2996,Kalyan Nagar,425250,35540,389710,0.9164256319811875,-1
2996,2997,Marathahalli,106650,33930,72720,0.6818565400843882,0
2997,2998,Hebbal,355100,45850,309250,0.8708814418473669,0
2998,2999,Varthur,394550,104290,290260,0.7356735521480168,0
2999,3000,Hoodi,299500,87800,211700,0.7068447412353923,0
3000,3001,Kammanahalli,299350,101150,198200,0.6621012193085017,0
3001,3002,Marathahalli,421150,36590,384560,0.9131188412679568,-1
3002,3003,Jalahalli,89600,98820,-9220,-0.10290178571428571,1
3003,3004,Vasanth Nagar,227350,97620,129730,0.5706179898834396,0
3004,3005,Horamavu,342650,74320,268330,0.7831022909674595,0
3005,3006,Shivajinagar,207500,4090,203410,0.9802891566265061,-1
3006,3007,Vasanth Nagar,199650,156270,43380,0.2172802404207363,1
3007,3008,Kalyan Nagar,364550,84470,280080,0.768289672198601,0
3008,3009,Vasanth Nagar,169150,38890,130260,0.7700857227313036,-1
3009,3010,Banaswadi,58850,22230,36620,0.6222599830076465,0
3010,3011,Horamavu,394850,55270,339580,0.8600227934658731,0
3011,3012,HBR Layout,123050,41970,81080,0.6589191385615604,0
3012,3013,Whitefield,189700,38550,151150,0.7967843964153927,-1
3013,3014,Rajajinagar,200250,92980,107270,0.5356803995006242,0
3014,3015,Whitefield,254950,44240,210710,0.8264757795646205,-1
3015,3016,Kammanahalli,98650,48800,49850,0.5053218449062341,0
3016,3017,CV Raman Nagar,85450,87060,-1610,-0.018841427735517845,1
3017,3018,Jalahalli,425800,77080,348720,0.8189760450915923,-1
3018,3019,Indiranagar,279450,45810,233640,0.8360708534621578,-1
3019,3020,Whitefield,409300,120750,288550,0.7049841192279501,-1
3020,3021,Indiranagar,203550,26600,176950,0.8693195774993859,0
3021,3022,Marathahalli,174950,95560,79390,0.45378679622749357,1
3022,3023,HBR Layout,321350,85970,235380,0.7324723821378559,-1
3023,3024,Malleswaram,438600,82270,356330,0.8124259005927953,-1
3024,3025,Horamavu,44700,76850,-32150,-0.7192393736017897,1
3025,3026,HBR Layout,342300,101040,241260,0.704820333041192,0
3026,3027,HBR Layout,46450,54640,-8190,-0.17631862217438105,1
3027,3028,Krishnarajapuram,320050,83570,236480,0.7388845492891736,-1
3028,3029,Marathahalli,209400,102760,106640,0.5092645654250239,0
3029,3030,Shivajinagar,248000,98730,149270,0.6018951612903226,0
3030,3031,Kammanahalli,430400,68960,361440,0.8397769516728625,-1
3031,3032,Vasanth Nagar,279700,69780,209920,0.7505184125849124,0
3032,3033,Indiranagar,400600,62060,338540,0.845082376435347,-1
3033,3034,Vasanth Nagar,75750,27270,48480,0.64,0
3034,3035,CV Raman Nagar,32550,66170,-33620,-1.0328725038402458,1
3035,3036,Hebbal,405200,42350,362850,0.8954837117472852,-1
3036,3037,Horamavu,141000,26120,114880,0.8147517730496454,-1
3037,3038,Banaswadi,57650,101900,-44250,-0.7675628794449263,1
3038,3039,Vasanth Nagar,135450,38540,96910,0.7154669619785898,-1
3039,3040,Rajajinagar,293700,87970,205730,0.7004766768811712,-1
3040,3041,Horamavu,124650,58050,66600,0.5342960288808665,0
3041,3042,Vasanth Nagar,318350,89790,228560,0.7179519396890215,0
3042,3043,Varthur,54800,60530,-5730,-0.10456204379562044,1
3043,3044,Kammanahalli,352850,70420,282430,0.8004251098200369,-1
3044,3045,Marathahalli,354850,79430,275420,0.776158940397351,-1
3045,3046,Hoodi,324700,62380,262320,0.8078842008007392,-1
3046,3047,Hebbal,210800,19380,191420,0.9080645161290323,-1
3047,3048,Kalyan Nagar,189800,29700,160100,0.8435194942044257,-1
3048,3049,Malleswaram,331050,126570,204480,0.6176710466696873,0
3049,3050,Horamavu,138850,41450,97400,0.7014764133957508,-1
3050,3051,Krishnarajapuram,324350,23440,300910,0.9277323878526283,-1
3051,3052,Vasanth Nagar,318650,78280,240370,0.7543386160364036,0
3052,3053,Horamavu,300250,18250,282000,0.9392173189009159,-1
3053,3054,CV Raman Nagar,287500,106210,181290,0.6305739130434782,0
3054,3055,Mahadevapura,307800,109980,197820,0.6426900584795322,0
3055,3056,Krishnarajapuram,136800,54660,82140,0.6004385964912281,0
3056,3057,CV Raman Nagar,190900,25290,165610,0.8675222629649031,-1
3057,3058,Horamavu,383600,31720,351880,0.9173096976016684,-1
3058,3059,Marathahalli,35350,68770,-33420,-0.9454031117397454,1
3059,3060,Banaswadi,49700,29330,20370,0.4098591549295775,1
3060,3061,Kalyan Nagar,213300,87700,125600,0.5888420065635256,0
3061,3062,Mahadevapura,86700,94740,-8040,-0.09273356401384084,1
3062,3063,Kalyan Nagar,247350,112200,135150,0.5463917525773195,0
3063,3064,Jalahalli,59300,77660,-18360,-0.3096121416526138,1
3064,3065,Jalahalli,304650,0,304650,1.0,-1
3065,3066,Whitefield,250450,49250,201200,0.8033539628668397,-1
3066,3067,Whitefield,49850,39190,10660,0.21384152457372116,1
3067,3068,Varthur,373200,107690,265510,0.7114415862808146,-1
3068,3069,Horamavu,136300,50450,85850,0.6298606016140865,0
3069,3070,Jalahalli,432350,14520,417830,0.9664160980686943,-1
3070,3071,Whitefield,262800,61170,201630,0.7672374429223744,0
3071,3072,Hebbal,436300,106360,329940,0.756222782489113,-1
3072,3073,CV Raman Nagar,352250,39080,313170,0.889056068133428,-1
3073,3074,Kammanahalli,164100,78470,85630,0.5218159658744668,1
3074,3075,Jalahalli,245800,41890,203910,0.8295768917819365,-1
3075,3076,Kammanahalli,339750,55480,284270,0.8367034584253127,-1
3076,3077,Kammanahalli,137100,52960,84140,0.613712618526623,0
3077,3078,Marathahalli,192700,93240,99460,0.5161390762843798,0
3078,3079,Jalahalli,308300,125730,182570,0.5921829386960753,0
3079,3080,HBR Layout,253000,70370,182630,0.7218577075098814,-1
3080,3081,Hebbal,306300,58410,247890,0.8093046033300686,-1
3081,3082,Horamavu,412100,35860,376240,0.9129822858529483,-1
3082,3083,Hebbal,211350,130460,80890,0.38273006860657677,1
3083,3084,Shivajinagar,179300,18150,161150,0.8987730061349694,-1
3084,3085,Horamavu,82050,17900,64150,0.7818403412553321,0
3085,3086,Rajajinagar,122750,80880,41870,0.3410997963340122,1
3086,3087,Malleswaram,121200,74490,46710,0.3853960396039604,1
3087,3088,Kalyan Nagar,109300,43400,65900,0.6029277218664227,0
3088,3089,Banaswadi,419700,99110,320590,0.7638551346199667,-1
3089,3090,Malleswaram,433500,70910,362590,0.8364244521337947,-1
3090,3091,Whitefield,42250,68930,-26680,-0.6314792899408284,1
3091,3092,Mahadevapura,136650,36100,100550,0.7358214416392242,0
3092,3093,Banaswadi,376050,49510,326540,0.8683419758010903,0
3093,3094,Horamavu,367050,31090,335960,0.9152976433728375,-1
3094,3095,HBR Layout,45400,47350,-1950,-0.042951541850220265,1
3095,3096,Varthur,25050,63820,-38770,-1.5477045908183633,1
3096,3097,Marathahalli,402750,32090,370660,0.9203227808814402,-1
3097,3098,Vasanth Nagar,241800,68180,173620,0.7180314309346567,-1
3098,3099,Hoodi,177600,55170,122430,0.6893581081081082,0
3099,3100,Hebbal,70800,59150,11650,0.16454802259887005,1
3100,3101,Marathahalli,151650,51700,99950,0.6590834157599736,0
3101,3102,Rajajinagar,192500,66890,125610,0.6525194805194805,0
3102,3103,Malleswaram,330450,63560,266890,0.8076562263579967,-1
3103,3104,Banaswadi,349700,60850,288850,0.8259937088933371,0
3104,3105,Varthur,105550,28540,77010,0.7296068214116532,-1
3105,3106,CV Raman Nagar,255500,59600,195900,0.7667318982387475,0
3106,3107,Hoodi,154550,78730,75820,0.4905855710126173,0
3107,3108,Hoodi,102700,50140,52560,0.5117818889970789,1
3108,3109,Indiranagar,418100,21990,396110,0.9474049270509447,-1
3109,3110,Horamavu,407450,60850,346600,0.8506565222726715,-1
3110,3111,Hebbal,86500,32140,54360,0.6284393063583815,0
3111,3112,Marathahalli,416700,66780,349920,0.8397408207343412,0
3112,3113,Vasanth Nagar,324250,14770,309480,0.9544487278334618,-1
3113,3114,Hebbal,120200,84430,35770,0.29758735440931783,1
3114,3115,Mahadevapura,441000,28610,412390,0.935124716553288,-1
3115,3116,Jalahalli,30400,92320,-61920,-2.036842105263158,1
3116,3117,Hebbal,273050,108720,164330,0.6018311664530306,0
3117,3118,Hebbal,379550,38350,341200,0.8989592939006719,-1
3118,3119,Shivajinagar,31050,61860,-30810,-0.9922705314009662,1
3119,3120,Mahadevapura,67900,73210,-5310,-0.07820324005891016,1
3120,3121,Mahadevapura,92200,50000,42200,0.45770065075921906,1
3121,3122,Kammanahalli,351000,67780,283220,0.8068945868945869,-1
3122,3123,Kalyan Nagar,238050,60060,177990,0.7477000630119722,-1
3123,3124,Varthur,254900,82320,172580,0.6770498234601805,0
3124,3125,Vasanth Nagar,264900,62500,202400,0.7640619101547754,0
3125,3126,Whitefield,363450,29470,333980,0.918915944421516,-1
3126,3127,Rajajinagar,145550,57480,88070,0.6050841635176916,0
3127,3128,Varthur,70750,26880,43870,0.6200706713780919,0
3128,3129,Horamavu,93450,27090,66360,0.7101123595505618,-1
3129,3130,HBR Layout,274000,144050,129950,0.47427007299270074,0
3130,3131,HBR Layout,34650,108890,-74240,-2.142568542568543,1
3131,3132,Shivajinagar,181100,118570,62530,0.34527885146327997,1
3132,3133,Krishnarajapuram,187900,17630,170270,0.9061734965407131,-1
3133,3134,Marathahalli,171800,0,171800,1.0,-1
3134,3135,Hebbal,277200,93130,184070,0.6640331890331891,0
3135,3136,Krishnarajapuram,418200,63610,354590,0.847895743663319,-1
3136,3137,Marathahalli,295250,49310,245940,0.8329889923793395,0
3137,3138,Varthur,327000,53540,273460,0.8362691131498471,-1
3138,3139,Varthur,127800,68720,59080,0.4622848200312989,0
3139,3140,Hebbal,293250,29670,263580,0.8988235294117647,-1
3140,3141,HBR Layout,302950,28780,274170,0.905000825218683,-1
3141,3142,Jalahalli,400450,49560,350890,0.8762392308652766,-1
3142,3143,Banaswadi,62100,28320,33780,0.5439613526570048,0
3143,3144,Horamavu,93300,79000,14300,0.1532690246516613,1
3144,3145,Vasanth Nagar,189750,15950,173800,0.9159420289855073,-1
3145,3146,Jalahalli,155650,54680,100970,0.648699004176036,0
3146,3147,Kalyan Nagar,418650,74630,344020,0.821736534097695,0
3147,3148,Banaswadi,257750,95870,161880,0.6280504364694471,0
3148,3149,Kalyan Nagar,113350,39760,73590,0.6492280546978385,0
3149,3150,Varthur,377550,13260,364290,0.9648788239968216,-1
3150,3151,Hebbal,291100,92240,198860,0.6831329440054964,0
3151,3152,Jalahalli,55850,23080,32770,0.5867502238137869,0
3152,3153,Hebbal,335650,49770,285880,0.8517205422314912,0
3153,3154,Mahadevapura,299900,68430,231470,0.7718239413137713,0
3154,3155,CV Raman Nagar,279200,55330,223870,0.8018266475644699,0
3155,3156,Shivajinagar,57350,132840,-75490,-1.3163034001743679,1
3156,3157,Krishnarajapuram,229150,62390,166760,0.727732926030984,0
3157,3158,CV Raman Nagar,315450,75270,240180,0.7613884926295768,0
3158,3159,Mahadevapura,109300,58480,50820,0.46495882891125345,1
3159,3160,Hebbal,132500,96040,36460,0.27516981132075474,1
3160,3161,Rajajinagar,351800,63150,288650,0.8204945992040933,0
3161,3162,Hebbal,427050,21950,405100,0.9486008664090856,-1
3162,3163,Hebbal,49000,55770,-6770,-0.13816326530612244,1
3163,3164,Horamavu,272450,56410,216040,0.792952835382639,-1
3164,3165,Whitefield,266450,71490,194960,0.7316945017826985,0
3165,3166,Jalahalli,208900,36010,172890,0.8276208712302537,-1
3166,3167,Kammanahalli,48500,0,48500,1.0,-1
3167,3168,Banaswadi,392950,41890,351060,0.8933961063748569,0
3168,3169,HBR Layout,85050,74440,10610,0.12475014697236919,1
3169,3170,Mahadevapura,283700,71320,212380,0.7486076841734226,0
3170,3171,Vasanth Nagar,28900,127130,-98230,-3.3989619377162628,1
3171,3172,Horamavu,241150,52220,188930,0.7834542815674891,-1
3172,3173,Krishnarajapuram,427250,3460,423790,0.9919016968987712,-1
3173,3174,Hoodi,315450,68680,246770,0.7822792835631638,-1
3174,3175,Varthur,410850,134400,276450,0.6728733114275283,0
3175,3176,CV Raman Nagar,312050,45840,266210,0.8531004646691236,-1
3176,3177,Mahadevapura,166400,106270,60130,0.3613581730769231,1
3177,3178,Kammanahalli,141750,28120,113630,0.8016225749559083,-1
3178,3179,Kammanahalli,306350,74420,231930,0.7570752407377183,0
3179,3180,Rajajinagar,146650,15970,130680,0.8911012615069894,-1
3180,3181,Malleswaram,396600,620,395980,0.9984367120524458,-1
3181,3182,Malleswaram,64750,16230,48520,0.7493436293436293,0
3182,3183,Rajajinagar,42450,59100,-16650,-0.392226148409894,1
3183,3184,CV Raman Nagar,223750,90800,132950,0.5941899441340782,1
3184,3185,Mahadevapura,354750,32600,322150,0.9081042988019732,-1
3185,3186,Shivajinagar,411850,41700,370150,0.8987495447371616,0
3186,3187,Mahadevapura,94400,71770,22630,0.23972457627118643,1
3187,3188,Malleswaram,375200,29060,346140,0.9225479744136461,-1
3188,3189,HBR Layout,109450,51110,58340,0.5330287802649611,1
3189,3190,Malleswaram,243200,54400,188800,0.7763157894736842,0
3190,3191,HBR Layout,442100,65740,376360,0.8513006107215562,-1
3191,3192,Varthur,387000,12620,374380,0.967390180878553,-1
3192,3193,Banaswadi,259350,3230,256120,0.9875457875457876,-1
3193,3194,Rajajinagar,89050,104680,-15630,-0.1755193711398091,1
3194,3195,Rajajinagar,144700,127080,17620,0.12176917760884588,1
3195,3196,Horamavu,296200,110300,185900,0.6276164753544902,0
3196,3197,CV Raman Nagar,336350,43020,293330,0.8720975174669243,0
3197,3198,Whitefield,416350,61460,354890,0.8523838116968896,-1
3198,3199,Whitefield,36650,34570,2080,0.05675306957708049,1
3199,3200,Kammanahalli,284950,49930,235020,0.8247762765397438,-1
3200,3201,Varthur,264250,59710,204540,0.7740397350993378,0
3201,3202,CV Raman Nagar,185750,102620,83130,0.4475370121130552,1
3202,3203,Hoodi,146550,57570,88980,0.607164790174002,0
3203,3204,Marathahalli,442900,52950,389950,0.8804470535109505,-1
3204,3205,Varthur,109950,86190,23760,0.21609822646657573,1
3205,3206,Vasanth Nagar,373450,35880,337570,0.9039228812424689,-1
3206,3207,Banaswadi,175100,25580,149520,0.853912050256996,0
3207,3208,Indiranagar,41050,55300,-14250,-0.3471376370280146,1
3208,3209,Kalyan Nagar,207850,96640,111210,0.5350493144094299,0
3209,3210,Kalyan Nagar,336500,41160,295340,0.8776820208023774,-1
3210,3211,Hoodi,152000,55140,96860,0.6372368421052632,0
3211,3212,Kalyan Nagar,230250,24310,205940,0.8944191096634093,0
3212,3213,Mahadevapura,194550,66810,127740,0.6565921356977641,0
3213,3214,Varthur,426150,84950,341200,0.8006570456412061,-1
3214,3215,Jalahalli,387400,81280,306120,0.7901910170366546,-1
3215,3216,Horamavu,267050,56630,210420,0.7879423328964613,0
3216,3217,Malleswaram,161450,83500,77950,0.482812016104057,1
3217,3218,Kammanahalli,123800,37810,85990,0.6945880452342488,0
3218,3219,Hoodi,327800,93770,234030,0.7139414276998169,0
3219,3220,Kalyan Nagar,159000,33360,125640,0.790188679245283,0
3220,3221,Horamavu,113850,30500,83350,0.7321036451471234,-1
3221,3222,Varthur,129150,59250,69900,0.5412311265969802,0
3222,3223,Hoodi,440550,15590,424960,0.9646124162978096,-1
3223,3224,Hoodi,124050,49610,74440,0.6000806126561871,0
3224,3225,Jalahalli,407400,10010,397390,0.9754295532646048,-1
3225,3226,Banaswadi,351200,25260,325940,0.9280751708428246,-1
3226,3227,Horamavu,342600,67420,275180,0.8032107413893753,0
3227,3228,Rajajinagar,38150,45330,-7180,-0.18820445609436434,1
3228,3229,Krishnarajapuram,187250,72120,115130,0.6148464619492657,0
3229,3230,Krishnarajapuram,404700,25970,378730,0.9358290091425747,-1
3230,3231,Vasanth Nagar,387450,92680,294770,0.7607949412827462,0
3231,3232,Rajajinagar,291900,78460,213440,0.7312093182596779,0
3232,3233,Kammanahalli,231800,106610,125190,0.5400776531492666,1
3233,3234,CV Raman Nagar,211150,141950,69200,0.32772910253374377,1
3234,3235,Varthur,434250,71280,362970,0.8358549222797927,0
3235,3236,Marathahalli,423850,64140,359710,0.8486728795564469,-1
3236,3237,Marathahalli,370300,22760,347540,0.9385363219011612,-1
3237,3238,Kammanahalli,180150,90900,89250,0.4954204829308909,0
3238,3239,Malleswaram,114000,53180,60820,0.5335087719298246,0
3239,3240,Horamavu,275150,38890,236260,0.8586589133200073,-1
3240,3241,Shivajinagar,293400,54830,238570,0.8131220177232448,-1
3241,3242,HBR Layout,78650,77850,800,0.010171646535282899,1
3242,3243,Malleswaram,133300,11170,122130,0.9162040510127532,-1
3243,3244,Hoodi,133850,43240,90610,0.676951811729548,0
3244,3245,Banaswadi,233000,52020,180980,0.7767381974248927,0
3245,3246,Jalahalli,252400,92470,159930,0.6336370839936608,0
3246,3247,Vasanth Nagar,200850,53870,146980,0.7317898929549415,-1
3247,3248,Vasanth Nagar,384250,52730,331520,0.8627716330513988,-1
3248,3249,Kalyan Nagar,332800,72840,259960,0.7811298076923077,0
3249,3250,Indiranagar,400250,83560,316690,0.7912304809494066,0
3250,3251,HBR Layout,193250,129090,64160,0.33200517464424323,1
3251,3252,Horamavu,436700,98710,337990,0.7739638195557591,0
3252,3253,Malleswaram,140050,70400,69650,0.4973223848625491,1
3253,3254,Jalahalli,354600,97160,257440,0.7260011280315849,-1
3254,3255,Hoodi,259450,57870,201580,0.7769512430140683,0
3255,3256,Shivajinagar,159000,59650,99350,0.6248427672955975,0
3256,3257,Rajajinagar,215400,106430,108970,0.5058960074280409,1
3257,3258,Malleswaram,410550,43840,366710,0.8932164170015833,-1
3258,3259,Kalyan Nagar,211850,11680,200170,0.9448666509322634,-1
3259,3260,Krishnarajapuram,362600,38040,324560,0.8950910093767237,-1
3260,3261,CV Raman Nagar,354850,41760,313090,0.8823164717486262,0
3261,3262,Indiranagar,154300,29150,125150,0.8110823071937784,-1
3262,3263,Horamavu,40800,13870,26930,0.6600490196078431,0
3263,3264,Mahadevapura,134000,40070,93930,0.7009701492537314,0
3264,3265,Rajajinagar,220750,47890,172860,0.7830577576443941,0
3265,3266,Malleswaram,289800,19660,270140,0.93216011042098,-1
3266,3267,Horamavu,282500,58250,224250,0.7938053097345132,-1
3267,3268,Whitefield,168850,77020,91830,0.5438554930411608,0
3268,3269,Shivajinagar,240350,74510,165840,0.6899937591013106,0
3269,3270,Kalyan Nagar,128100,90010,38090,0.2973458235753318,1
3270,3271,Mahadevapura,162200,53350,108850,0.6710850801479655,0
3271,3272,Mahadevapura,151650,84830,66820,0.44061984833498186,0
3272,3273,Horamavu,127200,121170,6030,0.047405660377358494,1
3273,3274,Rajajinagar,259400,30780,228620,0.8813415574402467,-1
3274,3275,Vasanth Nagar,141400,52590,88810,0.6280763790664781,0
3275,3276,Jalahalli,390100,60020,330080,0.8461420148679826,0
3276,3277,Varthur,33800,87010,-53210,-1.5742603550295857,1
3277,3278,Shivajinagar,241350,55030,186320,0.7719908846074166,0
3278,3279,Vasanth Nagar,291150,143080,148070,0.5085694659110425,0
3279,3280,Krishnarajapuram,359300,75030,284270,0.7911772891733927,0
3280,3281,CV Raman Nagar,323650,39470,284180,0.8780472732890469,-1
3281,3282,Rajajinagar,210900,43620,167280,0.793172119487909,0
3282,3283,Shivajinagar,186350,106730,79620,0.42726053125838476,1
3283,3284,Vasanth Nagar,110550,55110,55440,0.5014925373134328,1
3284,3285,Horamavu,323950,65520,258430,0.7977465658280599,0
3285,3286,Kammanahalli,289400,8010,281390,0.9723220456116102,-1
3286,3287,Varthur,399600,61510,338090,0.846071071071071,0
3287,3288,Rajajinagar,67700,57500,10200,0.15066469719350073,1
3288,3289,HBR Layout,35100,42800,-7700,-0.21937321937321938,1
3289,3290,Jalahalli,166650,47850,118800,0.7128712871287128,0
3290,3291,Hebbal,433200,89760,343440,0.792797783933518,-1
3291,3292,Vasanth Nagar,302100,53750,248350,0.8220787818603111,-1
3292,3293,Shivajinagar,195500,122980,72520,0.3709462915601023,1
3293,3294,Malleswaram,100850,41870,58980,0.5848289538919187,1
3294,3295,Jalahalli,52700,90870,-38170,-0.7242884250474383,1
3295,3296,Shivajinagar,372750,32000,340750,0.9141515761234071,-1
3296,3297,Malleswaram,435650,70940,364710,0.8371628600941122,0
3297,3298,Jalahalli,343000,18810,324190,0.9451603498542274,-1
3298,3299,Indiranagar,185300,63840,121460,0.655477603885591,0
3299,3300,Mahadevapura,74650,60000,14650,0.19624916275954454,1
3300,3301,Malleswaram,338350,22050,316300,0.934830796512487,-1
3301,3302,HBR Layout,368300,43680,324620,0.8814010317675808,-1
3302,3303,Vasanth Nagar,139900,39610,100290,0.7168691922802002,0
3303,3304,Hebbal,232450,107090,125360,0.5392987739298774,0
3304,3305,Indiranagar,148950,111680,37270,0.2502181940248405,1
3305,3306,Vasanth Nagar,332250,39700,292550,0.8805116629044394,-1
3306,3307,HBR Layout,271550,36220,235330,0.8666175658258147,0
3307,3308,Hebbal,102800,82170,20630,0.2006809338521401,1
3308,3309,Indiranagar,160100,150800,9300,0.05808869456589631,1
3309,3310,Mahadevapura,221250,46750,174500,0.7887005649717514,-1
3310,3311,CV Raman Nagar,279400,24620,254780,0.911882605583393,-1
3311,3312,Mahadevapura,193100,86410,106690,0.5525116519937856,0
3312,3313,HBR Layout,420500,59660,360840,0.8581212841854935,-1
3313,3314,Hoodi,168500,22750,145750,0.8649851632047477,-1
3314,3315,Vasanth Nagar,257600,10100,247500,0.9607919254658385,-1
3315,3316,Shivajinagar,239600,27610,211990,0.8847662771285476,0
3316,3317,Marathahalli,176250,136120,40130,0.22768794326241135,1
3317,3318,Kammanahalli,415100,25550,389550,0.9384485666104553,-1
3318,3319,Vasanth Nagar,45600,71520,-25920,-0.5684210526315789,1
3319,3320,Rajajinagar,349750,23340,326410,0.9332666190135811,-1
3320,3321,Marathahalli,122100,48410,73690,0.6035217035217035,0
3321,3322,Hebbal,256500,94980,161520,0.6297076023391813,0
3322,3323,Horamavu,219250,67570,151680,0.6918129988597491,0
3323,3324,Shivajinagar,145000,145550,-550,-0.003793103448275862,1
3324,3325,Varthur,49750,48740,1010,0.020301507537688442,1
3325,3326,Varthur,327500,50580,276920,0.8455572519083969,-1
3326,3327,Kammanahalli,387000,12310,374690,0.9681912144702842,-1
3327,3328,Mahadevapura,215450,106650,108800,0.5049895567417034,1
3328,3329,Shivajinagar,121000,103360,17640,0.14578512396694215,1
3329,3330,CV Raman Nagar,350000,20390,329610,0.9417428571428571,-1
3330,3331,Kalyan Nagar,138000,103290,34710,0.2515217391304348,1
3331,3332,HBR Layout,222250,51780,170470,0.7670191226096738,0
3332,3333,Hoodi,186500,126570,59930,0.32134048257372655,1
3333,3334,CV Raman Nagar,150550,31230,119320,0.7925606110926603,0
3334,3335,HBR Layout,223050,94520,128530,0.5762385115444968,0
3335,3336,Kammanahalli,337650,20670,316980,0.9387827632163482,-1
3336,3337,CV Raman Nagar,443250,148290,294960,0.6654483925549916,0
3337,3338,Jalahalli,384300,47520,336780,0.8763466042154566,-1
3338,3339,CV Raman Nagar,290600,90720,199880,0.6878183069511355,0
3339,3340,Horamavu,325100,33540,291560,0.896831744078745,-1
3340,3341,Varthur,164000,71360,92640,0.5648780487804878,0
3341,3342,Mahadevapura,264300,0,264300,1.0,-1
3342,3343,Marathahalli,33400,93990,-60590,-1.8140718562874252,1
3343,3344,CV Raman Nagar,302050,24480,277570,0.9189538155934448,-1
3344,3345,Hoodi,395400,43510,351890,0.8899595346484572,-1
3345,3346,Malleswaram,411400,77930,333470,0.8105736509479825,-1
3346,3347,Hebbal,402650,100360,302290,0.7507512728175835,-1
3347,3348,Marathahalli,424900,46320,378580,0.8909861143798541,0
3348,3349,Malleswaram,27950,107560,-79610,-2.8483005366726295,1
3349,3350,Indiranagar,200150,14820,185330,0.9259555333499875,-1
3350,3351,Krishnarajapuram,46650,75270,-28620,-0.6135048231511254,1
3351,3352,Jalahalli,370300,14840,355460,0.9599243856332703,-1
3352,3353,Mahadevapura,364950,56060,308890,0.8463899164269078,0
3353,3354,Shivajinagar,395500,48550,346950,0.87724399494311,-1
3354,3355,Whitefield,179900,119530,60370,0.3355753196220122,1
3355,3356,Kammanahalli,303650,175120,128530,0.42328338547670014,1
3356,3357,CV Raman Nagar,95200,44470,50730,0.5328781512605042,1
3357,3358,Marathahalli,231300,72210,159090,0.6878080415045396,0
3358,3359,Horamavu,95050,70200,24850,0.2614413466596528,1
3359,3360,Rajajinagar,105100,40120,64980,0.6182683158896289,0
3360,3361,Indiranagar,190150,48910,141240,0.7427820141993163,-1
3361,3362,CV Raman Nagar,117550,92120,25430,0.2163334751169715,1
3362,3363,Hoodi,428000,40440,387560,0.9055140186915888,-1
3363,3364,Vasanth Nagar,201250,76850,124400,0.6181366459627329,0
3364,3365,Vasanth Nagar,443850,20700,423150,0.953362622507604,-1
3365,3366,Kalyan Nagar,90750,53490,37260,0.41057851239669424,1
3366,3367,Kammanahalli,264750,31480,233270,0.88109537299339,-1
3367,3368,Krishnarajapuram,250050,76590,173460,0.6937012597480504,0
3368,3369,Indiranagar,388300,57820,330480,0.8510945145506053,0
3369,3370,Marathahalli,410050,79270,330780,0.8066821119375686,0
3370,3371,Vasanth Nagar,101950,48170,53780,0.527513487003433,1
3371,3372,Horamavu,367400,19950,347450,0.9456995100707676,-1
3372,3373,Indiranagar,351250,23700,327550,0.9325266903914591,-1
3373,3374,Krishnarajapuram,340900,59690,281210,0.8249046641243767,-1
3374,3375,Rajajinagar,327100,29610,297490,0.9094772240904923,-1
3375,3376,CV Raman Nagar,159800,36930,122870,0.7688986232790989,0
3376,3377,Varthur,67750,94770,-27020,-0.39881918819188195,1
3377,3378,Marathahalli,37450,73390,-35940,-0.9596795727636849,1
3378,3379,HBR Layout,216050,83400,132650,0.6139782457764407,0
3379,3380,Hebbal,93450,23310,70140,0.750561797752809,-1
3380,3381,Indiranagar,358250,36250,322000,0.8988136775994418,-1
3381,3382,Horamavu,223600,29070,194530,0.8699910554561717,-1
3382,3383,CV Raman Nagar,276700,33440,243260,0.8791470907119624,-1
3383,3384,Mahadevapura,164250,101650,62600,0.3811263318112633,1
3384,3385,Hoodi,175100,76770,98330,0.5615648201027984,0
3385,3386,Malleswaram,150600,51110,99490,0.6606241699867198,0
3386,3387,CV Raman Nagar,378800,79580,299220,0.7899155227032735,0
3387,3388,Shivajinagar,139550,59690,79860,0.5722680042995342,1
3388,3389,Kammanahalli,250450,79100,171350,0.6841684967059293,0
3389,3390,Mahadevapura,275150,91770,183380,0.6664728330001817,0
3390,3391,HBR Layout,419350,79750,339600,0.8098247287468702,0
3391,3392,Malleswaram,44500,63880,-19380,-0.43550561797752807,1
3392,3393,Kammanahalli,337800,80710,257090,0.7610716400236827,-1
3393,3394,Krishnarajapuram,330800,19930,310870,0.9397521160822249,-1
3394,3395,Banaswadi,62100,116250,-54150,-0.8719806763285024,1
3395,3396,Krishnarajapuram,115150,53460,61690,0.5357359965262701,0
3396,3397,Krishnarajapuram,168350,111050,57300,0.34036234036234037,1
3397,3398,Mahadevapura,40650,48330,-7680,-0.18892988929889298,1
3398,3399,Hoodi,134500,66490,68010,0.5056505576208179,0
3399,3400,Mahadevapura,259350,79080,180270,0.6950838635049161,0
3400,3401,Jalahalli,420100,15120,404980,0.9640085693882409,-1
3401,3402,Malleswaram,303750,74880,228870,0.7534814814814815,-1
3402,3403,Hoodi,355050,78480,276570,0.7789607097591889,-1
3403,3404,Hoodi,419150,66240,352910,0.8419658833353215,0
3404,3405,Krishnarajapuram,238350,63480,174870,0.7336689741976086,0
3405,3406,Kalyan Nagar,238450,53060,185390,0.777479555462361,-1
3406,3407,Whitefield,216450,85880,130570,0.6032340032340032,0
3407,3408,Krishnarajapuram,210800,17930,192870,0.914943074003795,-1
3408,3409,Kalyan Nagar,441400,35090,406310,0.920502945174445,-1
3409,3410,Vasanth Nagar,214100,112890,101210,0.4727230266230733,0
3410,3411,Whitefield,332600,100060,232540,0.699158147925436,0
3411,3412,CV Raman Nagar,184200,56750,127450,0.6919109663409337,0
3412,3413,Krishnarajapuram,426950,54170,372780,0.8731233165476051,-1
3413,3414,Kammanahalli,398900,34930,363970,0.9124341940335924,-1
3414,3415,Shivajinagar,443700,58040,385660,0.869190894748704,-1
3415,3416,Krishnarajapuram,223750,44500,179250,0.8011173184357542,-1
3416,3417,Indiranagar,386550,1650,384900,0.9957314707023671,-1
3417,3418,Kalyan Nagar,68250,66630,1620,0.023736263736263738,1
3418,3419,Indiranagar,258400,66360,192040,0.743188854489164,0
3419,3420,Hoodi,139250,86000,53250,0.38240574506283664,1
3420,3421,Whitefield,216800,16780,200020,0.9226014760147602,-1
3421,3422,CV Raman Nagar,326500,47500,279000,0.8545176110260337,0
3422,3423,Whitefield,173300,26200,147100,0.8488170802077323,0
3423,3424,CV Raman Nagar,147950,47580,100370,0.6784048665089557,0
3424,3425,Banaswadi,127650,95600,32050,0.2510771641206424,1
3425,3426,Shivajinagar,111900,45120,66780,0.5967828418230563,0
3426,3427,Varthur,68950,18940,50010,0.7253081943437273,0
3427,3428,Mahadevapura,218250,57060,161190,0.7385567010309279,-1
3428,3429,Krishnarajapuram,116850,85950,30900,0.2644415917843389,1
3429,3430,Varthur,82050,61450,20600,0.251066422912858,1
3430,3431,Varthur,281800,32850,248950,0.8834279630943932,0
3431,3432,Vasanth Nagar,89150,85130,4020,0.045092540661805944,1
3432,3433,Hoodi,356650,70380,286270,0.8026636758727044,-1
3433,3434,Shivajinagar,368500,39770,328730,0.8920759837177747,0
3434,3435,CV Raman Nagar,58050,37890,20160,0.34728682170542635,1
3435,3436,Whitefield,252550,66970,185580,0.7348247871708573,0
3436,3437,Hebbal,289150,57790,231360,0.8001383365035448,-1
3437,3438,Varthur,46850,60540,-13690,-0.2922091782283885,1
3438,3439,Vasanth Nagar,54250,75780,-21530,-0.3968663594470046,1
3439,3440,Horamavu,25000,85660,-60660,-2.4264,1
3440,3441,Horamavu,358100,89610,268490,0.7497626361351578,0
3441,3442,Krishnarajapuram,108950,59160,49790,0.4569986232216613,1
3442,3443,Jalahalli,76250,37220,39030,0.5118688524590164,0
3443,3444,Jalahalli,268150,63070,205080,0.764795823233265,-1
3444,3445,Malleswaram,207600,81290,126310,0.6084296724470135,0
3445,3446,Horamavu,85800,12950,72850,0.8490675990675991,-1
3446,3447,Krishnarajapuram,159250,75830,83420,0.5238304552590267,1
3447,3448,Marathahalli,120050,71410,48640,0.405164514785506,1
3448,3449,CV Raman Nagar,336300,59760,276540,0.8223015165031222,-1
3449,3450,Krishnarajapuram,70300,0,70300,1.0,-1
3450,3451,Marathahalli,143750,20970,122780,0.8541217391304348,0
3451,3452,Marathahalli,208950,44950,164000,0.7848767647762622,0
3452,3453,Whitefield,206500,91180,115320,0.558450363196126,0
3453,3454,Malleswaram,169500,78340,91160,0.5378171091445427,0
3454,3455,Jalahalli,234750,97280,137470,0.585601703940362,1
3455,3456,Banaswadi,66900,106300,-39400,-0.5889387144992526,1
3456,3457,Hoodi,279150,18700,260450,0.9330109260254343,-1
3457,3458,Banaswadi,297600,91580,206020,0.6922715053763441,0
3458,3459,Whitefield,188750,51210,137540,0.7286887417218543,0
3459,3460,Hebbal,69050,49590,19460,0.2818247646632875,1
3460,3461,Malleswaram,274050,38790,235260,0.858456486042693,0
3461,3462,Varthur,281500,28550,252950,0.8985790408525755,-1
3462,3463,Vasanth Nagar,231150,22990,208160,0.900540774388925,-1
3463,3464,Vasanth Nagar,322150,35830,286320,0.8887785193232967,-1
3464,3465,Hoodi,190100,41250,148850,0.783008942661757,-1
3465,3466,Rajajinagar,211850,10750,201100,0.9492565494453623,-1
3466,3467,Marathahalli,271250,70460,200790,0.7402396313364056,0
3467,3468,Varthur,338450,124050,214400,0.6334761412320875,0
3468,3469,CV Raman Nagar,239500,78090,161410,0.6739457202505219,0
3469,3470,Krishnarajapuram,280200,60510,219690,0.7840471092077088,0
3470,3471,Marathahalli,288900,96410,192490,0.6662859120803046,0
3471,3472,Hoodi,90700,31510,59190,0.6525909592061742,0
3472,3473,Shivajinagar,208750,26760,181990,0.8718083832335329,-1
3473,3474,Whitefield,324250,43110,281140,0.867047031611411,-1
3474,3475,HBR Layout,30150,80510,-50360,-1.6703150912106135,1
3475,3476,HBR Layout,35500,50310,-14810,-0.4171830985915493,1
3476,3477,Kalyan Nagar,378500,59800,318700,0.842007926023778,-1
3477,3478,Banaswadi,209750,40260,169490,0.808057210965435,-1
3478,3479,Horamavu,47900,33220,14680,0.30647181628392484,1
3479,3480,Vasanth Nagar,165150,79020,86130,0.5215258855585831,0
3480,3481,Kalyan Nagar,264000,50280,213720,0.8095454545454546,-1
3481,3482,Varthur,430150,80590,349560,0.8126467511333256,0
3482,3483,Shivajinagar,247400,61400,186000,0.751818916734034,0
3483,3484,Indiranagar,128700,41070,87630,0.6808857808857809,0
3484,3485,Shivajinagar,320000,122550,197450,0.61703125,0
3485,3486,Banaswadi,73800,89890,-16090,-0.21802168021680216,1
3486,3487,Krishnarajapuram,59900,57090,2810,0.04691151919866444,1
3487,3488,HBR Layout,337100,31770,305330,0.9057549688519727,-1
3488,3489,Kammanahalli,95650,122300,-26650,-0.2786199686356508,1
3489,3490,Marathahalli,355200,67640,287560,0.809572072072072,-1
3490,3491,Hoodi,405600,17970,387630,0.9556952662721894,-1
3491,3492,Shivajinagar,77450,194180,-116730,-1.507165913492576,1
3492,3493,Hoodi,249700,70130,179570,0.719142971565879,0
3493,3494,Mahadevapura,117250,51780,65470,0.5583795309168443,1
3494,3495,Marathahalli,127250,45950,81300,0.6388998035363458,0
3495,3496,Shivajinagar,126950,64150,62800,0.49468294604174873,1
3496,3497,Vasanth Nagar,429950,42220,387730,0.9018025351785092,-1
3497,3498,Hebbal,88700,100310,-11610,-0.13089064261555805,1
3498,3499,Kalyan Nagar,326800,69730,257070,0.7866279069767442,0
3499,3500,Indiranagar,31500,47610,-16110,-0.5114285714285715,1
3500,3501,Vasanth Nagar,290650,96710,193940,0.6672630311371065,0
3501,3502,Vasanth Nagar,105600,44270,61330,0.5807765151515152,1
3502,3503,Varthur,113450,65740,47710,0.420537681798149,1
3503,3504,Jalahalli,98600,26140,72460,0.7348884381338743,0
3504,3505,Horamavu,116000,14660,101340,0.8736206896551724,-1
3505,3506,Shivajinagar,214750,60780,153970,0.7169732246798604,0
3506,3507,Indiranagar,102700,22130,80570,0.7845180136319376,-1
3507,3508,Jalahalli,362850,46940,315910,0.8706352487253686,-1
3508,3509,Whitefield,38900,44200,-5300,-0.13624678663239073,1
3509,3510,Marathahalli,390750,23160,367590,0.9407293666026871,-1
3510,3511,Hebbal,280250,105770,174480,0.6225869759143622,0
3511,3512,Krishnarajapuram,165150,66690,98460,0.5961852861035423,0
3512,3513,Whitefield,94450,54460,39990,0.42339862361037583,0
3513,3514,Krishnarajapuram,106350,18800,87550,0.8232251998119418,0
3514,3515,Hebbal,439950,26300,413650,0.9402204795999546,-1
3515,3516,Rajajinagar,272300,53270,219030,0.8043701799485862,-1
3516,3517,Marathahalli,105650,127030,-21380,-0.2023663038334122,1
3517,3518,Shivajinagar,222150,46060,176090,0.7926626153499887,-1
3518,3519,Indiranagar,421700,40210,381490,0.9046478539245909,-1
3519,3520,Hoodi,151450,126700,24750,0.16342027071640805,1
3520,3521,Mahadevapura,400650,12410,388240,0.9690253338325222,-1
3521,3522,Hoodi,113800,38560,75240,0.6611599297012303,0
3522,3523,Hebbal,419300,44390,374910,0.8941330789410923,-1
3523,3524,Jalahalli,38250,60210,-21960,-0.5741176470588235,1
3524,3525,Jalahalli,431100,56200,374900,0.8696358153560659,-1
3525,3526,Indiranagar,93250,143910,-50660,-0.5432707774798927,1
3526,3527,Malleswaram,412850,74990,337860,0.8183601792418554,-1
3527,3528,Varthur,233500,116070,117430,0.5029122055674519,1
3528,3529,Jalahalli,112350,115330,-2980,-0.02652425456163774,1
3529,3530,Indiranagar,165550,70300,95250,0.5753548776804591,0
3530,3531,Shivajinagar,131900,44430,87470,0.6631539044730856,0
3531,3532,Krishnarajapuram,248500,43590,204910,0.8245875251509054,0
3532,3533,Shivajinagar,285050,27840,257210,0.9023329240484126,-1
3533,3534,Marathahalli,258150,37770,220380,0.8536897152818129,-1
3534,3535,CV Raman Nagar,200450,16120,184330,0.9195809428785233,-1
3535,3536,Whitefield,28850,65890,-37040,-1.2838821490467938,1
3536,3537,Mahadevapura,301000,79490,221510,0.7359136212624585,-1
3537,3538,HBR Layout,402000,78850,323150,0.8038557213930348,-1
3538,3539,Shivajinagar,32600,21890,10710,0.3285276073619632,1
3539,3540,CV Raman Nagar,185250,45280,139970,0.7555735492577598,-1
3540,3541,CV Raman Nagar,48500,87960,-39460,-0.8136082474226805,1
3541,3542,Whitefield,379300,45760,333540,0.8793567097284472,-1
3542,3543,Vasanth Nagar,28650,101800,-73150,-2.5532286212914483,1
3543,3544,Shivajinagar,367850,28470,339380,0.9226043224140275,-1
3544,3545,Marathahalli,392650,96610,296040,0.7539539029670189,0
3545,3546,Whitefield,217400,38540,178860,0.822723091076357,-1
3546,3547,Kammanahalli,289250,62910,226340,0.7825064822817632,-1
3547,3548,Varthur,197350,11570,185780,0.9413731948315176,-1
3548,3549,Vasanth Nagar,280050,21000,259050,0.9250133904659882,-1
3549,3550,Kalyan Nagar,285700,55400,230300,0.8060903045152258,0
3550,3551,Varthur,140450,36170,104280,0.7424706301174795,-1
3551,3552,Indiranagar,225250,99390,125860,0.5587569367369589,0
3552,3553,Hoodi,209350,70070,139280,0.6652973489371865,0
3553,3554,Marathahalli,331100,157720,173380,0.5236484445786771,1
3554,3555,Hoodi,240350,16380,223970,0.9318493863116288,-1
3555,3556,Kammanahalli,96100,28410,67690,0.7043704474505723,0
3556,3557,Marathahalli,148900,13790,135110,0.9073875083948959,-1
3557,3558,Whitefield,390300,5800,384500,0.9851396361772995,-1
3558,3559,Indiranagar,439550,47000,392550,0.8930724604709361,-1
3559,3560,Whitefield,77650,34460,43190,0.5562137797810689,0
3560,3561,Mahadevapura,71150,30830,40320,0.5666900913562896,0
3561,3562,Horamavu,260750,80970,179780,0.6894726749760307,0
3562,3563,Mahadevapura,444050,80940,363110,0.8177232293660623,0
3563,3564,Whitefield,112250,32160,80090,0.7134966592427617,-1
3564,3565,Rajajinagar,239650,120060,119590,0.49901940329647404,1
3565,3566,Rajajinagar,132300,45650,86650,0.6549508692365835,0
3566,3567,Jalahalli,413500,92580,320920,0.7761064087061669,-1
3567,3568,Horamavu,80600,46590,34010,0.42196029776674937,0
3568,3569,Hebbal,197850,56130,141720,0.7163002274450341,0
3569,3570,HBR Layout,161800,22940,138860,0.8582200247218789,-1
3570,3571,CV Raman Nagar,267550,87760,179790,0.6719865445711082,0
3571,3572,Krishnarajapuram,252000,121440,130560,0.518095238095238,0
3572,3573,Vasanth Nagar,280100,70940,209160,0.7467333095323099,0
3573,3574,Banaswadi,290800,98690,192110,0.6606258596973865,0
3574,3575,Kammanahalli,201300,35400,165900,0.8241430700447094,-1
3575,3576,CV Raman Nagar,113500,53830,59670,0.525726872246696,0
3576,3577,Krishnarajapuram,261450,50080,211370,0.8084528590552686,0
3577,3578,Hoodi,434150,22480,411670,0.948220661061845,-1
3578,3579,Kammanahalli,124000,38830,85170,0.6868548387096775,0
3579,3580,Krishnarajapuram,41950,84580,-42630,-1.0162097735399285,1
3580,3581,Horamavu,328600,79590,249010,0.7577906269020085,0
3581,3582,Varthur,72750,40050,32700,0.44948453608247424,0
3582,3583,Krishnarajapuram,140000,59280,80720,0.5765714285714286,0
3583,3584,Kammanahalli,96850,78300,18550,0.19153329891584925,1
3584,3585,Jalahalli,391500,70880,320620,0.8189527458492976,0
3585,3586,Jalahalli,75000,75560,-560,-0.007466666666666667,1
3586,3587,Hoodi,186050,61880,124170,0.6674012362268208,0
3587,3588,Mahadevapura,381550,95850,285700,0.7487878390774473,0
3588,3589,Hoodi,272350,75630,196720,0.7223058564347347,-1
3589,3590,CV Raman Nagar,128700,112200,16500,0.1282051282051282,1
3590,3591,Kalyan Nagar,151250,116210,35040,0.2316694214876033,1
3591,3592,Marathahalli,143950,30100,113850,0.7908996179228899,0
3592,3593,Jalahalli,90400,53320,37080,0.4101769911504425,0
3593,3594,Jalahalli,199000,116720,82280,0.41346733668341706,1
3594,3595,Rajajinagar,235600,64770,170830,0.7250848896434635,0
3595,3596,Vasanth Nagar,153250,118260,34990,0.22831973898858074,1
3596,3597,Hebbal,314800,95670,219130,0.6960927573062262,0
3597,3598,Whitefield,85800,89200,-3400,-0.039627039627039624,1
3598,3599,Shivajinagar,186750,104550,82200,0.44016064257028115,0
3599,3600,CV Raman Nagar,347450,79680,267770,0.7706720391423226,0
3600,3601,HBR Layout,447750,51760,395990,0.8843997766610832,0
3601,3602,Kalyan Nagar,33350,56510,-23160,-0.6944527736131934,1
3602,3603,Malleswaram,93250,30160,63090,0.67656836461126,0
3603,3604,HBR Layout,55300,5670,49630,0.8974683544303798,-1
3604,3605,CV Raman Nagar,228250,66280,161970,0.7096166484118291,-1
3605,3606,Hoodi,176800,99950,76850,0.4346719457013575,0
3606,3607,Krishnarajapuram,313050,125570,187480,0.5988819677367833,0
3607,3608,Kammanahalli,275900,30060,245840,0.8910474809713664,-1
3608,3609,HBR Layout,216250,32080,184170,0.8516531791907515,-1
3609,3610,Jalahalli,398600,18020,380580,0.9547917711991972,-1
3610,3611,Malleswaram,119700,58250,61450,0.5133667502088555,1
3611,3612,HBR Layout,399350,33380,365970,0.9164141730311757,-1
3612,3613,Whitefield,307700,86580,221120,0.7186220344491387,0
3613,3614,Malleswaram,107850,64210,43640,0.40463606861381546,1
3614,3615,Horamavu,237300,90160,147140,0.6200589970501474,0
3615,3616,Horamavu,130250,66660,63590,0.48821497120921303,0
3616,3617,Rajajinagar,165200,27310,137890,0.834685230024213,-1
3617,3618,Kammanahalli,168250,71180,97070,0.5769390787518573,0
3618,3619,Shivajinagar,359550,16750,342800,0.9534139897093589,-1
3619,3620,Mahadevapura,102000,33600,68400,0.6705882352941176,0
3620,3621,Rajajinagar,146150,107140,39010,0.2669175504618543,1
3621,3622,Vasanth Nagar,191550,40120,151430,0.7905507700339337,0
3622,3623,Jalahalli,182000,85210,96790,0.5318131868131868,1
3623,3624,Banaswadi,234800,28940,205860,0.8767461669505963,0
3624,3625,Kalyan Nagar,130150,51960,78190,0.6007683442182098,0
3625,3626,Banaswadi,213450,112310,101140,0.4738346216912626,1
3626,3627,Vasanth Nagar,412700,60360,352340,0.8537436394475406,-1
3627,3628,Jalahalli,154050,25220,128830,0.8362869198312236,0
3628,3629,Marathahalli,183200,40450,142750,0.7792030567685589,-1
3629,3630,Kammanahalli,429150,85730,343420,0.80023301875801,0
3630,3631,Kalyan Nagar,220150,115730,104420,0.4743129684306155,1
3631,3632,Varthur,298200,41100,257100,0.8621730382293763,-1
3632,3633,Banaswadi,381800,76280,305520,0.8002095337873232,-1
3633,3634,Indiranagar,191150,35190,155960,0.8159037405179179,-1
3634,3635,Rajajinagar,387400,125090,262310,0.677103768714507,0
3635,3636,Hoodi,282600,111250,171350,0.6063340410474168,0
3636,3637,Kammanahalli,294000,79500,214500,0.7295918367346939,-1
3637,3638,Vasanth Nagar,161200,49360,111840,0.6937965260545905,0
3638,3639,Marathahalli,159150,83170,75980,0.4774112472510211,0
3639,3640,Kammanahalli,400850,71560,329290,0.8214793563677186,-1
3640,3641,CV Raman Nagar,193250,76610,116640,0.6035705045278137,0
3641,3642,Horamavu,407050,77360,329690,0.809949637636654,0
3642,3643,Vasanth Nagar,110650,47280,63370,0.572706732941708,0
3643,3644,Mahadevapura,257400,58200,199200,0.7738927738927739,0
3644,3645,Mahadevapura,275750,58180,217570,0.789011786038078,0
3645,3646,Hebbal,255150,74650,180500,0.7074270037233,-1
3646,3647,Mahadevapura,71050,34480,36570,0.5147079521463758,1
3647,3648,Kammanahalli,434200,182650,251550,0.5793413173652695,0
3648,3649,Hebbal,278150,96780,181370,0.6520582419557792,0
3649,3650,Krishnarajapuram,115400,39620,75780,0.6566724436741768,0
3650,3651,Vasanth Nagar,336300,47050,289250,0.86009515313708,0
3651,3652,Varthur,292650,19580,273070,0.9330941397573894,-1
3652,3653,CV Raman Nagar,427450,52470,374980,0.8772488010293602,-1
3653,3654,Jalahalli,83750,72340,11410,0.13623880597014926,1
3654,3655,Hebbal,315900,59040,256860,0.8131054131054131,0
3655,3656,Vasanth Nagar,202800,40700,162100,0.7993096646942801,0
3656,3657,Kammanahalli,398800,52280,346520,0.8689067201604814,0
3657,3658,Shivajinagar,321900,49620,272280,0.8458527493010252,-1
3658,3659,HBR Layout,384500,58810,325690,0.8470481144343303,-1
3659,3660,Vasanth Nagar,238600,26190,212410,0.8902347024308466,0
3660,3661,Varthur,341150,44040,297110,0.8709072255606038,0
3661,3662,Varthur,362300,64780,297520,0.8211979022909192,0
3662,3663,Jalahalli,335400,82290,253110,0.7546511627906977,0
3663,3664,Hoodi,396300,78450,317850,0.8020439061317184,0
3664,3665,Banaswadi,377950,37330,340620,0.901230321471094,-1
3665,3666,Kammanahalli,449850,41240,408610,0.908324997221296,-1
3666,3667,Horamavu,386650,27570,359080,0.9286952023794129,-1
3667,3668,Marathahalli,407900,50330,357570,0.8766119146849718,-1
3668,3669,Horamavu,139800,58280,81520,0.5831187410586552,0
3669,3670,Hebbal,156600,102670,53930,0.34438058748403577,1
3670,3671,Indiranagar,150950,15940,135010,0.894402119907254,0
3671,3672,Whitefield,198700,151610,47090,0.236990437845999,1
3672,3673,Malleswaram,58650,66270,-7620,-0.129923273657289,1
3673,3674,Hoodi,299900,65890,234010,0.7802934311437145,0
3674,3675,Banaswadi,176150,53900,122250,0.6940107862617088,0
3675,3676,Krishnarajapuram,98350,32170,66180,0.6729028978139299,0
3676,3677,Varthur,158000,53240,104760,0.6630379746835443,0
3677,3678,Mahadevapura,288750,63470,225280,0.7801904761904762,0
3678,3679,Krishnarajapuram,373750,43620,330130,0.8832909698996656,-1
3679,3680,Whitefield,90500,55690,34810,0.3846408839779005,1
3680,3681,Kammanahalli,287200,110620,176580,0.6148328690807799,0
3681,3682,Hoodi,113900,25600,88300,0.7752414398595259,0
3682,3683,Kalyan Nagar,236500,50880,185620,0.784862579281184,0
3683,3684,Shivajinagar,192350,38400,153950,0.8003639199376137,-1
3684,3685,Malleswaram,412800,24350,388450,0.9410125968992248,-1
3685,3686,Rajajinagar,419150,56600,362550,0.8649648097339855,0
3686,3687,Krishnarajapuram,416100,37010,379090,0.9110550348473925,-1
3687,3688,Mahadevapura,227550,113070,114480,0.5030982201713909,0
3688,3689,Banaswadi,65750,130830,-65080,-0.9898098859315589,1
3689,3690,Hoodi,196950,71090,125860,0.6390454430058391,0
3690,3691,Mahadevapura,341750,60220,281530,0.8237893196781273,0
3691,3692,CV Raman Nagar,428700,27760,400940,0.935246092838815,-1
3692,3693,Rajajinagar,37200,73220,-36020,-0.9682795698924731,1
3693,3694,Jalahalli,399850,31050,368800,0.9223458797048893,-1
3694,3695,Rajajinagar,299550,98970,200580,0.6696044066099148,0
3695,3696,Horamavu,118300,52600,65700,0.555367709213863,0
3696,3697,Whitefield,29300,46350,-17050,-0.5819112627986348,1
3697,3698,Malleswaram,278350,48330,230020,0.8263696784623675,-1
3698,3699,Kammanahalli,427800,45260,382540,0.8942028985507247,-1
3699,3700,Whitefield,293700,21330,272370,0.9273748723186925,-1
3700,3701,Malleswaram,111900,64410,47490,0.4243967828418231,1
3701,3702,Malleswaram,300650,36790,263860,0.8776317977714951,-1
3702,3703,Kammanahalli,65600,8400,57200,0.8719512195121951,-1
3703,3704,Banaswadi,338750,71220,267530,0.7897564575645757,0
3704,3705,Shivajinagar,173400,99980,73420,0.42341407151095733,1
3705,3706,Hebbal,43500,57820,-14320,-0.3291954022988506,1
3706,3707,Rajajinagar,194750,0,194750,1.0,-1
3707,3708,Whitefield,162700,101730,60970,0.37473878303626307,1
3708,3709,CV Raman Nagar,367450,30860,336590,0.9160157844604708,-1
3709,3710,Hebbal,437600,31630,405970,0.927719378427788,-1
3710,3711,Rajajinagar,153100,61010,92090,0.6015022860875245,0
3711,3712,Hebbal,267450,80550,186900,0.6988222097588335,0
3712,3713,Rajajinagar,288150,43590,244560,0.8487246225923998,-1
3713,3714,Horamavu,321100,80000,241100,0.7508564310183743,-1
3714,3715,Jalahalli,29650,21940,7710,0.26003372681281617,1
3715,3716,Rajajinagar,170350,121410,48940,0.28729087173466394,1
3716,3717,Rajajinagar,52850,44170,8680,0.16423841059602648,1
3717,3718,Krishnarajapuram,189400,15220,174180,0.9196409714889123,-1
3718,3719,Varthur,62100,65120,-3020,-0.04863123993558776,1
3719,3720,Shivajinagar,379200,104220,274980,0.7251582278481012,0
3720,3721,Vasanth Nagar,80850,23960,56890,0.7036487322201608,0
3721,3722,Malleswaram,387850,94880,292970,0.7553693438184865,0
3722,3723,Hoodi,417700,58920,358780,0.858941824275796,-1
3723,3724,Marathahalli,176250,89490,86760,0.49225531914893617,1
3724,3725,Rajajinagar,51400,51600,-200,-0.0038910505836575876,1
3725,3726,Varthur,122650,33160,89490,0.7296371789645332,0
3726,3727,Horamavu,112500,55230,57270,0.5090666666666667,0
3727,3728,Hebbal,158200,50240,107960,0.6824273072060683,0
3728,3729,Malleswaram,326500,81600,244900,0.7500765696784073,0
3729,3730,Mahadevapura,408150,69360,338790,0.8300624770305035,-1
3730,3731,CV Raman Nagar,371650,97650,274000,0.7372527916050047,0
3731,3732,CV Raman Nagar,338350,111600,226750,0.670164031328506,0
3732,3733,Whitefield,344400,105500,238900,0.6936701509872242,0
3733,3734,Marathahalli,109650,84440,25210,0.22991336069311447,1
3734,3735,Kalyan Nagar,84150,70230,13920,0.16541889483065952,1
3735,3736,Jalahalli,407000,84750,322250,0.7917690417690417,0
3736,3737,Varthur,197150,113930,83220,0.4221151407557697,1
3737,3738,Kammanahalli,32650,67700,-35050,-1.0735068912710566,1
3738,3739,HBR Layout,392500,83750,308750,0.7866242038216561,-1
3739,3740,Vasanth Nagar,94500,61810,32690,0.3459259259259259,1
3740,3741,Jalahalli,356550,88890,267660,0.750694152292806,-1
3741,3742,Mahadevapura,299900,70910,228990,0.7635545181727242,0
3742,3743,Shivajinagar,76150,39320,36830,0.48365068942875905,1
3743,3744,Whitefield,214200,104110,110090,0.5139589169000933,0
3744,3745,Shivajinagar,341800,54850,286950,0.8395260386190755,-1
3745,3746,Marathahalli,417450,94340,323110,0.7740088633369265,-1
3746,3747,Varthur,51200,63260,-12060,-0.235546875,1
3747,3748,Whitefield,299400,55080,244320,0.8160320641282565,-1
3748,3749,Rajajinagar,402400,14360,388040,0.9643141153081511,-1
3749,3750,Hebbal,284700,42640,242060,0.8502283105022831,-1
3750,3751,Horamavu,199750,68100,131650,0.6590738423028786,0
3751,3752,Indiranagar,281100,67950,213150,0.7582710779082177,0
3752,3753,Vasanth Nagar,426450,153300,273150,0.6405205768554344,0
3753,3754,Hebbal,421050,59830,361220,0.8579028618928868,-1
3754,3755,Varthur,75750,17190,58560,0.7730693069306931,0
3755,3756,Krishnarajapuram,276150,107890,168260,0.609306536302734,0
3756,3757,Vasanth Nagar,244350,77900,166450,0.681195007161858,0
3757,3758,Shivajinagar,415300,53940,361360,0.8701179869973513,-1
3758,3759,Hoodi,125150,48060,77090,0.6159808230123851,0
3759,3760,Hebbal,291900,12150,279750,0.9583761562178829,-1
3760,3761,Horamavu,419250,118570,300680,0.717185450208706,0
3761,3762,Shivajinagar,196350,80780,115570,0.5885918003565063,1
3762,3763,Rajajinagar,253950,4290,249660,0.9831069108092144,-1
3763,3764,Kalyan Nagar,402600,45200,357400,0.8877297565822156,-1
3764,3765,Kammanahalli,34350,91560,-57210,-1.6655021834061134,1
3765,3766,Hoodi,120250,78140,42110,0.3501871101871102,1
3766,3767,Krishnarajapuram,101600,59260,42340,0.4167322834645669,0
3767,3768,Varthur,57200,61380,-4180,-0.07307692307692308,1
3768,3769,Krishnarajapuram,39400,55060,-15660,-0.39746192893401017,1
3769,3770,Mahadevapura,72850,32600,40250,0.5525051475634866,0
3770,3771,Hoodi,223850,32170,191680,0.856287692651329,-1
3771,3772,Hoodi,124850,42160,82690,0.66231477773328,0
3772,3773,Kammanahalli,38550,89050,-50500,-1.3099870298313878,1
3773,3774,Kammanahalli,410250,76560,333690,0.813382084095064,-1
3774,3775,Kammanahalli,411950,36100,375850,0.9123680058259498,-1
3775,3776,Mahadevapura,374400,23540,350860,0.9371260683760684,-1
3776,3777,Hoodi,412450,56390,356060,0.8632803976239544,-1
3777,3778,Jalahalli,447150,90220,356930,0.7982332550598233,0
3778,3779,Varthur,339350,101160,238190,0.7019006925003684,-1
3779,3780,Hoodi,261250,53050,208200,0.7969377990430622,-1
3780,3781,Horamavu,255350,9090,246260,0.9644018014489916,-1
3781,3782,Mahadevapura,50500,151460,-100960,-1.9992079207920792,1
3782,3783,Kammanahalli,183200,61850,121350,0.6623908296943232,0
3783,3784,Kalyan Nagar,336900,81520,255380,0.758029088750371,0
3784,3785,Marathahalli,220900,100210,120690,0.5463558171118154,0
3785,3786,Marathahalli,305000,63170,241830,0.7928852459016393,0
3786,3787,Whitefield,413350,57890,355460,0.8599491955969517,-1
3787,3788,Rajajinagar,63950,131380,-67430,-1.0544175136825644,1
3788,3789,Kammanahalli,124450,122910,1540,0.012374447569304942,1
3789,3790,Banaswadi,403250,60670,342580,0.8495474271543707,-1
3790,3791,Indiranagar,331700,163650,168050,0.5066324992463069,0
3791,3792,Marathahalli,94600,102360,-7760,-0.08202959830866807,1
3792,3793,CV Raman Nagar,282550,99740,182810,0.6470005308794904,0
3793,3794,HBR Layout,416650,64320,352330,0.8456258250330013,-1
3794,3795,Marathahalli,438850,83410,355440,0.8099350575367438,-1
3795,3796,Indiranagar,99750,62830,36920,0.370125313283208,1
3796,3797,Marathahalli,346600,97830,248770,0.7177437968840161,0
3797,3798,Horamavu,67500,61740,5760,0.08533333333333333,1
3798,3799,Krishnarajapuram,386350,117850,268500,0.6949657046719296,0
3799,3800,Marathahalli,355300,39560,315740,0.8886574725584013,-1
3800,3801,Hoodi,238350,50320,188030,0.7888818963708831,-1
3801,3802,Jalahalli,108050,43740,64310,0.5951874132346135,0
3802,3803,Kalyan Nagar,217350,56950,160400,0.7379802162410858,0
3803,3804,CV Raman Nagar,222000,82930,139070,0.6264414414414414,0
3804,3805,Banaswadi,359150,80690,278460,0.7753306417931226,-1
3805,3806,HBR Layout,75250,91950,-16700,-0.22192691029900333,1
3806,3807,Whitefield,351850,61900,289950,0.8240727582776751,-1
3807,3808,CV Raman Nagar,228350,34450,193900,0.8491350996277643,-1
3808,3809,Mahadevapura,90500,167120,-76620,-0.8466298342541436,1
3809,3810,Whitefield,197950,45800,152150,0.7686284415256378,0
3810,3811,Shivajinagar,70150,50100,20050,0.285816108339273,1
3811,3812,Banaswadi,197200,82680,114520,0.5807302231237322,0
3812,3813,Varthur,339200,67490,271710,0.8010318396226415,-1
3813,3814,Banaswadi,130350,70960,59390,0.45561948599923285,1
3814,3815,Jalahalli,190700,79110,111590,0.5851599370739381,1
3815,3816,Varthur,350750,79690,271060,0.7728011404133999,0
3816,3817,Krishnarajapuram,311300,61350,249950,0.8029232251847093,-1
3817,3818,Rajajinagar,429200,47450,381750,0.8894454799627214,-1
3818,3819,Indiranagar,208900,43030,165870,0.7940162757300143,-1
3819,3820,Whitefield,292600,17120,275480,0.9414900888585099,-1
3820,3821,Hebbal,105850,49370,56480,0.5335852621634388,0
3821,3822,Hoodi,426450,67720,358730,0.8412006096846054,-1
3822,3823,Kalyan Nagar,331600,89930,241670,0.7287997587454764,-1
3823,3824,Mahadevapura,266700,49750,216950,0.8134608173978253,0
3824,3825,Malleswaram,260100,22690,237410,0.9127643214148404,-1
3825,3826,Horamavu,42200,96770,-54570,-1.293127962085308,1
3826,3827,Jalahalli,114350,23860,90490,0.7913423699169218,0
3827,3828,Mahadevapura,431800,87610,344190,0.797105141269106,0
3828,3829,CV Raman Nagar,62100,61840,260,0.004186795491143317,1
3829,3830,Mahadevapura,117750,19510,98240,0.8343099787685775,0
3830,3831,Marathahalli,200400,100020,100380,0.5008982035928143,1
3831,3832,Jalahalli,407600,123350,284250,0.6973748773307163,0
3832,3833,Krishnarajapuram,87250,54610,32640,0.3740974212034384,1
3833,3834,Varthur,404650,121500,283150,0.6997405164957371,0
3834,3835,Mahadevapura,358600,69530,289070,0.8061070831009481,-1
3835,3836,Banaswadi,303200,63220,239980,0.791490765171504,0
3836,3837,Kammanahalli,146500,56150,90350,0.6167235494880546,0
3837,3838,Vasanth Nagar,400400,91440,308960,0.7716283716283716,0
3838,3839,Whitefield,227250,45240,182010,0.8009240924092409,-1
3839,3840,Banaswadi,107950,19550,88400,0.8188976377952756,-1
3840,3841,Shivajinagar,363000,101280,261720,0.7209917355371901,-1
3841,3842,Kammanahalli,65850,79710,-13860,-0.21047835990888383,1
3842,3843,Rajajinagar,134600,50760,83840,0.6228826151560178,0
3843,3844,Malleswaram,153050,88290,64760,0.42312969617771967,1
3844,3845,Rajajinagar,399800,55240,344560,0.8618309154577288,0
3845,3846,Krishnarajapuram,251750,91010,160740,0.6384905660377358,0
3846,3847,Whitefield,105600,102140,3460,0.03276515151515152,1
3847,3848,Whitefield,215300,16620,198680,0.9228053878309336,-1
3848,3849,Hoodi,437950,1070,436880,0.9975567987213152,-1
3849,3850,Horamavu,127800,4830,122970,0.962206572769953,-1
3850,3851,Whitefield,417250,57380,359870,0.8624805272618334,-1
3851,3852,Kalyan Nagar,44150,12430,31720,0.7184597961494904,0
3852,3853,Krishnarajapuram,404650,54130,350520,0.8662300753737798,0
3853,3854,Horamavu,370100,72890,297210,0.8030532288570656,0
3854,3855,CV Raman Nagar,130700,59890,70810,0.5417750573833205,0
3855,3856,Kalyan Nagar,82700,54110,28590,0.34570737605804114,1
3856,3857,Varthur,378050,47130,330920,0.8753339505356434,0
3857,3858,Hebbal,331350,112660,218690,0.6599969820431568,0
3858,3859,Horamavu,120050,65450,54600,0.45481049562682213,1
3859,3860,Mahadevapura,404500,39580,364920,0.902150803461063,-1
3860,3861,Marathahalli,317550,11490,306060,0.9638167217760982,-1
3861,3862,Marathahalli,191850,40480,151370,0.7890018243419338,-1
3862,3863,Varthur,308300,32800,275500,0.8936101200129744,-1
3863,3864,Horamavu,272200,39350,232850,0.8554371785451874,-1
3864,3865,Marathahalli,369200,71040,298160,0.8075839653304442,0
3865,3866,Jalahalli,385900,27460,358440,0.9288416688261207,-1
3866,3867,Banaswadi,204800,0,204800,1.0,-1
3867,3868,Marathahalli,222450,76050,146400,0.6581254214430209,0
3868,3869,Varthur,303700,70170,233530,0.7689496213368455,0
3869,3870,Kalyan Nagar,124200,44670,79530,0.6403381642512077,0
3870,3871,Horamavu,399500,98280,301220,0.7539924906132666,0
3871,3872,Marathahalli,236350,32420,203930,0.8628305479162259,0
3872,3873,Indiranagar,363550,74100,289450,0.7961765919405859,0
3873,3874,Malleswaram,139950,64330,75620,0.5403358342265094,0
3874,3875,Mahadevapura,251500,53890,197610,0.7857256461232605,0
3875,3876,Krishnarajapuram,116650,76860,39790,0.3411058722674668,1
3876,3877,Hebbal,210550,45240,165310,0.7851341724056043,0
3877,3878,Krishnarajapuram,270550,76910,193640,0.7157272223248937,0
3878,3879,Rajajinagar,142600,196700,-54100,-0.379382889200561,1
3879,3880,HBR Layout,424500,47220,377280,0.8887632508833923,-1
3880,3881,Indiranagar,148250,102400,45850,0.30927487352445193,1
3881,3882,Malleswaram,173750,32480,141270,0.8130647482014388,-1
3882,3883,Marathahalli,258800,45750,213050,0.8232225656877898,-1
3883,3884,CV Raman Nagar,401800,144820,256980,0.6395719263315082,0
3884,3885,Horamavu,325200,16510,308690,0.9492312423124232,-1
3885,3886,Malleswaram,231400,128230,103170,0.4458513396715644,1
3886,3887,Marathahalli,157850,43140,114710,0.726702565726956,0
3887,3888,Banaswadi,151650,34560,117090,0.7721068249258161,0
3888,3889,Banaswadi,410200,62500,347700,0.8476352998537299,-1
3889,3890,Banaswadi,387250,42420,344830,0.890458360232408,-1
3890,3891,Shivajinagar,152050,32070,119980,0.7890825386386057,0
3891,3892,CV Raman Nagar,370200,25830,344370,0.930226904376013,-1
3892,3893,CV Raman Nagar,357650,53000,304650,0.8518104291905494,-1
3893,3894,Banaswadi,53600,81740,-28140,-0.525,1
3894,3895,Indiranagar,101950,39990,61960,0.607748896517901,0
3895,3896,Banaswadi,292850,26380,266470,0.9099197541403449,-1
3896,3897,Marathahalli,379400,59560,319840,0.84301528729573,-1
3897,3898,Hoodi,426300,34440,391860,0.9192118226600985,-1
3898,3899,Marathahalli,301550,51800,249750,0.8282208588957055,0
3899,3900,Banaswadi,103250,61170,42080,0.4075544794188862,1
3900,3901,Marathahalli,82700,92520,-9820,-0.11874244256348247,1
3901,3902,Vasanth Nagar,230950,63990,166960,0.7229270404849535,0
3902,3903,Whitefield,359200,48310,310890,0.8655066815144766,-1
3903,3904,Mahadevapura,366400,93860,272540,0.7438318777292576,0
3904,3905,Vasanth Nagar,327500,114450,213050,0.6505343511450382,0
3905,3906,HBR Layout,130250,39940,90310,0.6933589251439539,0
3906,3907,Hebbal,347000,77750,269250,0.7759365994236311,0
3907,3908,Marathahalli,117000,112510,4490,0.03837606837606838,1
3908,3909,Vasanth Nagar,100350,47720,52630,0.52446437468859,1
3909,3910,Marathahalli,324550,59650,264900,0.8162070559235866,-1
3910,3911,CV Raman Nagar,301950,60020,241930,0.8012253684384832,-1
3911,3912,HBR Layout,366850,46910,319940,0.8721275725773477,-1
3912,3913,Marathahalli,26300,11480,14820,0.5634980988593156,0
3913,3914,Kalyan Nagar,215850,51650,164200,0.7607134584201992,0
3914,3915,Krishnarajapuram,293750,52050,241700,0.8228085106382979,-1
3915,3916,Indiranagar,31850,19800,12050,0.3783359497645212,1
3916,3917,HBR Layout,345400,99980,245420,0.7105385060799073,-1
3917,3918,Krishnarajapuram,71850,97230,-25380,-0.35323590814196243,1
3918,3919,Jalahalli,157600,47860,109740,0.6963197969543147,0
3919,3920,Vasanth Nagar,290650,89080,201570,0.693514536383967,0
3920,3921,HBR Layout,174050,49820,124230,0.7137604136742316,-1
3921,3922,Varthur,298150,91800,206350,0.6921012912963274,0
3922,3923,HBR Layout,275950,81210,194740,0.7057075557166154,0
3923,3924,Malleswaram,299300,85210,214090,0.7153023722018043,-1
3924,3925,Hoodi,119850,51190,68660,0.5728827701293283,0
3925,3926,Krishnarajapuram,56250,48030,8220,0.14613333333333334,1
3926,3927,Rajajinagar,39700,79570,-39870,-1.0042821158690176,1
3927,3928,Indiranagar,317200,126750,190450,0.6004098360655737,0
3928,3929,Jalahalli,307900,69400,238500,0.7746021435531016,0
3929,3930,Marathahalli,305550,63810,241740,0.7911634756995581,-1
3930,3931,Hebbal,57750,22060,35690,0.618008658008658,0
3931,3932,Whitefield,179600,47140,132460,0.7375278396436525,0
3932,3933,Varthur,443450,69100,374350,0.8441763445709776,0
3933,3934,Vasanth Nagar,40300,73830,-33530,-0.8320099255583127,1
3934,3935,Hoodi,286600,67870,218730,0.7631891137473831,0
3935,3936,Malleswaram,52250,75640,-23390,-0.4476555023923445,1
3936,3937,Marathahalli,248600,55180,193420,0.778037007240547,-1
3937,3938,Shivajinagar,41750,146440,-104690,-2.5075449101796408,1
3938,3939,Marathahalli,227550,46570,180980,0.7953416831465612,0
3939,3940,CV Raman Nagar,259350,51700,207650,0.8006554848660112,-1
3940,3941,Horamavu,371300,79900,291400,0.7848101265822784,0
3941,3942,Kalyan Nagar,238950,98160,140790,0.589202762084118,0
3942,3943,Marathahalli,211900,72520,139380,0.6577630957999057,0
3943,3944,Shivajinagar,427200,11420,415780,0.9732677902621722,-1
3944,3945,Kammanahalli,148050,40740,107310,0.724822695035461,0
3945,3946,Jalahalli,127050,110940,16110,0.1268004722550177,1
3946,3947,Kalyan Nagar,447750,59610,388140,0.8668676716917922,0
3947,3948,Whitefield,428300,99440,328860,0.7678262899836563,-1
3948,3949,Marathahalli,66550,75010,-8460,-0.12712246431254695,1
3949,3950,Hebbal,227550,42920,184630,0.8113821138211382,-1
3950,3951,Kalyan Nagar,38150,22810,15340,0.4020969855832241,1
3951,3952,Krishnarajapuram,295500,23860,271640,0.9192554991539763,-1
3952,3953,Vasanth Nagar,246100,41900,204200,0.8297440065014222,0
3953,3954,Vasanth Nagar,361550,72510,289040,0.7994468261651224,-1
3954,3955,Marathahalli,437350,94270,343080,0.7844518120498457,-1
3955,3956,Mahadevapura,153200,86080,67120,0.4381201044386423,1
3956,3957,Horamavu,345800,51040,294760,0.8524002313475998,0
3957,3958,Kammanahalli,394100,31430,362670,0.9202486678507993,-1
3958,3959,Marathahalli,224100,47750,176350,0.786925479696564,0
3959,3960,Indiranagar,241650,80190,161460,0.6681564245810055,0
3960,3961,Malleswaram,433800,154400,279400,0.6440756108805902,0
3961,3962,CV Raman Nagar,346250,69100,277150,0.8004332129963899,-1
3962,3963,Vasanth Nagar,209800,5200,204600,0.9752144899904671,-1
3963,3964,Kammanahalli,348300,29450,318850,0.9154464542061441,-1
3964,3965,Vasanth Nagar,428000,61540,366460,0.856214953271028,-1
3965,3966,Indiranagar,235000,83620,151380,0.6441702127659574,0
3966,3967,Varthur,369700,53040,316660,0.8565323235055451,-1
3967,3968,Mahadevapura,388200,63380,324820,0.8367336424523442,0
3968,3969,Kammanahalli,186250,16040,170210,0.9138791946308725,-1
3969,3970,Krishnarajapuram,246300,73690,172610,0.7008120178643931,0
3970,3971,Kalyan Nagar,392000,110290,281710,0.7186479591836735,-1
3971,3972,Jalahalli,310050,49170,260880,0.8414126753749396,-1
3972,3973,Jalahalli,214450,92560,121890,0.5683842387502914,0
3973,3974,Jalahalli,79650,110960,-31310,-0.3930947897049592,1
3974,3975,Kammanahalli,317700,20000,297700,0.9370475291155178,-1
3975,3976,Krishnarajapuram,90250,69670,20580,0.2280332409972299,1
3976,3977,HBR Layout,366800,125830,240970,0.6569520174482006,0
3977,3978,Marathahalli,367250,70450,296800,0.8081688223281144,0
3978,3979,Mahadevapura,435850,61710,374140,0.8584145921762074,-1
3979,3980,Indiranagar,191100,70280,120820,0.6322344322344322,0
3980,3981,Jalahalli,33100,55760,-22660,-0.6845921450151058,1
3981,3982,HBR Layout,83650,44060,39590,0.4732815301852959,0
3982,3983,Kalyan Nagar,342350,72040,270310,0.7895720753614722,-1
3983,3984,HBR Layout,275600,120200,155400,0.5638606676342526,0
3984,3985,Shivajinagar,27500,60380,-32880,-1.1956363636363636,1
3985,3986,Banaswadi,100100,165010,-64910,-0.6484515484515484,1
3986,3987,Kalyan Nagar,257250,44590,212660,0.8266666666666667,0
3987,3988,Horamavu,95200,120860,-25660,-0.2695378151260504,1
3988,3989,Krishnarajapuram,396650,45970,350680,0.884104374133367,-1
3989,3990,Kammanahalli,183700,75840,107860,0.5871529667936853,0
3990,3991,Horamavu,296200,50210,245990,0.8304861580013504,-1
3991,3992,Mahadevapura,260950,84750,176200,0.6752251389155011,0
3992,3993,Malleswaram,252300,9980,242320,0.960443915973048,-1
3993,3994,Banaswadi,38900,71600,-32700,-0.8406169665809768,1
3994,3995,Horamavu,165550,39710,125840,0.7601328903654485,0
3995,3996,Kalyan Nagar,418750,46800,371950,0.8882388059701493,0
3996,3997,Kammanahalli,435600,51720,383880,0.881267217630854,-1
3997,3998,Kammanahalli,428600,93830,334770,0.7810779281381242,0
3998,3999,Shivajinagar,262450,52980,209470,0.79813297771004,0
3999,4000,Rajajinagar,226450,41800,184650,0.8154117906822698,-1
4000,4001,Vasanth Nagar,29550,110250,-80700,-2.730964467005076,1
4001,4002,Vasanth Nagar,257650,93420,164230,0.6374150980011644,0
4002,4003,Varthur,228850,43480,185370,0.8100065545116889,-1
4003,4004,Horamavu,25400,96830,-71430,-2.812204724409449,1
4004,4005,Jalahalli,115550,38050,77500,0.6707053223712679,0
4005,4006,Malleswaram,276500,47380,229120,0.8286437613019891,0
4006,4007,Kalyan Nagar,120250,47410,72840,0.6057380457380457,0
4007,4008,HBR Layout,323350,23700,299650,0.9267048090304624,-1
4008,4009,Krishnarajapuram,58250,12070,46180,0.7927896995708155,-1
4009,4010,Krishnarajapuram,338900,109840,229060,0.675892593685453,0
4010,4011,Shivajinagar,253100,15260,237840,0.9397076254444884,-1
4011,4012,Whitefield,104300,99850,4450,0.042665388302972194,1
4012,4013,CV Raman Nagar,113550,15320,98230,0.8650814619110524,-1
4013,4014,Rajajinagar,406000,58980,347020,0.8547290640394088,-1
4014,4015,Jalahalli,153900,51430,102470,0.6658219623131904,0
4015,4016,Hebbal,427750,35360,392390,0.9173348918760958,-1
4016,4017,CV Raman Nagar,149250,73660,75590,0.506465661641541,1
4017,4018,Kammanahalli,65500,75100,-9600,-0.1465648854961832,1
4018,4019,Whitefield,77850,68090,9760,0.12536929993577392,1
4019,4020,Jalahalli,227300,98110,129190,0.5683677958644963,0
4020,4021,Jalahalli,304250,87650,216600,0.7119145439605588,0
4021,4022,Rajajinagar,50650,46560,4090,0.0807502467917078,1
4022,4023,Rajajinagar,291150,67660,223490,0.767611196977503,-1
4023,4024,Varthur,143450,65690,77760,0.5420704078075985,1
4024,4025,Vasanth Nagar,284850,20780,264070,0.9270493242057223,-1
4025,4026,Varthur,95850,29580,66270,0.6913928012519562,0
4026,4027,Shivajinagar,434350,27650,406700,0.9363416599516519,-1
4027,4028,Mahadevapura,246050,96870,149180,0.6062995326153221,0
4028,4029,Vasanth Nagar,271750,61950,209800,0.772033118675253,-1
4029,4030,Whitefield,389700,37900,351800,0.9027457018219143,-1
4030,4031,Whitefield,388850,51280,337570,0.8681239552526682,-1
4031,4032,Shivajinagar,213000,81290,131710,0.618356807511737,0
4032,4033,CV Raman Nagar,447150,60840,386310,0.8639382757463938,-1
4033,4034,Marathahalli,231550,100630,130920,0.5654070395163032,0
4034,4035,CV Raman Nagar,403050,50210,352840,0.875424885249969,-1
4035,4036,Kammanahalli,139850,10130,129720,0.9275652484805148,-1
4036,4037,Rajajinagar,67550,77680,-10130,-0.14996299037749816,1
4037,4038,Kammanahalli,398450,58300,340150,0.8536830217091228,-1
4038,4039,Rajajinagar,94300,64520,29780,0.31580063626723226,1
4039,4040,Banaswadi,198000,35410,162590,0.8211616161616162,-1
4040,4041,Banaswadi,198850,38710,160140,0.8053306512446567,0
4041,4042,Malleswaram,193500,48760,144740,0.7480103359173127,0
4042,4043,Vasanth Nagar,269950,24510,245440,0.9092054084089646,-1
4043,4044,Shivajinagar,52350,95010,-42660,-0.8148997134670487,1
4044,4045,Hoodi,181250,31100,150150,0.8284137931034483,-1
4045,4046,Krishnarajapuram,85700,161020,-75320,-0.878879813302217,1
4046,4047,Malleswaram,119350,91600,27750,0.23250942605781316,1
4047,4048,Banaswadi,335450,60060,275390,0.8209569235355493,-1
4048,4049,Hebbal,58900,59410,-510,-0.00865874363327674,1
4049,4050,Indiranagar,121450,41850,79600,0.655413750514615,0
4050,4051,Banaswadi,378450,41650,336800,0.8899458316818603,-1
4051,4052,Jalahalli,353300,61180,292120,0.826832720067931,-1
4052,4053,Marathahalli,307500,104100,203400,0.6614634146341464,0
4053,4054,Rajajinagar,150700,65790,84910,0.5634372926343729,0
4054,4055,Hoodi,330800,31340,299460,0.9052599758162031,-1
4055,4056,Indiranagar,267100,49890,217210,0.8132160239610633,0
4056,4057,HBR Layout,305950,127150,178800,0.5844092171923517,1
4057,4058,Rajajinagar,298450,85560,212890,0.7133188138716703,0
4058,4059,Mahadevapura,233050,59470,173580,0.744818708431667,0
4059,4060,CV Raman Nagar,230200,77360,152840,0.6639443961772372,0
4060,4061,Banaswadi,269000,36540,232460,0.8641635687732342,-1
4061,4062,Vasanth Nagar,407100,97440,309660,0.7606484893146647,-1
4062,4063,Varthur,73950,143460,-69510,-0.9399594320486815,1
4063,4064,Marathahalli,165450,3410,162040,0.9793895436687821,-1
4064,4065,Banaswadi,170550,25110,145440,0.8527704485488127,-1
4065,4066,Vasanth Nagar,425150,39150,386000,0.907914853581089,-1
4066,4067,Hebbal,119800,95610,24190,0.20191986644407345,1
4067,4068,Rajajinagar,316550,91170,225380,0.7119886273890381,0
4068,4069,Shivajinagar,178300,73980,104320,0.58508132361189,1
4069,4070,HBR Layout,278400,68830,209570,0.7527658045977011,0
4070,4071,Horamavu,261100,42110,218990,0.8387207966296438,-1
4071,4072,Marathahalli,422800,27890,394910,0.9340350047303689,-1
4072,4073,Kammanahalli,294900,59550,235350,0.7980671414038657,0
4073,4074,Kalyan Nagar,418550,67620,350930,0.8384422410703619,0
4074,4075,Whitefield,370050,134740,235310,0.6358870422915822,0
4075,4076,Jalahalli,433150,107190,325960,0.7525337642848897,-1
4076,4077,Shivajinagar,148950,54720,94230,0.6326283987915408,0
4077,4078,Kammanahalli,127000,65240,61760,0.4862992125984252,0
4078,4079,Krishnarajapuram,366450,45140,321310,0.8768181197980625,0
4079,4080,Hebbal,317900,106240,211660,0.6658068575023592,0
4080,4081,Mahadevapura,84750,138440,-53690,-0.6335103244837759,1
4081,4082,Mahadevapura,67200,69330,-2130,-0.03169642857142857,1
4082,4083,Mahadevapura,222100,138250,83850,0.3775326429536245,1
4083,4084,Rajajinagar,136250,118180,18070,0.13262385321100917,1
4084,4085,Marathahalli,75050,68070,6980,0.09300466355762825,1
4085,4086,Kammanahalli,413400,42550,370850,0.8970730527334301,0
4086,4087,Horamavu,289850,64590,225260,0.7771606003105054,0
4087,4088,Whitefield,99850,45710,54140,0.5422133199799699,0
4088,4089,Vasanth Nagar,308650,58970,249680,0.8089421675036449,-1
4089,4090,Rajajinagar,387900,91300,296600,0.7646300592936324,0
4090,4091,Hebbal,227800,48340,179460,0.7877963125548727,-1
4091,4092,Horamavu,387200,77750,309450,0.7991993801652892,0
4092,4093,Varthur,142750,22080,120670,0.845323992994746,-1
4093,4094,Kalyan Nagar,136600,30130,106470,0.7794289897510981,0
4094,4095,Rajajinagar,71050,71560,-510,-0.007178043631245602,1
4095,4096,Horamavu,190950,72670,118280,0.6194291699397748,0
4096,4097,Mahadevapura,378350,62350,316000,0.8352054975551738,-1
4097,4098,Vasanth Nagar,236650,29160,207490,0.876780054933446,-1
4098,4099,Banaswadi,265550,41110,224440,0.8451892299002071,0
4099,4100,Jalahalli,99750,107090,-7340,-0.07358395989974938,1
4100,4101,Banaswadi,123000,88020,34980,0.284390243902439,1
4101,4102,Krishnarajapuram,96500,50710,45790,0.4745077720207254,0
4102,4103,HBR Layout,246850,36760,210090,0.8510836540409156,0
4103,4104,Varthur,290450,26720,263730,0.9080048201067309,-1
4104,4105,Banaswadi,390300,105360,284940,0.7300538047655649,0
4105,4106,Horamavu,229500,57360,172140,0.7500653594771242,-1
4106,4107,Indiranagar,217550,43660,173890,0.7993105033325673,0
4107,4108,Hebbal,314050,68670,245380,0.7813405508676963,0
4108,4109,Shivajinagar,108450,2770,105680,0.974458275703089,-1
4109,4110,Krishnarajapuram,256100,49290,206810,0.8075361187036314,0
4110,4111,Shivajinagar,367700,72090,295610,0.803943432145771,-1
4111,4112,Hebbal,99550,49240,50310,0.5053741838272225,0
4112,4113,Whitefield,268150,106630,161520,0.602349431288458,0
4113,4114,Hebbal,208150,54230,153920,0.7394667307230363,0
4114,4115,Hoodi,413200,67630,345570,0.8363262342691191,0
4115,4116,Hebbal,309100,52760,256340,0.8293109026205112,-1
4116,4117,Hoodi,190400,64860,125540,0.6593487394957983,0
4117,4118,Indiranagar,268250,50310,217940,0.8124510717614166,-1
4118,4119,Horamavu,45850,103980,-58130,-1.2678298800436205,1
4119,4120,Varthur,176150,110410,65740,0.37320465512347434,1
4120,4121,Hoodi,297900,39700,258200,0.8667338032896945,0
4121,4122,Banaswadi,398150,113030,285120,0.7161120180836368,0
4122,4123,Mahadevapura,107150,75850,31300,0.2921138590760616,1
4123,4124,CV Raman Nagar,71850,83470,-11620,-0.16172581767571328,1
4124,4125,Kalyan Nagar,280150,31010,249140,0.889309298590041,-1
4125,4126,Horamavu,278850,50860,227990,0.8176080329926484,-1
4126,4127,Mahadevapura,387050,36690,350360,0.9052060457305258,-1
4127,4128,CV Raman Nagar,283650,77170,206480,0.7279393618896527,-1
4128,4129,Indiranagar,400350,108780,291570,0.7282877482203073,0
4129,4130,Kalyan Nagar,100250,78070,22180,0.22124688279301746,1
4130,4131,Vasanth Nagar,157550,131980,25570,0.16229768327515073,1
4131,4132,Krishnarajapuram,434550,29470,405080,0.9321827177539984,-1
4132,4133,Banaswadi,389900,29960,359940,0.9231597845601436,-1
4133,4134,Kalyan Nagar,145050,106350,38700,0.26680455015511895,1
4134,4135,Rajajinagar,284250,74460,209790,0.7380474934036939,0
4135,4136,Vasanth Nagar,116250,73070,43180,0.37144086021505374,1
4136,4137,Malleswaram,51800,32650,19150,0.3696911196911197,1
4137,4138,HBR Layout,48600,24390,24210,0.4981481481481482,1
4138,4139,Indiranagar,439700,86440,353260,0.8034114168751422,-1
4139,4140,Hoodi,67050,81600,-14550,-0.21700223713646533,1
4140,4141,Shivajinagar,210300,47010,163290,0.7764621968616262,-1
4141,4142,Krishnarajapuram,410950,34250,376700,0.9166565275580971,-1
4142,4143,Hebbal,377000,17860,359140,0.9526259946949602,-1
4143,4144,Rajajinagar,321600,3060,318540,0.9904850746268656,-1
4144,4145,Whitefield,271900,33020,238880,0.8785582934902537,-1
4145,4146,Vasanth Nagar,303550,66380,237170,0.7813210344259595,-1
4146,4147,HBR Layout,243050,104570,138480,0.5697593087842008,0
4147,4148,Horamavu,301600,109940,191660,0.6354774535809019,0
4148,4149,Kammanahalli,268850,57160,211690,0.7873907383299238,0
4149,4150,Varthur,136750,75620,61130,0.4470201096892139,1
4150,4151,Kammanahalli,290300,115710,174590,0.6014123320702721,0
4151,4152,Krishnarajapuram,353300,65480,287820,0.8146617605434475,-1
4152,4153,Kalyan Nagar,192750,62640,130110,0.6750194552529183,0
4153,4154,HBR Layout,36600,34930,1670,0.04562841530054645,1
4154,4155,Varthur,132850,61750,71100,0.5351900639819345,0
4155,4156,Malleswaram,363250,76320,286930,0.7898967653131452,0
4156,4157,HBR Layout,170400,116710,53690,0.31508215962441316,1
4157,4158,Whitefield,28100,67890,-39790,-1.4160142348754448,1
4158,4159,Hebbal,155950,85940,70010,0.4489259378005771,1
4159,4160,Varthur,363500,7370,356130,0.9797248968363136,-1
4160,4161,Kammanahalli,193900,132610,61290,0.31609076843733885,1
4161,4162,Jalahalli,328600,28190,300410,0.9142118076688983,-1
4162,4163,Rajajinagar,406300,105440,300860,0.7404873246369678,0
4163,4164,Kammanahalli,290250,61360,228890,0.7885960378983635,0
4164,4165,Whitefield,111750,69560,42190,0.3775391498881432,1
4165,4166,Vasanth Nagar,400750,45730,355020,0.8858889582033687,-1
4166,4167,Indiranagar,298450,91060,207390,0.6948902663762775,0
4167,4168,Jalahalli,204150,47030,157120,0.7696301738917463,0
4168,4169,Krishnarajapuram,126950,49990,76960,0.6062229224103978,0
4169,4170,Indiranagar,133000,22340,110660,0.8320300751879699,-1
4170,4171,Shivajinagar,120650,28050,92600,0.7675093244923332,0
4171,4172,Whitefield,150750,96790,53960,0.3579436152570481,1
4172,4173,Mahadevapura,431550,34470,397080,0.9201251303441085,-1
4173,4174,Kammanahalli,348350,25380,322970,0.9271422419979906,-1
4174,4175,Hoodi,252700,70960,181740,0.719192718638702,-1
4175,4176,Krishnarajapuram,80300,79690,610,0.007596513075965131,1
4176,4177,HBR Layout,35600,46650,-11050,-0.3103932584269663,1
4177,4178,CV Raman Nagar,90100,17350,72750,0.8074361820199778,-1
4178,4179,Hebbal,89550,119050,-29500,-0.3294249022892239,1
4179,4180,Hoodi,46300,86660,-40360,-0.8717062634989201,1
4180,4181,Banaswadi,75800,66130,9670,0.12757255936675463,1
4181,4182,Kalyan Nagar,286750,80040,206710,0.720871839581517,0
4182,4183,Jalahalli,304800,64840,239960,0.7872703412073491,0
4183,4184,Vasanth Nagar,413400,86780,326620,0.790082244799226,-1
4184,4185,Varthur,300350,69060,231290,0.770068253704012,0
4185,4186,Mahadevapura,324700,22050,302650,0.9320911610717586,-1
4186,4187,Whitefield,127750,47560,80190,0.6277103718199608,0
4187,4188,CV Raman Nagar,121300,71120,50180,0.41368507831821927,0
4188,4189,Jalahalli,98750,36240,62510,0.6330126582278481,0
4189,4190,Krishnarajapuram,62800,93170,-30370,-0.48359872611464966,1
4190,4191,Malleswaram,226700,78320,148380,0.65452139391266,0
4191,4192,Hoodi,269700,78390,191310,0.7093437152391546,0
4192,4193,Varthur,114950,52620,62330,0.5422357546759461,0
4193,4194,Whitefield,249900,84510,165390,0.6618247298919567,0
4194,4195,Whitefield,200950,68580,132370,0.6587210748942524,0
4195,4196,Shivajinagar,442350,75870,366480,0.8284842319430316,0
4196,4197,Rajajinagar,368300,113570,254730,0.6916372522400217,0
4197,4198,Rajajinagar,433050,43870,389180,0.8986953007735827,0
4198,4199,Whitefield,165900,34030,131870,0.7948764315852923,-1
4199,4200,HBR Layout,428900,59960,368940,0.8602005129400793,-1
4200,4201,CV Raman Nagar,306200,84650,221550,0.7235467015022861,0
4201,4202,Varthur,317400,59620,257780,0.8121613106490233,0
4202,4203,CV Raman Nagar,386900,78500,308400,0.7971051951408633,-1
4203,4204,Varthur,365250,98500,266750,0.730321697467488,-1
4204,4205,Jalahalli,418450,87470,330980,0.7909666626837137,0
4205,4206,Malleswaram,203700,31120,172580,0.8472263132056946,-1
4206,4207,Jalahalli,216050,31390,184660,0.8547095579726915,0
4207,4208,CV Raman Nagar,171700,49450,122250,0.7119976703552708,-1
4208,4209,Horamavu,51500,49030,2470,0.04796116504854369,1
4209,4210,Marathahalli,150350,81350,69000,0.45892916528101096,0
4210,4211,Vasanth Nagar,115600,27460,88140,0.7624567474048443,0
4211,4212,Hoodi,288950,80790,208160,0.7204014535386745,0
4212,4213,Kammanahalli,194050,24440,169610,0.8740530791033239,-1
4213,4214,Rajajinagar,35700,120380,-84680,-2.3719887955182073,1
4214,4215,Vasanth Nagar,302550,39620,262930,0.8690464386051893,-1
4215,4216,Hoodi,146150,46840,99310,0.6795073554567226,0
4216,4217,Horamavu,409000,42420,366580,0.8962836185819071,-1
4217,4218,CV Raman Nagar,109150,68000,41150,0.37700412276683465,1
4218,4219,Banaswadi,300650,66710,233940,0.7781140861466822,-1
4219,4220,Hebbal,66600,22230,44370,0.6662162162162162,0
4220,4221,Vasanth Nagar,132900,82690,50210,0.3778028592927013,1
4221,4222,Varthur,152700,57250,95450,0.6250818598559267,0
4222,4223,Marathahalli,302550,61050,241500,0.7982151710461081,0
4223,4224,Hoodi,31600,169030,-137430,-4.349050632911393,1
4224,4225,Mahadevapura,293300,75380,217920,0.7429935219911353,-1
4225,4226,Whitefield,198850,65690,133160,0.6696504903193362,0
4226,4227,Whitefield,179650,40080,139570,0.776899526857779,0
4227,4228,Shivajinagar,397600,53120,344480,0.8663983903420523,-1
4228,4229,Hoodi,367500,35160,332340,0.9043265306122449,-1
4229,4230,Rajajinagar,228200,47590,180610,0.7914548641542507,0
4230,4231,Hoodi,74250,108000,-33750,-0.45454545454545453,1
4231,4232,Hoodi,139200,64180,75020,0.5389367816091954,0
4232,4233,Banaswadi,131350,144280,-12930,-0.0984392843547773,1
4233,4234,Varthur,65000,58280,6720,0.10338461538461538,1
4234,4235,Vasanth Nagar,222100,45550,176550,0.794912201710941,0
4235,4236,Kammanahalli,357600,57200,300400,0.8400447427293065,-1
4236,4237,Marathahalli,205000,41230,163770,0.7988780487804878,-1
4237,4238,HBR Layout,320650,51840,268810,0.8383283954467488,0
4238,4239,Shivajinagar,440850,19000,421850,0.9569014403992288,-1
4239,4240,Vasanth Nagar,90850,61930,28920,0.3183269124931205,1
4240,4241,Malleswaram,409500,70390,339110,0.8281074481074481,0
4241,4242,Indiranagar,259150,57150,202000,0.779471348639784,-1
4242,4243,Jalahalli,51850,11600,40250,0.7762777242044359,0
4243,4244,Banaswadi,40400,13160,27240,0.6742574257425743,0
4244,4245,HBR Layout,280650,50830,229820,0.8188847318724389,-1
4245,4246,Hoodi,190400,86450,103950,0.5459558823529411,0
4246,4247,Kammanahalli,353450,54820,298630,0.8449002687791767,-1
4247,4248,Malleswaram,49150,23190,25960,0.5281790437436419,0
4248,4249,Horamavu,168900,82950,85950,0.5088809946714032,0
4249,4250,Whitefield,335000,33390,301610,0.9003283582089552,-1
4250,4251,Jalahalli,345250,70470,274780,0.7958870383779869,0
4251,4252,Varthur,100900,97790,3110,0.030822596630327055,1
4252,4253,Varthur,325400,33510,291890,0.8970190534726491,0
4253,4254,Banaswadi,297850,86240,211610,0.7104582843713279,0
4254,4255,Krishnarajapuram,151450,19820,131630,0.8691317266424563,-1
4255,4256,Vasanth Nagar,66350,75960,-9610,-0.14483798040693294,1
4256,4257,Kalyan Nagar,229650,37580,192070,0.8363596777705203,-1
4257,4258,HBR Layout,156000,77280,78720,0.5046153846153846,0
4258,4259,HBR Layout,246100,61250,184850,0.7511174319382364,-1
4259,4260,Indiranagar,228350,74570,153780,0.6734398948981826,0
4260,4261,Kalyan Nagar,306450,51390,255060,0.8323054331864904,-1
4261,4262,Shivajinagar,384100,89520,294580,0.7669356938297318,0
4262,4263,Krishnarajapuram,408700,83660,325040,0.7953021776364081,0
4263,4264,Varthur,385250,99210,286040,0.7424789097988319,0
4264,4265,HBR Layout,174150,46930,127220,0.7305196669537755,0
4265,4266,Shivajinagar,50650,64080,-13430,-0.26515301085883514,1
4266,4267,Mahadevapura,131150,63320,67830,0.5171940526115135,0
4267,4268,CV Raman Nagar,48850,72820,-23970,-0.4906857727737973,1
4268,4269,Shivajinagar,160600,34660,125940,0.7841843088418431,0
4269,4270,Kalyan Nagar,398400,62920,335480,0.8420682730923694,-1
4270,4271,Jalahalli,130150,80840,49310,0.37887053399923165,1
4271,4272,Rajajinagar,161750,18510,143240,0.885564142194745,-1
4272,4273,Kalyan Nagar,210250,104430,105820,0.5033055885850178,0
4273,4274,Horamavu,335100,16800,318300,0.9498657117278424,-1
4274,4275,HBR Layout,415000,48190,366810,0.8838795180722891,0
4275,4276,Hoodi,100000,90730,9270,0.0927,1
4276,4277,Malleswaram,88250,108040,-19790,-0.22424929178470254,1
4277,4278,Vasanth Nagar,26850,25090,1760,0.06554934823091248,1
4278,4279,Kammanahalli,299250,42340,256910,0.8585129490392648,-1
4279,4280,Kalyan Nagar,352800,84700,268100,0.7599206349206349,-1
4280,4281,Horamavu,158500,71210,87290,0.5507255520504731,1
4281,4282,Jalahalli,291450,65370,226080,0.7757076685537828,-1
4282,4283,Hoodi,53200,43740,9460,0.17781954887218046,1
4283,4284,Jalahalli,353050,11470,341580,0.967511683897465,-1
4284,4285,Banaswadi,348250,61870,286380,0.8223402727925341,-1
4285,4286,Rajajinagar,65550,109930,-44380,-0.6770404271548436,1
4286,4287,Kalyan Nagar,132800,72890,59910,0.4511295180722892,0
4287,4288,Varthur,385850,40960,344890,0.8938447583257743,-1
4288,4289,Vasanth Nagar,124050,26660,97390,0.785086658605401,0
4289,4290,Kalyan Nagar,444550,22820,421730,0.9486671915420087,-1
4290,4291,HBR Layout,37250,110010,-72760,-1.953288590604027,1
4291,4292,Varthur,372600,47510,325090,0.8724906065485776,-1
4292,4293,Varthur,412950,60270,352680,0.8540501271340356,-1
4293,4294,Whitefield,190300,144490,45810,0.24072517078297426,1
4294,4295,Varthur,263650,35190,228460,0.8665275934003414,-1
4295,4296,Marathahalli,133100,31780,101320,0.7612321562734786,0
4296,4297,Rajajinagar,392950,94810,298140,0.7587224837765619,0
4297,4298,Krishnarajapuram,179750,88730,91020,0.5063699582753824,1
4298,4299,Varthur,414700,61420,353280,0.8518929346515554,-1
4299,4300,CV Raman Nagar,193850,60170,133680,0.6896053649729172,0
4300,4301,Hebbal,381400,13870,367530,0.9636339800734137,-1
4301,4302,Hoodi,167550,116600,50950,0.3040883318412414,1
4302,4303,Varthur,170400,31160,139240,0.8171361502347417,-1
4303,4304,Hebbal,98350,107550,-9200,-0.09354346720894764,1
4304,4305,Vasanth Nagar,360050,95370,264680,0.7351201222052492,0
4305,4306,Hoodi,58150,51430,6720,0.11556319862424763,1
4306,4307,Hebbal,109400,113810,-4410,-0.040310786106032906,1
4307,4308,Banaswadi,441500,51220,390280,0.883986409966025,-1
4308,4309,Horamavu,154600,81320,73280,0.47399741267787837,0
4309,4310,Rajajinagar,240050,54770,185280,0.771839200166632,-1
4310,4311,Varthur,346750,74760,271990,0.7843979812545061,0
4311,4312,Kalyan Nagar,177400,44920,132480,0.7467869222096956,0
4312,4313,CV Raman Nagar,183700,130960,52740,0.2870985302123027,1
4313,4314,Rajajinagar,117950,104390,13560,0.11496396778295888,1
4314,4315,Varthur,193150,80130,113020,0.5851410820605747,0
4315,4316,CV Raman Nagar,371700,85650,286050,0.7695722356739306,0
4316,4317,Krishnarajapuram,162800,67170,95630,0.5874078624078624,1
4317,4318,Kammanahalli,415950,70450,345500,0.8306286813318908,0
4318,4319,Shivajinagar,47400,34300,13100,0.27637130801687765,1
4319,4320,Hebbal,449450,66850,382600,0.8512626543553232,-1
4320,4321,Jalahalli,157800,87640,70160,0.44461343472750314,1
4321,4322,Indiranagar,107250,62200,45050,0.42004662004662,0
4322,4323,Krishnarajapuram,342350,82100,260250,0.7601869431867971,-1
4323,4324,HBR Layout,246250,68580,177670,0.721502538071066,-1
4324,4325,Mahadevapura,441150,66210,374940,0.849914994899694,-1
4325,4326,Kalyan Nagar,104800,76950,27850,0.2657442748091603,1
4326,4327,Marathahalli,77050,61760,15290,0.19844256975989616,1
4327,4328,Hebbal,436350,101380,334970,0.767663572819984,-1
4328,4329,Kalyan Nagar,328400,53790,274610,0.8362058465286236,0
4329,4330,HBR Layout,417400,20420,396980,0.9510781025395304,-1
4330,4331,Jalahalli,63500,61980,1520,0.02393700787401575,1
4331,4332,Krishnarajapuram,147300,5550,141750,0.9623217922606925,-1
4332,4333,Mahadevapura,139850,47560,92290,0.6599213442974615,0
4333,4334,Mahadevapura,61000,70090,-9090,-0.14901639344262296,1
4334,4335,Malleswaram,36850,87220,-50370,-1.3668928086838534,1
4335,4336,Jalahalli,49800,47850,1950,0.0391566265060241,1
4336,4337,Varthur,46050,65360,-19310,-0.4193268186753529,1
4337,4338,Banaswadi,105700,125730,-20030,-0.18949858088930938,1
4338,4339,Indiranagar,191400,56990,134410,0.7022466039707419,0
4339,4340,Banaswadi,407300,98450,308850,0.7582862754726246,0
4340,4341,Vasanth Nagar,60500,62060,-1560,-0.025785123966942148,1
4341,4342,CV Raman Nagar,317950,48600,269350,0.8471457776379934,-1
4342,4343,Horamavu,390050,60420,329630,0.8450967824637867,-1
4343,4344,Mahadevapura,282550,41740,240810,0.8522739338170235,0
4344,4345,Horamavu,410050,60490,349560,0.852481404706743,-1
4345,4346,Varthur,306450,47380,259070,0.8453907652145538,0
4346,4347,Indiranagar,357300,60060,297240,0.8319059613769941,-1
4347,4348,Hebbal,109050,50670,58380,0.5353507565337001,1
4348,4349,Vasanth Nagar,98200,50780,47420,0.4828920570264766,1
4349,4350,HBR Layout,358400,68250,290150,0.8095703125,0
4350,4351,Kammanahalli,387550,50320,337230,0.8701586892013934,-1
4351,4352,CV Raman Nagar,243100,9230,233870,0.9620320855614973,-1
4352,4353,Rajajinagar,228800,59360,169440,0.7405594405594406,0
4353,4354,Krishnarajapuram,169100,90020,79080,0.46765227675931403,0
4354,4355,Horamavu,348900,105010,243890,0.6990255087417598,0
4355,4356,Hoodi,360350,69290,291060,0.8077147217982517,-1
4356,4357,Indiranagar,79700,134080,-54380,-0.6823086574654956,1
4357,4358,Malleswaram,132350,52070,80280,0.6065734794106535,0
4358,4359,Horamavu,359000,59760,299240,0.8335376044568246,-1
4359,4360,Malleswaram,30950,24670,6280,0.20290791599353797,1
4360,4361,Horamavu,223800,115740,108060,0.48284182305630025,0
4361,4362,Whitefield,264850,78690,186160,0.7028884274117425,0
4362,4363,Horamavu,395450,72430,323020,0.8168415728916424,0
4363,4364,Hebbal,129650,76630,53020,0.40894716544543,0
4364,4365,Banaswadi,254300,120100,134200,0.5277231616201337,0
4365,4366,Mahadevapura,204600,22150,182450,0.8917399804496579,-1
4366,4367,Malleswaram,76650,32730,43920,0.5729941291585127,0
4367,4368,Rajajinagar,109800,102520,7280,0.06630236794171221,1
4368,4369,Banaswadi,362800,164880,197920,0.5455347298787211,0
4369,4370,Hoodi,236650,78530,158120,0.6681597295584196,0
4370,4371,Jalahalli,385550,47560,337990,0.8766437556737129,-1
4371,4372,Krishnarajapuram,64800,113840,-49040,-0.7567901234567901,1
4372,4373,Horamavu,113050,57650,55400,0.4900486510393631,1
4373,4374,HBR Layout,46050,139520,-93470,-2.0297502714440827,1
4374,4375,Vasanth Nagar,428950,40270,388680,0.9061195943583168,-1
4375,4376,Marathahalli,345250,58780,286470,0.8297465604634323,-1
4376,4377,Marathahalli,253200,33030,220170,0.8695497630331753,-1
4377,4378,Mahadevapura,422650,114570,308080,0.7289246421388856,0
4378,4379,Krishnarajapuram,448150,79920,368230,0.8216668526163114,0
4379,4380,Marathahalli,113500,74820,38680,0.34079295154185024,1
4380,4381,Whitefield,73400,51220,22180,0.3021798365122616,1
4381,4382,Malleswaram,439150,41350,397800,0.9058408288739611,-1
4382,4383,Jalahalli,207500,99050,108450,0.5226506024096386,1
4383,4384,Kammanahalli,386850,66950,319900,0.8269355047175908,-1
4384,4385,Hebbal,257600,135740,121860,0.47305900621118013,0
4385,4386,Krishnarajapuram,238150,118020,120130,0.504429981104346,0
4386,4387,Hoodi,426900,7510,419390,0.9824080580932303,-1
4387,4388,Vasanth Nagar,249950,81490,168460,0.6739747949589918,0
4388,4389,Kalyan Nagar,62100,115390,-53290,-0.8581320450885668,1
4389,4390,Shivajinagar,45600,28170,17430,0.38223684210526315,1
4390,4391,Shivajinagar,89700,175400,-85700,-0.955406911928651,1
4391,4392,Varthur,270800,37890,232910,0.8600812407680946,0
4392,4393,CV Raman Nagar,310900,39920,270980,0.8715985847539401,-1
4393,4394,Krishnarajapuram,388700,65310,323390,0.8319783895034731,-1
4394,4395,Malleswaram,219000,108970,110030,0.502420091324201,0
4395,4396,Jalahalli,74500,51580,22920,0.3076510067114094,1
4396,4397,Banaswadi,266200,40250,225950,0.8487978963185575,0
4397,4398,Mahadevapura,72650,91430,-18780,-0.2584996558843772,1
4398,4399,Kammanahalli,179450,60710,118740,0.6616884926163277,0
4399,4400,Varthur,187950,76990,110960,0.5903697791965948,0
4400,4401,Kalyan Nagar,75550,112620,-37070,-0.49066843150231637,1
4401,4402,Whitefield,261750,84760,176990,0.6761795606494747,0
4402,4403,CV Raman Nagar,398550,72760,325790,0.8174382135240246,-1
4403,4404,Krishnarajapuram,322900,12070,310830,0.9626200061938681,-1
4404,4405,Mahadevapura,413500,42620,370880,0.8969286577992744,-1
4405,4406,Hebbal,149700,63650,86050,0.5748162992651971,0
4406,4407,Indiranagar,408150,24780,383370,0.939287026828372,-1
4407,4408,CV Raman Nagar,220450,45080,175370,0.7955091857564074,0
4408,4409,Malleswaram,274400,102430,171970,0.6267128279883382,0
4409,4410,Krishnarajapuram,441350,37410,403940,0.915237339979608,-1
4410,4411,Whitefield,25650,88770,-63120,-2.4608187134502923,1
4411,4412,Kammanahalli,298800,63080,235720,0.7888888888888889,0
4412,4413,Malleswaram,280800,38610,242190,0.8625,-1
4413,4414,Vasanth Nagar,352750,33320,319430,0.9055421686746988,-1
4414,4415,HBR Layout,293850,96490,197360,0.6716351880210992,0
4415,4416,Varthur,283800,44480,239320,0.8432699083861874,-1
4416,4417,Banaswadi,44850,96650,-51800,-1.1549609810479375,1
4417,4418,Rajajinagar,347100,44280,302820,0.872428694900605,-1
4418,4419,Hebbal,135250,31150,104100,0.7696857670979668,-1
4419,4420,Malleswaram,157500,45430,112070,0.7115555555555556,-1
4420,4421,Whitefield,238300,56870,181430,0.7613512379353756,0
4421,4422,Kalyan Nagar,109400,57480,51920,0.47458866544789763,1
4422,4423,Varthur,395650,57570,338080,0.8544926071022368,0
4423,4424,HBR Layout,404950,45400,359550,0.887887393505371,-1
4424,4425,CV Raman Nagar,264350,66070,198280,0.7500662001134859,-1
4425,4426,Hoodi,389300,52860,336440,0.8642178268687387,-1
4426,4427,Malleswaram,67250,47240,20010,0.29754646840148696,1
4427,4428,Hebbal,372100,110600,261500,0.7027680730986294,0
4428,4429,Vasanth Nagar,82900,73370,9530,0.11495778045838359,1
4429,4430,Indiranagar,404950,62920,342030,0.8446227929373997,-1
4430,4431,Marathahalli,279550,76240,203310,0.7272759792523699,0
4431,4432,Kalyan Nagar,41650,63390,-21740,-0.521968787515006,1
4432,4433,Mahadevapura,288600,104420,184180,0.6381843381843382,0
4433,4434,Vasanth Nagar,307450,8720,298730,0.9716376646609205,-1
4434,4435,Jalahalli,345000,69640,275360,0.7981449275362319,-1
4435,4436,Krishnarajapuram,441550,19070,422480,0.956811233155928,-1
4436,4437,Rajajinagar,128200,47280,80920,0.631201248049922,0
4437,4438,Banaswadi,257850,100800,157050,0.6090750436300174,0
4438,4439,Rajajinagar,158550,90040,68510,0.43210343740145063,1
4439,4440,Horamavu,89800,147460,-57660,-0.6420935412026726,1
4440,4441,Jalahalli,387250,50800,336450,0.8688185926404132,-1
4441,4442,Kammanahalli,306200,131000,175200,0.5721750489875899,1
4442,4443,Malleswaram,308350,157210,151140,0.49015728879520026,1
4443,4444,Krishnarajapuram,345900,83510,262390,0.7585718415727088,0
4444,4445,Shivajinagar,293750,53410,240340,0.8181787234042553,0
4445,4446,Banaswadi,297000,89750,207250,0.6978114478114478,0
4446,4447,Varthur,231500,88350,143150,0.6183585313174946,0
4447,4448,Indiranagar,51200,92210,-41010,-0.8009765625,1
4448,4449,Banaswadi,60150,76290,-16140,-0.2683291770573566,1
4449,4450,Marathahalli,301450,94380,207070,0.6869132526123736,0
4450,4451,Malleswaram,217750,23410,194340,0.8924913892078071,-1
4451,4452,Vasanth Nagar,295550,44740,250810,0.8486212146844866,-1
4452,4453,HBR Layout,205550,80400,125150,0.60885429335928,0
4453,4454,Krishnarajapuram,219150,62130,157020,0.7164955509924709,0
4454,4455,Indiranagar,400000,110590,289410,0.723525,0
4455,4456,Indiranagar,198400,64800,133600,0.6733870967741935,0
4456,4457,Shivajinagar,239850,23780,216070,0.9008547008547009,-1
4457,4458,Kalyan Nagar,177950,100460,77490,0.4354593987075021,1
4458,4459,Indiranagar,214300,119850,94450,0.4407372841810546,1
4459,4460,Jalahalli,119400,16640,102760,0.8606365159128978,-1
4460,4461,Whitefield,363850,47010,316840,0.8707984059365123,-1
4461,4462,Kalyan Nagar,44500,18870,25630,0.5759550561797753,1
4462,4463,Kalyan Nagar,357450,33470,323980,0.9063645265072038,-1
4463,4464,Krishnarajapuram,149100,52260,96840,0.6494969818913481,0
4464,4465,Marathahalli,148100,85680,62420,0.42147197839297773,1
4465,4466,Mahadevapura,433550,58570,374980,0.8649060085341944,0
4466,4467,Shivajinagar,122400,61970,60430,0.4937091503267974,1
4467,4468,Marathahalli,320200,105860,214340,0.6693941286695815,0
4468,4469,Krishnarajapuram,138050,49800,88250,0.6392611372691054,0
4469,4470,Hebbal,411400,94860,316540,0.7694214876033058,0
4470,4471,Kalyan Nagar,41150,95850,-54700,-1.3292831105710814,1
4471,4472,Kammanahalli,177150,75820,101330,0.5720011289867344,0
4472,4473,HBR Layout,95200,62180,33020,0.3468487394957983,1
4473,4474,Whitefield,250100,24370,225730,0.9025589764094363,-1
4474,4475,Whitefield,426550,83840,342710,0.8034462548353065,-1
4475,4476,Rajajinagar,381100,61660,319440,0.8382051954867489,-1
4476,4477,Indiranagar,372250,44100,328150,0.8815312290127603,-1
4477,4478,Rajajinagar,190800,37690,153110,0.8024633123689727,0
4478,4479,Rajajinagar,345250,16250,329000,0.9529326574945691,-1
4479,4480,Shivajinagar,361450,68400,293050,0.8107622077742427,0
4480,4481,Kammanahalli,399350,38920,360430,0.9025416301489921,-1
4481,4482,Kalyan Nagar,324200,44820,279380,0.8617520049352252,-1
4482,4483,HBR Layout,255700,61460,194240,0.7596402033633164,0
4483,4484,Varthur,258950,34630,224320,0.8662676192315119,0
4484,4485,Krishnarajapuram,436750,38810,397940,0.9111390955924442,-1
4485,4486,Whitefield,151400,111130,40270,0.26598414795244385,1
4486,4487,Mahadevapura,449250,44780,404470,0.9003227601558152,-1
4487,4488,Horamavu,215500,106130,109370,0.5075174013921113,1
4488,4489,Marathahalli,104250,57670,46580,0.446810551558753,0
4489,4490,Kalyan Nagar,351350,90170,261180,0.7433613206204639,0
4490,4491,HBR Layout,310300,56950,253350,0.8164679342571705,0
4491,4492,HBR Layout,425700,60470,365230,0.8579516091143998,-1
4492,4493,Jalahalli,104150,66970,37180,0.356985117618819,1
4493,4494,Indiranagar,78850,61420,17430,0.22105263157894736,1
4494,4495,Jalahalli,242600,95540,147060,0.6061830173124485,0
4495,4496,Shivajinagar,59500,93530,-34030,-0.5719327731092437,1
4496,4497,Varthur,219600,70500,149100,0.6789617486338798,0
4497,4498,Whitefield,301650,60330,241320,0.8,0
4498,4499,Kammanahalli,44100,47880,-3780,-0.08571428571428572,1
4499,4500,Kammanahalli,55950,66560,-10610,-0.1896336014298481,1
4500,4501,Vasanth Nagar,36700,66320,-29620,-0.8070844686648502,1
4501,4502,Malleswaram,88400,9240,79160,0.895475113122172,-1
4502,4503,Banaswadi,282150,63430,218720,0.775190501506291,0
4503,4504,Malleswaram,301600,79700,221900,0.7357427055702918,-1
4504,4505,Banaswadi,197500,37930,159570,0.8079493670886075,0
4505,4506,Marathahalli,113450,72850,40600,0.35786690171881885,1
4506,4507,HBR Layout,249700,87810,161890,0.648338005606728,0
4507,4508,Indiranagar,294550,31350,263200,0.8935664573077576,-1
4508,4509,Malleswaram,429900,93110,336790,0.7834147476157246,0
4509,4510,Kalyan Nagar,384050,95760,288290,0.7506574664757193,0
4510,4511,CV Raman Nagar,181250,124470,56780,0.31326896551724137,1
4511,4512,Hoodi,287300,34680,252620,0.8792899408284024,0
4512,4513,CV Raman Nagar,51400,89280,-37880,-0.7369649805447471,1
4513,4514,Vasanth Nagar,132200,31340,100860,0.7629349470499244,0
4514,4515,Hoodi,379450,87720,291730,0.7688232968770589,0
4515,4516,Horamavu,157950,58820,99130,0.6276036720481165,0
4516,4517,Hebbal,435250,35520,399730,0.9183917288914417,-1
4517,4518,Banaswadi,117700,67390,50310,0.4274426508071368,1
4518,4519,Malleswaram,112600,43520,69080,0.6134991119005329,0
4519,4520,Banaswadi,360300,95310,264990,0.7354704412989176,-1
4520,4521,Banaswadi,174250,38150,136100,0.7810616929698708,-1
4521,4522,HBR Layout,224200,78560,145640,0.6495985727029439,0
4522,4523,Vasanth Nagar,259750,24300,235450,0.9064485081809432,-1
4523,4524,Hoodi,201900,12200,189700,0.9395740465577018,-1
4524,4525,Jalahalli,82750,91610,-8860,-0.10706948640483384,1
4525,4526,Krishnarajapuram,391850,57830,334020,0.8524180170983795,-1
4526,4527,Rajajinagar,205800,58420,147380,0.7161321671525753,-1
4527,4528,Marathahalli,121950,78760,43190,0.35416154161541613,1
4528,4529,Rajajinagar,387150,74840,312310,0.8066899134702312,0
4529,4530,Vasanth Nagar,278500,33940,244560,0.878132854578097,-1
4530,4531,Kammanahalli,413950,29030,384920,0.9298707573378427,-1
4531,4532,Indiranagar,222600,132550,90050,0.4045372866127583,1
4532,4533,CV Raman Nagar,84600,32610,51990,0.6145390070921986,0
4533,4534,Varthur,243700,23830,219870,0.9022158391464916,-1
4534,4535,Hoodi,402200,99390,302810,0.7528841372451517,0
4535,4536,Shivajinagar,385450,17250,368200,0.955247113763134,-1
4536,4537,Hoodi,144700,81450,63250,0.43711126468555633,1
4537,4538,Marathahalli,216450,5140,211310,0.9762531762531762,-1
4538,4539,Mahadevapura,256500,32220,224280,0.8743859649122807,-1
4539,4540,Mahadevapura,401050,51670,349380,0.8711631966089016,-1
4540,4541,CV Raman Nagar,25000,54070,-29070,-1.1628,1
4541,4542,Jalahalli,25450,78880,-53430,-2.099410609037328,1
4542,4543,Malleswaram,380000,62680,317320,0.8350526315789474,-1
4543,4544,Banaswadi,366150,39370,326780,0.8924757613000136,-1
4544,4545,Hebbal,182600,30170,152430,0.834775465498357,0
4545,4546,Horamavu,55950,33250,22700,0.40571939231456655,0
4546,4547,Whitefield,358600,10650,347950,0.9703011712214166,-1
4547,4548,Whitefield,443450,33440,410010,0.9245912729732777,-1
4548,4549,Kalyan Nagar,427500,46270,381230,0.891766081871345,0
4549,4550,Banaswadi,415650,40210,375440,0.9032599542884638,-1
4550,4551,Shivajinagar,421550,74900,346650,0.8223223816866326,0
4551,4552,Hebbal,258600,78940,179660,0.6947409126063419,0
4552,4553,Mahadevapura,281100,94170,186930,0.6649946638207044,0
4553,4554,Vasanth Nagar,298650,81600,217050,0.7267704671019588,-1
4554,4555,Rajajinagar,265800,64180,201620,0.7585402558314522,0
4555,4556,Shivajinagar,335600,37070,298530,0.8895411203814064,-1
4556,4557,Marathahalli,100700,22910,77790,0.7724925521350546,0
4557,4558,Banaswadi,430200,36360,393840,0.9154811715481171,-1
4558,4559,Marathahalli,185750,76820,108930,0.5864333781965007,1
4559,4560,HBR Layout,192100,34800,157300,0.818844351900052,-1
4560,4561,Mahadevapura,405500,22820,382680,0.9437237977805178,-1
4561,4562,Kalyan Nagar,291400,41950,249450,0.8560398078242965,0
4562,4563,CV Raman Nagar,235750,43050,192700,0.8173913043478261,-1
4563,4564,Rajajinagar,423500,46370,377130,0.8905076741440378,-1
4564,4565,Whitefield,148600,39320,109280,0.7353970390309555,0
4565,4566,Horamavu,438450,67120,371330,0.8469152697000798,0
4566,4567,Marathahalli,357000,26500,330500,0.9257703081232493,-1
4567,4568,Marathahalli,323100,45380,277720,0.8595481275147013,-1
4568,4569,Malleswaram,146300,65610,80690,0.5515379357484621,0
4569,4570,HBR Layout,280350,70040,210310,0.7501694310683075,0
4570,4571,Varthur,304400,48640,255760,0.8402102496714849,-1
4571,4572,Whitefield,79600,22210,57390,0.7209798994974874,0
4572,4573,CV Raman Nagar,170950,31320,139630,0.816788534659257,0
4573,4574,Mahadevapura,49950,100540,-50590,-1.0128128128128129,1
4574,4575,Varthur,60300,116590,-56290,-0.9334991708126037,1
4575,4576,CV Raman Nagar,426200,66390,359810,0.8442280619427499,-1
4576,4577,Banaswadi,41900,49470,-7570,-0.18066825775656326,1
4577,4578,Varthur,61250,72040,-10790,-0.17616326530612245,1
4578,4579,Indiranagar,185300,86860,98440,0.5312466270912034,0
4579,4580,Krishnarajapuram,37200,80180,-42980,-1.1553763440860214,1
4580,4581,Horamavu,136100,31650,104450,0.7674504041146216,-1
4581,4582,HBR Layout,124000,58470,65530,0.5284677419354838,0
4582,4583,Varthur,139600,35250,104350,0.7474928366762178,-1
4583,4584,Rajajinagar,294600,62340,232260,0.7883910386965377,0
4584,4585,Indiranagar,434800,7900,426900,0.9818307267709292,-1
4585,4586,Varthur,294900,32990,261910,0.8881315700237369,0
4586,4587,Malleswaram,208750,79740,129010,0.6180119760479041,0
4587,4588,Varthur,228600,84710,143890,0.6294400699912511,0
4588,4589,Rajajinagar,324850,46600,278250,0.8565491765430199,0
4589,4590,Krishnarajapuram,248900,72070,176830,0.7104459622338288,0
4590,4591,Hebbal,204300,25380,178920,0.8757709251101321,-1
4591,4592,Hoodi,104150,44560,59590,0.5721555448871819,0
4592,4593,Varthur,393350,121970,271380,0.6899199186475149,0
4593,4594,Shivajinagar,263200,18900,244300,0.9281914893617021,-1
4594,4595,Marathahalli,75000,63210,11790,0.1572,1
4595,4596,HBR Layout,229650,49850,179800,0.7829305464837797,0
4596,4597,Hoodi,100550,85170,15380,0.1529587270014918,1
4597,4598,Marathahalli,304600,136610,167990,0.551510177281681,1
4598,4599,HBR Layout,235200,9050,226150,0.9615221088435374,-1
4599,4600,Varthur,298600,59120,239480,0.8020093770931012,-1
4600,4601,Marathahalli,90100,52970,37130,0.4120976692563818,0
4601,4602,Horamavu,44500,88690,-44190,-0.9930337078651685,1
4602,4603,Marathahalli,225900,64840,161060,0.7129703408587871,0
4603,4604,Rajajinagar,91350,46570,44780,0.4902025177887247,1
4604,4605,Krishnarajapuram,197850,69440,128410,0.6490270406873895,0
4605,4606,Kalyan Nagar,157000,47770,109230,0.6957324840764331,0
4606,4607,Kalyan Nagar,62850,61980,870,0.013842482100238664,1
4607,4608,Kammanahalli,283350,58340,225010,0.7941062290453502,0
4608,4609,Malleswaram,168600,27450,141150,0.8371886120996441,-1
4609,4610,Shivajinagar,184900,59990,124910,0.6755543537047053,0
4610,4611,Horamavu,139950,143970,-4020,-0.02872454448017149,1
4611,4612,Rajajinagar,42450,61710,-19260,-0.45371024734982335,1
4612,4613,Mahadevapura,442300,84530,357770,0.8088853719195116,0
4613,4614,Indiranagar,239400,127060,112340,0.4692564745196324,1
4614,4615,Kalyan Nagar,130650,83270,47380,0.3626482969766552,1
4615,4616,CV Raman Nagar,324050,86540,237510,0.7329424471532171,0
4616,4617,Vasanth Nagar,392250,13310,378940,0.9660675589547483,-1
4617,4618,Banaswadi,307100,39470,267630,0.8714750895473787,-1
4618,4619,Indiranagar,341600,24240,317360,0.92903981264637,-1
4619,4620,Kalyan Nagar,50200,10410,39790,0.7926294820717131,0
4620,4621,Kalyan Nagar,448050,103710,344340,0.7685302979578172,-1
4621,4622,Whitefield,396750,28950,367800,0.9270321361058601,-1
4622,4623,Vasanth Nagar,151250,65340,85910,0.568,0
4623,4624,Kammanahalli,132300,88300,44000,0.3325774754346183,1
4624,4625,Kalyan Nagar,63800,68690,-4890,-0.07664576802507837,1
4625,4626,Rajajinagar,227450,57330,170120,0.7479446032094966,0
4626,4627,Kalyan Nagar,262400,99310,163090,0.621532012195122,0
4627,4628,HBR Layout,180000,11950,168050,0.9336111111111111,-1
4628,4629,Hoodi,251050,74730,176320,0.7023302131049591,0
4629,4630,Kammanahalli,240400,138710,101690,0.42300332778702165,1
4630,4631,Vasanth Nagar,133300,68360,64940,0.48717179294823704,0
4631,4632,Kalyan Nagar,56050,80930,-24880,-0.4438893844781445,1
4632,4633,Whitefield,79100,72560,6540,0.08268015170670039,1
4633,4634,Krishnarajapuram,196650,67140,129510,0.6585812356979405,0
4634,4635,Hoodi,63350,26550,36800,0.5808997632202052,1
4635,4636,Hebbal,161300,89200,72100,0.44699318040917546,1
4636,4637,Malleswaram,310650,134650,176000,0.5665539996780943,0
4637,4638,Marathahalli,181650,109100,72550,0.3993944398568676,1
4638,4639,Kammanahalli,424650,47570,377080,0.8879783350994938,-1
4639,4640,Hoodi,265400,13890,251510,0.9476639035418236,-1
4640,4641,Malleswaram,51050,99250,-48200,-0.9441723800195886,1
4641,4642,Mahadevapura,356600,90540,266060,0.7461020751542344,-1
4642,4643,HBR Layout,286650,23970,262680,0.916378859236002,-1
4643,4644,Shivajinagar,295300,101590,193710,0.6559769725702675,0
4644,4645,Malleswaram,381550,74260,307290,0.80537282138645,0
4645,4646,Hebbal,378050,76190,301860,0.7984658114006083,-1
4646,4647,Horamavu,135300,119780,15520,0.11470805617147081,1
4647,4648,Rajajinagar,407350,79920,327430,0.8038050816251381,-1
4648,4649,Krishnarajapuram,298000,55680,242320,0.8131543624161074,-1
4649,4650,Kalyan Nagar,445100,39680,405420,0.9108514940462817,-1
4650,4651,Indiranagar,164900,64170,100730,0.6108550636749546,0
4651,4652,Krishnarajapuram,374800,53550,321250,0.8571237993596584,-1
4652,4653,Shivajinagar,247800,46940,200860,0.8105730427764326,-1
4653,4654,Horamavu,99250,119830,-20580,-0.2073551637279597,1
4654,4655,Shivajinagar,230250,37410,192840,0.8375244299674267,0
4655,4656,CV Raman Nagar,129550,55820,73730,0.5691238903898109,0
4656,4657,Shivajinagar,133250,55400,77850,0.5842401500938086,0
4657,4658,Varthur,242700,92370,150330,0.619406674907293,0
4658,4659,Mahadevapura,163450,61010,102440,0.6267360048944631,0
4659,4660,Rajajinagar,187650,106790,80860,0.4309086064481748,0
4660,4661,Jalahalli,407650,32400,375250,0.9205200539678646,-1
4661,4662,Mahadevapura,379150,31540,347610,0.9168139258868522,-1
4662,4663,Krishnarajapuram,317150,44160,272990,0.8607598927952073,0
4663,4664,HBR Layout,365950,76290,289660,0.7915288973903539,0
4664,4665,Hebbal,306500,56280,250220,0.8163784665579119,0
4665,4666,Hebbal,192800,1740,191060,0.9909751037344399,-1
4666,4667,Kalyan Nagar,36100,36550,-450,-0.012465373961218837,1
4667,4668,Rajajinagar,319200,64720,254480,0.7972431077694235,-1
4668,4669,Shivajinagar,337550,17710,319840,0.947533698711302,-1
4669,4670,Hebbal,131500,72260,59240,0.45049429657794676,1
4670,4671,Mahadevapura,204300,74910,129390,0.6333333333333333,0
4671,4672,Kammanahalli,230550,40450,190100,0.8245499891563652,-1
4672,4673,Hoodi,432250,58310,373940,0.8651012145748987,0
4673,4674,Mahadevapura,364250,89380,274870,0.7546190803019904,0
4674,4675,Hebbal,140150,14340,125810,0.8976810560114163,-1
4675,4676,Hebbal,78750,60120,18630,0.23657142857142857,1
4676,4677,Whitefield,68250,14940,53310,0.7810989010989011,0
4677,4678,Horamavu,144200,75980,68220,0.4730929264909847,1
4678,4679,Hebbal,348250,80120,268130,0.7699353912419239,-1
4679,4680,Varthur,399600,72970,326630,0.8173923923923924,-1
4680,4681,Banaswadi,352400,60380,292020,0.8286606129398411,-1
4681,4682,Whitefield,183300,62250,121050,0.660392798690671,0
4682,4683,Hoodi,25800,53370,-27570,-1.0686046511627907,1
4683,4684,Indiranagar,164700,54360,110340,0.6699453551912569,0
4684,4685,Mahadevapura,383250,48640,334610,0.873085453359426,0
4685,4686,Varthur,313350,54480,258870,0.8261369076112973,-1
4686,4687,Hoodi,254850,28810,226040,0.8869531096723563,-1
4687,4688,Krishnarajapuram,87500,71870,15630,0.17862857142857144,1
4688,4689,Krishnarajapuram,65250,64460,790,0.01210727969348659,1
4689,4690,Hebbal,153050,0,153050,1.0,-1
4690,4691,Horamavu,62050,24360,37690,0.6074133763094279,0
4691,4692,Kammanahalli,276200,102150,174050,0.6301593048515568,0
4692,4693,Banaswadi,91250,63270,27980,0.30663013698630137,1
4693,4694,Malleswaram,329050,70060,258990,0.7870840297827078,0
4694,4695,Mahadevapura,231750,54360,177390,0.7654368932038835,-1
4695,4696,Indiranagar,382650,18690,363960,0.951156409251274,-1
4696,4697,Malleswaram,204450,46670,157780,0.77172902910247,0
4697,4698,Varthur,373750,47280,326470,0.8734983277591973,0
4698,4699,Hoodi,393950,67910,326040,0.8276177179845158,-1
4699,4700,Banaswadi,158150,105870,52280,0.3305722415428391,1
4700,4701,Horamavu,242600,104390,138210,0.5697032151690025,0
4701,4702,Krishnarajapuram,178300,53440,124860,0.7002804262478968,-1
4702,4703,Horamavu,132350,47780,84570,0.6389875330562902,0
4703,4704,Shivajinagar,70550,30450,40100,0.5683912119064494,0
4704,4705,Jalahalli,304450,55270,249180,0.8184595171620955,-1
4705,4706,Vasanth Nagar,402000,84240,317760,0.7904477611940298,-1
4706,4707,Mahadevapura,224950,65050,159900,0.7108246276950434,0
4707,4708,Banaswadi,190200,95620,94580,0.49726603575184014,0
4708,4709,Rajajinagar,266100,56150,209950,0.788989101841413,0
4709,4710,Indiranagar,300850,144670,156180,0.5191291341199934,0
4710,4711,Shivajinagar,322850,48500,274350,0.8497754375096794,-1
4711,4712,Vasanth Nagar,144950,39370,105580,0.7283890996895481,0
4712,4713,Hebbal,280350,21300,259050,0.9240235420010701,-1
4713,4714,Horamavu,71900,54570,17330,0.24102920723226703,1
4714,4715,Varthur,286350,58730,227620,0.7949013445084686,0
4715,4716,Marathahalli,395550,130850,264700,0.6691947920616863,0
4716,4717,Hoodi,292550,34140,258410,0.8833019996581781,-1
4717,4718,HBR Layout,217300,56410,160890,0.7404049700874368,-1
4718,4719,Kammanahalli,43000,89140,-46140,-1.0730232558139534,1
4719,4720,Kalyan Nagar,210850,125590,85260,0.4043632914394119,1
4720,4721,CV Raman Nagar,45400,79300,-33900,-0.7466960352422908,1
4721,4722,Krishnarajapuram,258200,70430,187770,0.7272269558481798,-1
4722,4723,Kalyan Nagar,110650,30660,79990,0.722910076818798,0
4723,4724,Hoodi,246950,55570,191380,0.7749746912330431,-1
4724,4725,Hebbal,198550,25390,173160,0.872122890959456,-1
4725,4726,Krishnarajapuram,75500,59390,16110,0.2133774834437086,1
4726,4727,Varthur,127400,43980,83420,0.6547880690737834,0
4727,4728,Mahadevapura,265300,66890,198410,0.7478703354692801,-1
4728,4729,CV Raman Nagar,227050,48010,179040,0.7885487778022462,0
4729,4730,HBR Layout,336050,47400,288650,0.8589495610772206,-1
4730,4731,Hebbal,168300,72290,96010,0.5704693998811646,0
4731,4732,Marathahalli,212300,155980,56320,0.26528497409326424,1
4732,4733,Banaswadi,299650,0,299650,1.0,-1
4733,4734,Mahadevapura,242300,19980,222320,0.9175402393726785,-1
4734,4735,Hoodi,321000,53500,267500,0.8333333333333334,-1
4735,4736,Shivajinagar,42450,48160,-5710,-0.13451118963486455,1
4736,4737,Jalahalli,46750,74650,-27900,-0.5967914438502674,1
4737,4738,Shivajinagar,305150,71000,234150,0.7673275438309028,-1
4738,4739,Malleswaram,426800,78570,348230,0.8159090909090909,0
4739,4740,Mahadevapura,332750,61770,270980,0.8143651389932381,-1
4740,4741,Marathahalli,237250,30590,206660,0.8710642781875658,-1
4741,4742,Mahadevapura,162250,56560,105690,0.651402157164869,0
4742,4743,Shivajinagar,85200,36570,48630,0.5707746478873239,0
4743,4744,Mahadevapura,311900,71600,240300,0.7704392433472267,-1
4744,4745,Banaswadi,319200,42900,276300,0.8656015037593985,-1
4745,4746,Horamavu,342450,97300,245150,0.7158709300627829,-1
4746,4747,HBR Layout,189750,118480,71270,0.37559947299077734,1
4747,4748,HBR Layout,260150,131430,128720,0.4947914664616567,1
4748,4749,Jalahalli,225750,92670,133080,0.5895016611295681,0
4749,4750,Hebbal,337600,70400,267200,0.7914691943127962,0
4750,4751,Horamavu,243600,104020,139580,0.5729885057471265,0
4751,4752,Marathahalli,26850,26210,640,0.023836126629422718,1
4752,4753,Krishnarajapuram,437250,56370,380880,0.8710806174957119,-1
4753,4754,Horamavu,323100,29430,293670,0.9089136490250697,-1
4754,4755,HBR Layout,46900,68810,-21910,-0.4671641791044776,1
4755,4756,Mahadevapura,193950,22570,171380,0.8836298014952307,-1
4756,4757,Marathahalli,388250,42050,346200,0.8916934964584675,0
4757,4758,Marathahalli,91700,53150,38550,0.42039258451472195,1
4758,4759,CV Raman Nagar,296550,116360,180190,0.6076209745405496,0
4759,4760,Whitefield,302150,35050,267100,0.883998014231342,-1
4760,4761,Marathahalli,356650,29830,326820,0.916360577597084,-1
4761,4762,Jalahalli,394150,44880,349270,0.8861347202841557,-1
4762,4763,Whitefield,34500,70050,-35550,-1.0304347826086957,1
4763,4764,Marathahalli,195600,34680,160920,0.8226993865030675,-1
4764,4765,Kammanahalli,212650,62440,150210,0.7063719727251352,-1
4765,4766,Rajajinagar,114600,14490,100110,0.8735602094240837,-1
4766,4767,Kammanahalli,69850,67940,1910,0.027344309234073015,1
4767,4768,Malleswaram,351550,70840,280710,0.7984923908405632,0
4768,4769,Rajajinagar,25250,32250,-7000,-0.27722772277227725,1
4769,4770,Indiranagar,444850,74330,370520,0.8329099696526919,-1
4770,4771,Malleswaram,289000,49880,239120,0.8274048442906574,-1
4771,4772,HBR Layout,233150,117850,115300,0.4945314175423547,1
4772,4773,Mahadevapura,195300,8910,186390,0.9543778801843318,-1
4773,4774,HBR Layout,446200,84460,361740,0.8107126848946661,0
4774,4775,Mahadevapura,155850,76120,79730,0.511581649021495,0
4775,4776,Malleswaram,200800,109950,90850,0.4524402390438247,1
4776,4777,Hoodi,218150,51050,167100,0.7659867063946826,0
4777,4778,Varthur,256650,51870,204780,0.797895967270602,-1
4778,4779,Whitefield,237400,39790,197610,0.8323925863521483,0
4779,4780,Shivajinagar,385950,75510,310440,0.8043528954527789,-1
4780,4781,Indiranagar,434850,29730,405120,0.9316315971024491,-1
4781,4782,Rajajinagar,41600,67860,-26260,-0.63125,1
4782,4783,Vasanth Nagar,274500,10740,263760,0.9608743169398907,-1
4783,4784,Mahadevapura,201850,94140,107710,0.5336140698538518,1
4784,4785,Mahadevapura,396350,114620,281730,0.7108111517598082,-1
4785,4786,Kalyan Nagar,50950,35240,15710,0.3083415112855741,1
4786,4787,Banaswadi,126000,26830,99170,0.787063492063492,-1
4787,4788,HBR Layout,82850,37770,45080,0.544115872057936,0
4788,4789,HBR Layout,366950,100260,266690,0.7267747649543534,0
4789,4790,Whitefield,273400,127200,146200,0.53474762253109,0
4790,4791,Kalyan Nagar,397900,25720,372180,0.9353606433777331,-1
4791,4792,Krishnarajapuram,407700,99970,307730,0.7547951925435369,0
4792,4793,Indiranagar,44550,70670,-26120,-0.5863075196408529,1
4793,4794,Marathahalli,156050,37010,119040,0.7628324255046459,-1
4794,4795,HBR Layout,368450,61320,307130,0.8335730764011399,0
4795,4796,Malleswaram,78500,40200,38300,0.4878980891719745,1
4796,4797,Marathahalli,152200,70440,81760,0.5371879106438896,0
4797,4798,Rajajinagar,244150,37910,206240,0.8447266024984641,0
4798,4799,Kammanahalli,25550,54990,-29440,-1.1522504892367906,1
4799,4800,Kalyan Nagar,307500,116130,191370,0.6223414634146341,0
4800,4801,Varthur,249350,55930,193420,0.7756968117104471,0
4801,4802,Vasanth Nagar,338150,63220,274930,0.8130415496081621,-1
4802,4803,Hoodi,440700,34750,405950,0.9211481733605628,-1
4803,4804,Banaswadi,334950,97380,237570,0.709270040304523,0
4804,4805,Jalahalli,213300,65880,147420,0.6911392405063291,0
4805,4806,Jalahalli,247450,74430,173020,0.6992119620125278,0
4806,4807,Shivajinagar,182250,61310,120940,0.6635939643347051,0
4807,4808,Jalahalli,247750,38110,209640,0.846175580221998,-1
4808,4809,CV Raman Nagar,128100,36210,91890,0.7173302107728338,-1
4809,4810,Kammanahalli,39500,35210,4290,0.10860759493670886,1
4810,4811,CV Raman Nagar,439600,82770,356830,0.8117151956323931,-1
4811,4812,Jalahalli,84300,51700,32600,0.3867141162514828,1
4812,4813,Marathahalli,254600,56530,198070,0.7779654359780047,0
4813,4814,Mahadevapura,227600,60040,167560,0.7362038664323375,-1
4814,4815,Malleswaram,384350,29960,354390,0.9220502146481072,-1
4815,4816,Rajajinagar,136750,112600,24150,0.17659963436928702,1
4816,4817,Varthur,152250,16060,136190,0.8945155993431856,-1
4817,4818,Whitefield,280500,59850,220650,0.7866310160427807,0
4818,4819,Varthur,26000,77490,-51490,-1.9803846153846154,1
4819,4820,Indiranagar,81200,37150,44050,0.5424876847290641,0
4820,4821,Marathahalli,437350,75210,362140,0.8280324682748371,-1
4821,4822,Vasanth Nagar,110250,25020,85230,0.773061224489796,-1
4822,4823,Jalahalli,70200,55760,14440,0.2056980056980057,1
4823,4824,Hebbal,320150,18230,301920,0.9430579415898798,-1
4824,4825,Whitefield,220100,62000,158100,0.7183098591549296,0
4825,4826,Mahadevapura,177850,56670,121180,0.6813606972167557,0
4826,4827,Kammanahalli,358600,107990,250610,0.698856664807585,0
4827,4828,Vasanth Nagar,400200,100140,300060,0.7497751124437781,-1
4828,4829,Kammanahalli,78950,36390,42560,0.5390753641545282,1
4829,4830,Whitefield,386550,39600,346950,0.8975552968568102,-1
4830,4831,Shivajinagar,236100,89370,146730,0.6214739517153749,0
4831,4832,CV Raman Nagar,294750,69710,225040,0.7634944868532655,0
4832,4833,Hebbal,274750,67830,206920,0.7531210191082802,0
4833,4834,Horamavu,167250,45130,122120,0.7301644245142003,0
4834,4835,Jalahalli,286350,30970,255380,0.8918456434433386,-1
4835,4836,Whitefield,105650,21140,84510,0.7999053478466636,0
4836,4837,Malleswaram,318000,54680,263320,0.8280503144654088,-1
4837,4838,Rajajinagar,57350,74890,-17540,-0.3058413251961639,1
4838,4839,Rajajinagar,167450,64600,102850,0.6142131979695431,0
4839,4840,Hebbal,351600,46760,304840,0.8670079635949943,0
4840,4841,Jalahalli,249300,59290,190010,0.7621740874448456,-1
4841,4842,CV Raman Nagar,88900,67330,21570,0.24263217097862766,1
4842,4843,Hoodi,100700,29580,71120,0.7062562065541211,0
4843,4844,Mahadevapura,257350,46550,210800,0.8191179327763746,0
4844,4845,Mahadevapura,327000,108620,218380,0.66782874617737,0
4845,4846,Kalyan Nagar,225400,67720,157680,0.6995563442768412,0
4846,4847,Rajajinagar,179350,72900,106450,0.5935321996097017,0
4847,4848,Varthur,200900,63760,137140,0.6826281732205077,0
4848,4849,Whitefield,343150,112260,230890,0.6728544368352033,0
4849,4850,Vasanth Nagar,435400,34840,400560,0.9199816260909508,-1
4850,4851,Krishnarajapuram,75800,68310,7490,0.09881266490765171,1
4851,4852,Indiranagar,444600,114290,330310,0.7429374718848403,0
4852,4853,Krishnarajapuram,388900,53930,334970,0.8613268192337362,-1
4853,4854,Jalahalli,38100,76850,-38750,-1.0170603674540681,1
4854,4855,Banaswadi,55250,48700,6550,0.11855203619909502,1
4855,4856,Jalahalli,320000,71100,248900,0.7778125,0
4856,4857,Jalahalli,310250,125780,184470,0.5945850120870266,1
4857,4858,Malleswaram,399700,111500,288200,0.7210407805854391,-1
4858,4859,Horamavu,165400,114040,51360,0.3105199516324063,1
4859,4860,CV Raman Nagar,213900,33780,180120,0.8420757363253857,-1
4860,4861,Shivajinagar,68250,120830,-52580,-0.7704029304029304,1
4861,4862,CV Raman Nagar,66450,54150,12300,0.18510158013544017,1
4862,4863,Malleswaram,258550,111230,147320,0.5697930767743183,0
4863,4864,Rajajinagar,195700,56710,138990,0.7102197240674502,-1
4864,4865,Krishnarajapuram,351900,63810,288090,0.8186700767263427,0
4865,4866,Hebbal,315950,42030,273920,0.8669726222503561,-1
4866,4867,Marathahalli,172050,54410,117640,0.6837547224643998,0
4867,4868,Hoodi,287100,81440,205660,0.7163357715081853,0
4868,4869,Varthur,45350,80260,-34910,-0.7697905181918412,1
4869,4870,Kammanahalli,390050,64920,325130,0.8335598000256378,-1
4870,4871,Marathahalli,192150,46590,145560,0.7575331772053083,-1
4871,4872,Kammanahalli,399200,53680,345520,0.8655310621242485,0
4872,4873,Indiranagar,106300,10720,95580,0.8991533396048919,-1
4873,4874,Indiranagar,142400,63580,78820,0.5535112359550561,0
4874,4875,Varthur,83250,99420,-16170,-0.19423423423423422,1
4875,4876,Indiranagar,243050,36820,206230,0.8485085373379962,0
4876,4877,Kalyan Nagar,345750,73640,272110,0.7870137382501807,0
4877,4878,Varthur,220200,18120,202080,0.9177111716621253,-1
4878,4879,Hoodi,324450,31550,292900,0.9027585144089998,-1
4879,4880,Shivajinagar,415850,67070,348780,0.8387158831309366,-1
4880,4881,Marathahalli,133050,36400,96650,0.7264186396091695,0
4881,4882,Banaswadi,319750,33570,286180,0.8950117279124316,-1
4882,4883,Indiranagar,298500,68380,230120,0.7709212730318258,0
4883,4884,Kalyan Nagar,152900,52020,100880,0.6597776324395029,0
4884,4885,Marathahalli,38800,54570,-15770,-0.40644329896907216,1
4885,4886,Vasanth Nagar,151700,81470,70230,0.4629531970995386,1
4886,4887,Banaswadi,275750,47470,228280,0.8278513145965548,0
4887,4888,Kalyan Nagar,256800,26790,230010,0.8956775700934579,0
4888,4889,Banaswadi,423500,49460,374040,0.8832113341204251,-1
4889,4890,Krishnarajapuram,133500,6910,126590,0.9482397003745319,-1
4890,4891,Horamavu,183150,68110,115040,0.6281190281190281,0
4891,4892,Banaswadi,348700,32710,315990,0.9061944364783482,-1
4892,4893,Jalahalli,63850,81300,-17450,-0.27329678935003915,1
4893,4894,Jalahalli,204350,33470,170880,0.836212380719354,-1
4894,4895,Vasanth Nagar,81150,81730,-580,-0.0071472581638940234,1
4895,4896,Malleswaram,415650,63770,351880,0.8465776494646938,-1
4896,4897,Malleswaram,346450,64860,281590,0.8127868379275509,-1
4897,4898,Whitefield,94600,56490,38110,0.4028541226215645,1
4898,4899,Malleswaram,322900,75990,246910,0.7646639826571694,-1
4899,4900,HBR Layout,215950,43820,172130,0.7970826580226904,-1
4900,4901,Kalyan Nagar,425050,25210,399840,0.9406893306669804,-1
4901,4902,HBR Layout,166950,41860,125090,0.7492662473794549,0
4902,4903,HBR Layout,246950,33050,213900,0.8661672403320511,0
4903,4904,Indiranagar,89750,89950,-200,-0.0022284122562674096,1
4904,4905,Shivajinagar,95550,106000,-10450,-0.10936682365253794,1
4905,4906,CV Raman Nagar,346950,34620,312330,0.9002161694768699,-1
4906,4907,Vasanth Nagar,215950,28950,187000,0.8659411900902987,-1
4907,4908,Rajajinagar,348350,15040,333310,0.9568250322951055,-1
4908,4909,Varthur,196750,56770,139980,0.7114612452350699,0
4909,4910,Malleswaram,385050,82350,302700,0.7861316712115309,-1
4910,4911,Jalahalli,220300,40410,179890,0.8165683159328189,-1
4911,4912,CV Raman Nagar,390700,32160,358540,0.9176862042487842,-1
4912,4913,Varthur,320400,71140,249260,0.7779650436953808,-1
4913,4914,CV Raman Nagar,416350,20820,395530,0.9499939954365317,-1
4914,4915,Mahadevapura,399100,95730,303370,0.7601353044349787,-1
4915,4916,Varthur,310950,59080,251870,0.8100016079755588,0
4916,4917,Whitefield,321150,54420,266730,0.8305464736104624,-1
4917,4918,Jalahalli,275400,59250,216150,0.7848583877995643,0
4918,4919,Kammanahalli,291650,100060,191590,0.6569175381450368,0
4919,4920,Kammanahalli,445000,67680,377320,0.8479101123595506,0
4920,4921,Kammanahalli,154300,32780,121520,0.7875567077122488,0
4921,4922,Indiranagar,301850,103540,198310,0.6569819446745072,0
4922,4923,Banaswadi,71350,66910,4440,0.06222845129642607,1
4923,4924,Hoodi,252300,32980,219320,0.8692826000792707,0
4924,4925,Krishnarajapuram,292300,32860,259440,0.8875812521382141,0
4925,4926,Hoodi,390650,127850,262800,0.6727249456034814,0
4926,4927,HBR Layout,165750,33360,132390,0.7987330316742082,0
4927,4928,Whitefield,316400,84050,232350,0.7343552465233881,0
4928,4929,Horamavu,174950,108000,66950,0.3826807659331237,1
4929,4930,Mahadevapura,113550,64810,48740,0.42923822104799647,1
4930,4931,Varthur,33600,9060,24540,0.7303571428571428,0
4931,4932,Indiranagar,88050,164690,-76640,-0.8704145371947757,1
4932,4933,HBR Layout,284600,44340,240260,0.8442023893183416,-1
4933,4934,Jalahalli,327600,34470,293130,0.8947802197802198,-1
4934,4935,Hebbal,152100,42950,109150,0.7176199868507561,0
4935,4936,Kalyan Nagar,210000,79660,130340,0.6206666666666667,0
4936,4937,Malleswaram,184700,54180,130520,0.7066594477531132,0
4937,4938,Marathahalli,417050,23810,393240,0.9429085241577748,-1
4938,4939,Indiranagar,107150,33840,73310,0.6841810545963602,0
4939,4940,Indiranagar,367250,137830,229420,0.6246970728386657,0
4940,4941,Malleswaram,364500,73130,291370,0.7993689986282579,0
4941,4942,Vasanth Nagar,66150,108810,-42660,-0.6448979591836734,1
4942,4943,Jalahalli,61600,44140,17460,0.28344155844155844,1
4943,4944,Kammanahalli,121500,45520,75980,0.6253497942386831,0
4944,4945,Kalyan Nagar,44950,53490,-8540,-0.18998887652947719,1
4945,4946,Kammanahalli,384200,2640,381560,0.9931285788651744,-1
4946,4947,Indiranagar,167200,56880,110320,0.6598086124401914,0
4947,4948,Vasanth Nagar,183700,10150,173550,0.9447468698965705,-1
4948,4949,Marathahalli,38900,100540,-61640,-1.5845758354755783,1
4949,4950,Malleswaram,357300,63760,293540,0.8215505177721802,-1
4950,4951,Whitefield,29600,50900,-21300,-0.7195945945945946,1
4951,4952,Horamavu,99850,80760,19090,0.1911867801702554,1
4952,4953,Indiranagar,245500,71040,174460,0.7106313645621182,0
4953,4954,Horamavu,96150,16000,80150,0.8335933437337494,-1
4954,4955,Krishnarajapuram,144200,107700,36500,0.25312066574202496,1
4955,4956,Marathahalli,139200,30470,108730,0.7811063218390805,0
4956,4957,Mahadevapura,236450,79800,156650,0.6625079297948826,0
4957,4958,Jalahalli,319750,57850,261900,0.8190774042220484,0
4958,4959,Banaswadi,126850,73590,53260,0.4198659834450138,1
4959,4960,Kammanahalli,122000,113900,8100,0.06639344262295081,1
4960,4961,Krishnarajapuram,189750,10520,179230,0.9445586297760211,-1
4961,4962,Jalahalli,288850,62040,226810,0.7852172407824131,-1
4962,4963,Jalahalli,388250,2930,385320,0.9924533161622666,-1
4963,4964,Varthur,417850,115390,302460,0.7238482709106139,-1
4964,4965,Indiranagar,34700,37670,-2970,-0.08559077809798271,1
4965,4966,Kammanahalli,70400,31400,39000,0.5539772727272727,1
4966,4967,Mahadevapura,430800,79140,351660,0.8162952646239554,-1
4967,4968,Kammanahalli,292800,16210,276590,0.9446379781420765,-1
4968,4969,Whitefield,445050,69140,375910,0.8446466689136052,-1
4969,4970,Indiranagar,381750,106500,275250,0.7210216110019646,-1
4970,4971,Jalahalli,118300,26640,91660,0.7748098055790363,-1
4971,4972,Banaswadi,342400,53560,288840,0.8435747663551402,0
4972,4973,Malleswaram,182350,183070,-720,-0.003948450781464217,1
4973,4974,Kammanahalli,398700,46500,352200,0.8833709556057185,0
4974,4975,Marathahalli,317100,16760,300340,0.9471460107221696,-1
4975,4976,Varthur,141350,31630,109720,0.7762292182525645,-1
4976,4977,Hebbal,59900,55110,4790,0.07996661101836394,1
4977,4978,Marathahalli,343700,45740,297960,0.8669188245562991,-1
4978,4979,Jalahalli,362500,30400,332100,0.9161379310344827,-1
4979,4980,Hoodi,33350,50720,-17370,-0.5208395802098951,1
4980,4981,HBR Layout,428600,83420,345180,0.8053663089127392,-1
4981,4982,CV Raman Nagar,147400,85580,61820,0.41940298507462687,1
4982,4983,CV Raman Nagar,301750,84470,217280,0.72006628003314,0
4983,4984,Banaswadi,235550,70810,164740,0.6993844194438548,0
4984,4985,Banaswadi,357850,50450,307400,0.8590191420986447,-1
4985,4986,Mahadevapura,37050,108820,-71770,-1.9371120107962214,1
4986,4987,Jalahalli,331800,23280,308520,0.9298372513562387,-1
4987,4988,Hoodi,404900,118310,286590,0.7078043961471968,-1
4988,4989,Indiranagar,405700,77430,328270,0.8091446881932463,0
4989,4990,Malleswaram,52850,87590,-34740,-0.6573320719016084,1
4990,4991,CV Raman Nagar,303500,52930,250570,0.8256013179571664,0
4991,4992,Shivajinagar,76300,39430,36870,0.48322411533420706,1
4992,4993,Vasanth Nagar,267850,63340,204510,0.7635243606496174,0
4993,4994,HBR Layout,172000,71410,100590,0.5848255813953488,0
4994,4995,Krishnarajapuram,306200,25130,281070,0.9179294578706728,-1
4995,4996,Kammanahalli,157150,104320,52830,0.33617562838052817,1
4996,4997,Varthur,270400,70840,199560,0.7380177514792899,0
4997,4998,Kammanahalli,98950,45980,52970,0.5353208691258211,0
4998,4999,HBR Layout,280400,72910,207490,0.7399786019971469,0
4999,5000,CV Raman Nagar,186300,56110,130190,0.6988191089640365,0
5000,5001,Marathahalli,271850,72660,199190,0.7327202501379437,0
5001,5002,Indiranagar,86450,82680,3770,0.04360902255639098,1
5002,5003,Malleswaram,307600,55090,252510,0.8209037711313394,0
5003,5004,Kammanahalli,283400,60000,223400,0.7882851093860268,0
5004,5005,Varthur,42850,37070,5780,0.13488914819136522,1
5005,5006,Varthur,367150,73600,293550,0.7995369739888329,-1
5006,5007,Kalyan Nagar,119150,56170,62980,0.5285774234158623,1
5007,5008,Malleswaram,441600,81700,359900,0.8149909420289855,-1
5008,5009,Kalyan Nagar,123050,51730,71320,0.5796017878911012,1
5009,5010,Hebbal,443600,118540,325060,0.7327772768259694,0
5010,5011,Varthur,372900,57580,315320,0.8455886296594262,-1
5011,5012,Indiranagar,40850,101190,-60340,-1.477111383108935,1
5012,5013,Mahadevapura,440550,75230,365320,0.8292361820451708,0
5013,5014,CV Raman Nagar,46500,94390,-47890,-1.0298924731182795,1
5014,5015,Vasanth Nagar,194650,39590,155060,0.7966092987413306,-1
5015,5016,Krishnarajapuram,50100,56750,-6650,-0.13273453093812376,1
5016,5017,Banaswadi,206150,72290,133860,0.6493330099442154,0
5017,5018,HBR Layout,316850,38580,278270,0.8782389143127662,-1
5018,5019,Kalyan Nagar,386900,156380,230520,0.5958128715430344,1
5019,5020,Jalahalli,165350,60990,104360,0.6311460538252193,0
5020,5021,Banaswadi,142400,83310,59090,0.41495786516853933,0
5021,5022,Hoodi,31700,31430,270,0.008517350157728707,1
5022,5023,Jalahalli,207900,38420,169480,0.8151996151996151,-1
5023,5024,Kalyan Nagar,442550,76150,366400,0.8279290475652469,0
5024,5025,Vasanth Nagar,439550,33810,405740,0.92308042316005,-1
5025,5026,HBR Layout,80250,82690,-2440,-0.030404984423676014,1
5026,5027,Shivajinagar,37300,75730,-38430,-1.0302949061662199,1
5027,5028,Vasanth Nagar,113450,63380,50070,0.4413397972675187,1
5028,5029,Kammanahalli,403950,95670,308280,0.763163757890828,0
5029,5030,Marathahalli,252400,83170,169230,0.6704833597464342,0
5030,5031,Jalahalli,251350,109030,142320,0.5662223990451561,0
5031,5032,Varthur,80500,73290,7210,0.08956521739130435,1
5032,5033,CV Raman Nagar,136700,83950,52750,0.3858814923189466,1
5033,5034,Horamavu,340700,44440,296260,0.8695626651012621,-1
5034,5035,Jalahalli,304400,13230,291170,0.9565374507227332,-1
5035,5036,Hoodi,365150,85910,279240,0.7647268245926332,-1
5036,5037,Banaswadi,261400,67720,193680,0.7409334353481255,0
5037,5038,Marathahalli,319950,70930,249020,0.7783091107985622,-1
5038,5039,Hebbal,305750,58650,247100,0.8081766148814391,-1
5039,5040,HBR Layout,327850,15640,312210,0.9522952569772762,-1
5040,5041,Shivajinagar,42050,73360,-31310,-0.744589774078478,1
5041,5042,HBR Layout,287400,69200,218200,0.7592205984690327,0
5042,5043,Malleswaram,173200,15370,157830,0.9112586605080831,-1
5043,5044,Kalyan Nagar,205550,27080,178470,0.8682558988080759,0
5044,5045,Varthur,399400,101220,298180,0.7465698547821733,-1
5045,5046,Jalahalli,215400,78070,137330,0.6375580315691737,0
5046,5047,HBR Layout,35850,34820,1030,0.028730822873082287,1
5047,5048,Mahadevapura,436400,66680,369720,0.8472043996333639,0
5048,5049,Krishnarajapuram,357850,69830,288020,0.8048623725024452,-1
5049,5050,Horamavu,386950,46630,340320,0.8794934746091226,0
5050,5051,Indiranagar,173550,49760,123790,0.7132814750792279,0
5051,5052,Marathahalli,81850,67380,14470,0.17678680513133782,1
5052,5053,Mahadevapura,262250,33620,228630,0.8718017159199237,0
5053,5054,Varthur,206350,95000,111350,0.5396171553186334,0
5054,5055,Horamavu,76500,60660,15840,0.20705882352941177,1
5055,5056,HBR Layout,445000,78410,366590,0.8237977528089888,-1
5056,5057,HBR Layout,432600,37700,394900,0.9128525196486361,-1
5057,5058,Varthur,256150,119450,136700,0.5336716767519032,1
5058,5059,Kalyan Nagar,255100,55680,199420,0.7817326538612309,0
5059,5060,Shivajinagar,375850,51010,324840,0.8642809631501929,-1
5060,5061,Hebbal,431500,20160,411340,0.953279258400927,-1
5061,5062,CV Raman Nagar,209350,96820,112530,0.5375208980176738,1
5062,5063,Kalyan Nagar,36600,26550,10050,0.27459016393442626,1
5063,5064,Varthur,41200,159450,-118250,-2.870145631067961,1
5064,5065,Hebbal,198250,83820,114430,0.5772005044136191,0
5065,5066,Shivajinagar,147800,168910,-21110,-0.14282814614343708,1
5066,5067,Malleswaram,348200,87120,261080,0.7497989661114303,0
5067,5068,HBR Layout,269650,86530,183120,0.6791025403300575,0
5068,5069,Marathahalli,64100,26400,37700,0.5881435257410297,0
5069,5070,Kammanahalli,260700,49000,211700,0.8120444955887994,-1
5070,5071,Varthur,259550,21040,238510,0.9189366210749373,-1
5071,5072,Malleswaram,96850,61320,35530,0.3668559628291172,1
5072,5073,Hoodi,363300,81340,281960,0.7761078998073218,0
5073,5074,Jalahalli,336000,55970,280030,0.833422619047619,-1
5074,5075,Hoodi,401000,46690,354310,0.8835660847880299,-1
5075,5076,Varthur,164550,60430,104120,0.6327560012154361,0
5076,5077,HBR Layout,405700,26210,379490,0.9353956125215677,-1
5077,5078,Vasanth Nagar,382600,92080,290520,0.7593308938839519,0
5078,5079,CV Raman Nagar,447350,17610,429740,0.9606348496702806,-1
5079,5080,Indiranagar,388900,66740,322160,0.8283877603497043,0
5080,5081,Kammanahalli,177700,51600,126100,0.7096229600450197,0
5081,5082,Malleswaram,336400,42900,293500,0.8724732461355529,-1
5082,5083,Varthur,38800,61170,-22370,-0.5765463917525773,1
5083,5084,Kammanahalli,275450,105470,169980,0.6170992920675259,0
5084,5085,CV Raman Nagar,364700,107290,257410,0.7058129969838223,-1
5085,5086,Jalahalli,209700,25270,184430,0.8794945159752027,-1
5086,5087,Kammanahalli,159350,31490,127860,0.8023846877941638,0
5087,5088,Indiranagar,123350,80570,42780,0.3468179975678962,1
5088,5089,Kalyan Nagar,408800,64200,344600,0.8429549902152642,0
5089,5090,CV Raman Nagar,223950,54430,169520,0.7569546773833445,0
5090,5091,CV Raman Nagar,193100,66820,126280,0.6539616778871051,0
5091,5092,Mahadevapura,36950,65260,-28310,-0.76617050067659,1
5092,5093,Kalyan Nagar,337450,77670,259780,0.7698325677878204,0
5093,5094,Horamavu,448700,29440,419260,0.934388232672164,-1
5094,5095,Marathahalli,113600,98630,14970,0.1317781690140845,1
5095,5096,Mahadevapura,263500,155540,107960,0.40971537001897534,1
5096,5097,Hebbal,83900,26710,57190,0.6816448152562574,0
5097,5098,Vasanth Nagar,180650,79940,100710,0.5574868530307224,0
5098,5099,Kammanahalli,331800,49670,282130,0.8503013863773358,-1
5099,5100,Vasanth Nagar,299950,27550,272400,0.9081513585597599,-1
5100,5101,Whitefield,177300,131920,45380,0.2559503666102651,1
5101,5102,Krishnarajapuram,281700,52850,228850,0.8123890663826766,-1
5102,5103,Banaswadi,378400,18720,359680,0.9505285412262157,-1
5103,5104,Hebbal,439800,93520,346280,0.7873578899499772,0
5104,5105,Marathahalli,399800,55590,344210,0.8609554777388695,-1
5105,5106,CV Raman Nagar,116300,109140,7160,0.06156491831470336,1
5106,5107,Whitefield,341300,57570,283730,0.831321418107237,-1
5107,5108,Malleswaram,334750,47130,287620,0.859208364451083,0
5108,5109,Indiranagar,161850,108030,53820,0.3325301204819277,1
5109,5110,Indiranagar,417300,73780,343520,0.8231967409537503,-1
5110,5111,Marathahalli,278300,74560,203740,0.7320876751706791,0
5111,5112,Vasanth Nagar,407650,35300,372350,0.9134061081810376,-1
5112,5113,Banaswadi,110500,14350,96150,0.8701357466063349,0
5113,5114,Krishnarajapuram,295100,112620,182480,0.6183666553710606,0
5114,5115,HBR Layout,432450,32290,400160,0.9253324083709099,-1
5115,5116,Jalahalli,294100,135070,159030,0.540734444066644,0
5116,5117,Kammanahalli,76450,23690,52760,0.6901242642249836,0
5117,5118,CV Raman Nagar,193500,71520,121980,0.6303875968992249,0
5118,5119,CV Raman Nagar,187200,86580,100620,0.5375,0
5119,5120,Mahadevapura,233550,62100,171450,0.7341040462427746,-1
5120,5121,Horamavu,163700,23490,140210,0.8565058032987172,0
5121,5122,Kalyan Nagar,79650,79480,170,0.0021343377275580664,1
5122,5123,Malleswaram,211650,60900,150750,0.7122608079376329,-1
5123,5124,Marathahalli,318050,78540,239510,0.7530576953309228,0
5124,5125,Vasanth Nagar,395200,19010,376190,0.9518977732793522,-1
5125,5126,Rajajinagar,440300,32340,407960,0.926550079491256,-1
5126,5127,Horamavu,164150,142220,21930,0.13359731952482484,1
5127,5128,Malleswaram,222000,47500,174500,0.786036036036036,0
5128,5129,Hoodi,218350,59580,158770,0.7271353331806732,-1
5129,5130,Marathahalli,174350,97290,77060,0.4419845139088041,1
5130,5131,Whitefield,59850,72900,-13050,-0.21804511278195488,1
5131,5132,Kammanahalli,409350,25940,383410,0.9366312446561622,-1
5132,5133,Kalyan Nagar,380050,100070,279980,0.7366925404552033,-1
5133,5134,Kammanahalli,72800,71460,1340,0.018406593406593407,1
5134,5135,Marathahalli,93100,53130,39970,0.4293233082706767,1
5135,5136,Malleswaram,434250,73670,360580,0.8303511801957398,-1
5136,5137,Vasanth Nagar,40200,131470,-91270,-2.2703980099502488,1
5137,5138,CV Raman Nagar,279550,61670,217880,0.7793954569844392,-1
5138,5139,Shivajinagar,267200,16810,250390,0.9370883233532934,-1
5139,5140,Hoodi,343750,63230,280520,0.8160581818181818,-1
5140,5141,Kalyan Nagar,238450,75460,162990,0.6835395261061019,0
5141,5142,CV Raman Nagar,377950,24520,353430,0.9351236936102659,-1
5142,5143,Kalyan Nagar,310300,55930,254370,0.8197550757331614,-1
5143,5144,Malleswaram,411150,88620,322530,0.7844582269244801,-1
5144,5145,Hoodi,174550,63740,110810,0.6348324262389,0
5145,5146,Mahadevapura,424050,79570,344480,0.8123570333687066,0
5146,5147,Whitefield,303100,36810,266290,0.8785549323655559,-1
5147,5148,Whitefield,42450,25330,17120,0.4032979976442874,1
5148,5149,Marathahalli,73250,64170,9080,0.12395904436860068,1
5149,5150,Shivajinagar,398250,177170,221080,0.5551286880100439,1
5150,5151,Horamavu,215200,73710,141490,0.6574814126394052,0
5151,5152,Kammanahalli,368900,55810,313090,0.8487123881810789,0
5152,5153,Kalyan Nagar,35450,93110,-57660,-1.6265162200282088,1
5153,5154,Krishnarajapuram,91200,97640,-6440,-0.0706140350877193,1
5154,5155,Mahadevapura,199450,80100,119350,0.5983955878666333,0
5155,5156,Varthur,444700,95910,348790,0.7843265122554531,-1
5156,5157,Kammanahalli,365600,103810,261790,0.7160557986870897,0
5157,5158,Whitefield,80200,41670,38530,0.4804239401496259,0
5158,5159,Banaswadi,28550,30470,-1920,-0.06725043782837128,1
5159,5160,Marathahalli,136450,46830,89620,0.6567973616709417,0
5160,5161,Varthur,147750,84630,63120,0.4272081218274112,0
5161,5162,Kammanahalli,369450,106820,262630,0.7108675057517932,0
5162,5163,Shivajinagar,443050,95200,347850,0.7851258322988376,0
5163,5164,Banaswadi,415650,48390,367260,0.8835799350415012,-1
5164,5165,Shivajinagar,262150,49710,212440,0.810375739080679,0
5165,5166,Horamavu,124250,9060,115190,0.9270824949698189,-1
5166,5167,Rajajinagar,398050,51370,346680,0.8709458610727295,0
5167,5168,Rajajinagar,404350,68370,335980,0.8309138122913318,-1
5168,5169,Marathahalli,286300,83020,203280,0.7100244498777506,0
5169,5170,Hebbal,302900,0,302900,1.0,-1
5170,5171,Mahadevapura,371650,79060,292590,0.7872729718821472,-1
5171,5172,Mahadevapura,99150,52880,46270,0.4666666666666667,1
5172,5173,Kalyan Nagar,256500,36250,220250,0.8586744639376218,-1
5173,5174,Horamavu,280350,17260,263090,0.938434100231853,-1
5174,5175,Shivajinagar,100000,92280,7720,0.0772,1
5175,5176,Indiranagar,290750,51080,239670,0.8243164230438521,0
5176,5177,Kammanahalli,282800,58600,224200,0.7927864214992928,-1
5177,5178,Krishnarajapuram,220850,74010,146840,0.6648856690061128,0
5178,5179,Kammanahalli,295150,60230,234920,0.7959342707098086,0
5179,5180,Malleswaram,181700,113370,68330,0.3760594386351128,1
5180,5181,Kammanahalli,73250,22170,51080,0.6973378839590444,0
5181,5182,Hebbal,244900,34230,210670,0.860228664761127,-1
5182,5183,HBR Layout,176400,24730,151670,0.8598072562358277,-1
5183,5184,Krishnarajapuram,366450,47980,318470,0.8690680856869969,-1
5184,5185,Mahadevapura,288200,105360,182840,0.6344205412907703,0
5185,5186,CV Raman Nagar,277300,53630,223670,0.8065993508835196,-1
5186,5187,Hoodi,123250,49250,74000,0.6004056795131846,0
5187,5188,Whitefield,417250,105430,311820,0.7473217495506291,0
5188,5189,Kalyan Nagar,440150,36190,403960,0.9177780302169715,-1
5189,5190,Kammanahalli,255500,12950,242550,0.9493150684931507,-1
5190,5191,Varthur,351950,81090,270860,0.7695979542548658,-1
5191,5192,Rajajinagar,358650,35730,322920,0.9003764115432873,-1
5192,5193,CV Raman Nagar,391050,67590,323460,0.8271576524741082,0
5193,5194,Indiranagar,90850,48630,42220,0.4647220693450743,0
5194,5195,Banaswadi,42400,19970,22430,0.5290094339622642,0
5195,5196,Varthur,187800,89720,98080,0.5222577209797657,0
5196,5197,Rajajinagar,192050,21110,170940,0.8900807081489196,0
5197,5198,Jalahalli,206250,69860,136390,0.6612848484848485,0
5198,5199,CV Raman Nagar,36950,78350,-41400,-1.1204330175913397,1
5199,5200,Hebbal,168450,103050,65400,0.38824577025823687,1
5200,5201,Banaswadi,249500,126140,123360,0.4944288577154309,1
5201,5202,Vasanth Nagar,212550,127230,85320,0.4014114326040932,1
5202,5203,Rajajinagar,170350,122960,47390,0.2781919577340769,1
5203,5204,Hebbal,445050,81170,363880,0.8176159982024491,-1
5204,5205,HBR Layout,380150,66690,313460,0.8245692489806655,0
5205,5206,Hebbal,345400,58390,287010,0.8309496236247829,0
5206,5207,Marathahalli,74700,36680,38020,0.5089692101740294,1
5207,5208,CV Raman Nagar,418550,121000,297550,0.7109067017082786,-1
5208,5209,Hebbal,378850,10120,368730,0.9732875808367428,-1
5209,5210,Whitefield,376300,35050,341250,0.9068562317300026,-1
5210,5211,Marathahalli,116900,25740,91160,0.7798118049615056,-1
5211,5212,CV Raman Nagar,105200,126690,-21490,-0.20427756653992396,1
5212,5213,Varthur,430650,77320,353330,0.820457448043655,-1
5213,5214,Banaswadi,444600,46960,397640,0.8943769680611786,-1
5214,5215,HBR Layout,37200,38030,-830,-0.022311827956989248,1
5215,5216,Kalyan Nagar,167100,152050,15050,0.090065828845003,1
5216,5217,Mahadevapura,439250,26460,412790,0.9397609561752988,-1
5217,5218,Shivajinagar,419350,61380,357970,0.8536306188148325,-1
5218,5219,Jalahalli,122950,49100,73850,0.6006506710044733,0
5219,5220,Krishnarajapuram,174000,37220,136780,0.7860919540229885,0
5220,5221,Whitefield,96250,83860,12390,0.12872727272727272,1
5221,5222,Jalahalli,27950,90060,-62110,-2.2221824686940965,1
5222,5223,Marathahalli,378150,74920,303230,0.801877561814095,-1
5223,5224,HBR Layout,344800,42230,302570,0.8775232018561485,-1
5224,5225,Varthur,374700,93110,281590,0.7515078729650387,-1
5225,5226,Kammanahalli,429450,71650,357800,0.8331586913494003,-1
5226,5227,Rajajinagar,426450,85700,340750,0.7990385742759996,0
5227,5228,Kalyan Nagar,373350,45120,328230,0.8791482523101647,-1
5228,5229,Krishnarajapuram,238150,63730,174420,0.7323955490237245,0
5229,5230,Indiranagar,196950,61740,135210,0.6865194211728866,0
5230,5231,Rajajinagar,209900,50930,158970,0.7573606479275846,0
5231,5232,Malleswaram,137500,57780,79720,0.5797818181818182,0
5232,5233,Krishnarajapuram,424900,21930,402970,0.9483878559661096,-1
5233,5234,Horamavu,442200,206450,235750,0.5331298055178653,1
5234,5235,HBR Layout,329450,59330,270120,0.8199119745029595,-1
5235,5236,Mahadevapura,224900,35880,189020,0.8404624277456647,-1
5236,5237,Jalahalli,421250,45210,376040,0.8926765578635015,-1
5237,5238,Indiranagar,203700,88020,115680,0.5678939617083947,0
5238,5239,Kalyan Nagar,213950,82910,131040,0.612479551297032,0
5239,5240,Kalyan Nagar,428750,80740,348010,0.8116851311953353,0
5240,5241,Shivajinagar,298300,19280,279020,0.9353670801206839,-1
5241,5242,Mahadevapura,153950,106180,47770,0.3102955505034102,1
5242,5243,Varthur,323250,57220,266030,0.8229853054911059,0
5243,5244,Horamavu,138500,54970,83530,0.6031046931407942,0
5244,5245,Malleswaram,282750,81130,201620,0.7130680813439434,0
5245,5246,Varthur,224050,66190,157860,0.7045748716804284,0
5246,5247,Marathahalli,209000,63390,145610,0.6966985645933015,0
5247,5248,Hoodi,260550,50000,210550,0.8080982536941086,-1
5248,5249,Hoodi,296400,42960,253440,0.8550607287449393,-1
5249,5250,Malleswaram,351650,34920,316730,0.9006967154841462,-1
5250,5251,Whitefield,192750,53500,139250,0.7224383916990921,-1
5251,5252,Jalahalli,178950,63590,115360,0.644649343392009,0
5252,5253,Whitefield,315750,19590,296160,0.937957244655582,-1
5253,5254,Banaswadi,221500,19240,202260,0.91313769751693,-1
5254,5255,Hebbal,142850,40520,102330,0.7163458172908646,0
5255,5256,Horamavu,239550,2450,237100,0.9897724900855771,-1
5256,5257,Indiranagar,104300,74090,30210,0.28964525407478425,1
5257,5258,Krishnarajapuram,302750,45860,256890,0.848521882741536,-1
5258,5259,Krishnarajapuram,288900,112380,176520,0.6110072689511942,0
5259,5260,Horamavu,130750,87130,43620,0.33361376673040155,1
5260,5261,Shivajinagar,98700,54930,43770,0.44346504559270516,1
5261,5262,Shivajinagar,68700,30710,37990,0.5529839883551674,0
5262,5263,Malleswaram,87150,21770,65380,0.7502008032128514,0
5263,5264,Vasanth Nagar,430750,24190,406560,0.9438421358096344,-1
5264,5265,Hebbal,245400,41830,203570,0.8295436022819885,0
5265,5266,Marathahalli,182800,83230,99570,0.5446936542669584,1
5266,5267,Hoodi,218450,34870,183580,0.8403753719386587,-1
5267,5268,CV Raman Nagar,322350,63940,258410,0.8016441755855437,0
5268,5269,Rajajinagar,385500,17440,368060,0.9547600518806745,-1
5269,5270,Mahadevapura,241450,26510,214940,0.8902050113895217,0
5270,5271,Banaswadi,106900,67470,39430,0.36884939195509825,1
5271,5272,Hebbal,414100,22890,391210,0.9447234967399178,-1
5272,5273,HBR Layout,302850,21690,281160,0.9283803863298663,-1
5273,5274,Kammanahalli,271700,28460,243240,0.8952521163047479,-1
5274,5275,Marathahalli,112600,105780,6820,0.060568383658969806,1
5275,5276,Whitefield,341750,90130,251620,0.736269202633504,0
5276,5277,HBR Layout,186100,13120,172980,0.9295002686727566,-1
5277,5278,Indiranagar,92200,25140,67060,0.7273318872017354,0
5278,5279,Banaswadi,333100,83660,249440,0.7488441909336535,-1
5279,5280,CV Raman Nagar,47650,59330,-11680,-0.24512067156348374,1
5280,5281,HBR Layout,397500,15190,382310,0.9617861635220126,-1
5281,5282,Varthur,250900,59310,191590,0.7636110003985652,-1
5282,5283,HBR Layout,213400,52610,160790,0.7534676663542643,0
5283,5284,Whitefield,60600,52010,8590,0.14174917491749175,1
5284,5285,CV Raman Nagar,32650,9390,23260,0.7124042879019908,0
5285,5286,Banaswadi,321150,119240,201910,0.6287093258601899,0
5286,5287,Indiranagar,246850,106750,140100,0.5675511444196881,1
5287,5288,Kammanahalli,300150,45080,255070,0.849808429118774,0
5288,5289,Mahadevapura,69350,83250,-13900,-0.20043258832011535,1
5289,5290,Malleswaram,202500,54380,148120,0.7314567901234568,0
5290,5291,HBR Layout,308050,88970,219080,0.7111832494724882,0
5291,5292,Malleswaram,130900,43610,87290,0.6668449197860963,0
5292,5293,Hoodi,355650,152760,202890,0.5704765921552087,0
5293,5294,Hoodi,115650,48000,67650,0.5849546044098574,1
5294,5295,Indiranagar,204200,63970,140230,0.6867286973555338,0
5295,5296,HBR Layout,200150,122980,77170,0.38556082937796654,1
5296,5297,Indiranagar,96750,27280,69470,0.7180361757105943,0
5297,5298,Hebbal,172200,62080,110120,0.6394889663182346,0
5298,5299,Whitefield,358500,85620,272880,0.7611715481171548,0
5299,5300,Mahadevapura,428150,46270,381880,0.8919303982249212,-1
5300,5301,Kammanahalli,237750,51490,186260,0.7834279705573081,-1
5301,5302,Malleswaram,324300,53060,271240,0.8363860622880049,-1
5302,5303,Mahadevapura,329850,610,329240,0.9981506745490374,-1
5303,5304,Rajajinagar,389600,105730,283870,0.7286190965092403,-1
5304,5305,Rajajinagar,446600,61680,384920,0.8618898343036274,0
5305,5306,CV Raman Nagar,416400,54670,361730,0.8687079731027858,-1
5306,5307,Marathahalli,103850,46440,57410,0.5528165623495426,1
5307,5308,HBR Layout,217750,99230,118520,0.5442939150401837,1
5308,5309,Whitefield,355500,99550,255950,0.719971870604782,0
5309,5310,CV Raman Nagar,370050,127850,242200,0.6545061478178624,0
5310,5311,Varthur,445600,70440,375160,0.8419210053859965,-1
5311,5312,Mahadevapura,446750,100670,346080,0.7746614437604924,0
5312,5313,Horamavu,337600,77580,260020,0.7702014218009479,-1
5313,5314,Varthur,397100,27800,369300,0.9299924452279023,-1
5314,5315,Rajajinagar,217200,100640,116560,0.5366482504604052,1
5315,5316,Marathahalli,403650,68630,335020,0.8299764647590735,0
5316,5317,Banaswadi,76000,64210,11790,0.15513157894736843,1
5317,5318,Hoodi,315900,0,315900,1.0,-1
5318,5319,Rajajinagar,274600,87890,186710,0.6799344501092498,0
5319,5320,Banaswadi,90350,48340,42010,0.4649695628112894,0
5320,5321,CV Raman Nagar,422650,79470,343180,0.8119720809180173,0
5321,5322,HBR Layout,320650,69380,251270,0.7836270076407298,0
5322,5323,Jalahalli,282650,139270,143380,0.5072704758535291,1
5323,5324,Krishnarajapuram,372500,64920,307580,0.8257181208053691,0
5324,5325,Mahadevapura,337700,32440,305260,0.9039384068700029,-1
5325,5326,Indiranagar,307350,83220,224130,0.7292337725719863,0
5326,5327,Hoodi,298950,72930,226020,0.7560461615654792,0
5327,5328,Vasanth Nagar,53250,57350,-4100,-0.07699530516431925,1
5328,5329,Krishnarajapuram,225200,0,225200,1.0,-1
5329,5330,Varthur,390950,102380,288570,0.7381250799334953,-1
5330,5331,Krishnarajapuram,123050,18910,104140,0.8463226330759853,-1
5331,5332,Kammanahalli,233000,78700,154300,0.6622317596566524,0
5332,5333,Malleswaram,118250,59680,58570,0.4953065539112051,0
5333,5334,HBR Layout,210550,153480,57070,0.27105200664925194,1
5334,5335,Hoodi,171100,86240,84860,0.49596727060198714,1
5335,5336,HBR Layout,412900,77910,334990,0.811310244611286,-1
5336,5337,Varthur,108550,45460,63090,0.5812068171349608,0
5337,5338,Hoodi,111450,89070,22380,0.20080753701211307,1
5338,5339,Horamavu,321150,91110,230040,0.7163007940214853,-1
5339,5340,Varthur,369250,84950,284300,0.7699390656736629,-1
5340,5341,Jalahalli,369200,74800,294400,0.7973997833152763,-1
5341,5342,Rajajinagar,239150,43850,195300,0.8166422747229772,-1
5342,5343,Varthur,310000,20850,289150,0.932741935483871,-1
5343,5344,Mahadevapura,355450,66320,289130,0.813419608946406,-1
5344,5345,Jalahalli,109150,78900,30250,0.277141548327989,1
5345,5346,CV Raman Nagar,302100,26850,275250,0.9111221449851042,-1
5346,5347,Hebbal,221000,19150,201850,0.9133484162895927,-1
5347,5348,Varthur,404650,136790,267860,0.6619547757321141,0
5348,5349,Hebbal,251900,109080,142820,0.5669710202461294,0
5349,5350,Indiranagar,422650,32790,389860,0.9224180764225719,-1
5350,5351,Horamavu,177100,6670,170430,0.9623376623376624,-1
5351,5352,Hebbal,341350,29690,311660,0.913021825106196,-1
5352,5353,Marathahalli,78650,71030,7620,0.09688493324856962,1
5353,5354,Kalyan Nagar,56150,63220,-7070,-0.12591273374888692,1
5354,5355,Whitefield,284750,37460,247290,0.8684460052677787,0
5355,5356,Kalyan Nagar,384650,62920,321730,0.8364227219550241,0
5356,5357,Banaswadi,166400,37690,128710,0.7734975961538462,-1
5357,5358,Marathahalli,412150,44060,368090,0.8930971733592139,0
5358,5359,Mahadevapura,382550,64290,318260,0.8319435367925762,-1
5359,5360,Rajajinagar,191050,93640,97410,0.50986652708715,0
5360,5361,Kalyan Nagar,352050,30300,321750,0.9139326800170431,-1
5361,5362,Hoodi,159000,54480,104520,0.6573584905660378,0
5362,5363,Banaswadi,195700,64570,131130,0.670056208482371,0
5363,5364,Shivajinagar,269600,80390,189210,0.7018175074183977,0
5364,5365,Varthur,292450,61680,230770,0.7890921525047017,-1
5365,5366,Malleswaram,376850,41980,334870,0.8886028923975057,-1
5366,5367,CV Raman Nagar,160700,28900,131800,0.8201617921593031,-1
5367,5368,Krishnarajapuram,76450,130850,-54400,-0.7115761935905821,1
5368,5369,Hoodi,63900,78610,-14710,-0.2302034428794992,1
5369,5370,Shivajinagar,284850,42150,242700,0.85202738283307,0
5370,5371,Indiranagar,395900,55850,340050,0.8589290224804244,-1
5371,5372,Horamavu,51150,19580,31570,0.6172043010752688,0
5372,5373,Whitefield,343750,107510,236240,0.6872436363636364,0
5373,5374,Hoodi,259700,27070,232630,0.8957643434732383,-1
5374,5375,Horamavu,59050,15520,43530,0.7371718882303133,-1
5375,5376,Krishnarajapuram,235800,50730,185070,0.7848600508905852,0
5376,5377,Hoodi,80250,62340,17910,0.22317757009345796,1
5377,5378,Vasanth Nagar,282350,63720,218630,0.7743226491942624,0
5378,5379,CV Raman Nagar,321750,83590,238160,0.7402020202020202,0
5379,5380,Krishnarajapuram,242000,87650,154350,0.6378099173553718,0
5380,5381,CV Raman Nagar,230450,88380,142070,0.6164894771100021,0
5381,5382,Banaswadi,383100,21420,361680,0.9440877055599061,-1
5382,5383,Vasanth Nagar,419700,75360,344340,0.8204431736954968,-1
5383,5384,Horamavu,270950,35400,235550,0.8693485883004244,-1
5384,5385,CV Raman Nagar,166200,51770,114430,0.6885078219013238,0
5385,5386,Krishnarajapuram,315050,97320,217730,0.6910966513251865,0
5386,5387,Banaswadi,28750,17890,10860,0.37773913043478263,1
5387,5388,Indiranagar,157800,86090,71710,0.4544359949302915,1
5388,5389,Indiranagar,48050,74680,-26630,-0.5542143600416233,1
5389,5390,Kammanahalli,393950,26350,367600,0.9331133392562508,-1
5390,5391,Malleswaram,312650,60160,252490,0.8075803614265152,-1
5391,5392,Jalahalli,379400,56460,322940,0.8511860832894044,0
5392,5393,Indiranagar,250100,44600,205500,0.821671331467413,0
5393,5394,Malleswaram,413800,17970,395830,0.9565732237796036,-1
5394,5395,Whitefield,80550,119640,-39090,-0.48528864059590315,1
5395,5396,Krishnarajapuram,222050,50010,172040,0.7747804548525107,0
5396,5397,Mahadevapura,387850,59440,328410,0.8467448755962357,0
5397,5398,Hebbal,349100,40580,308520,0.8837582354626181,-1
5398,5399,Krishnarajapuram,353500,88050,265450,0.750919377652051,-1
5399,5400,Kalyan Nagar,80550,49300,31250,0.38795779019242704,1
5400,5401,Mahadevapura,31750,27570,4180,0.13165354330708662,1
5401,5402,Marathahalli,98050,97350,700,0.0071392146863844975,1
5402,5403,Kalyan Nagar,382600,53730,328870,0.8595661265028751,-1
5403,5404,Malleswaram,195300,90940,104360,0.534357398873528,0
5404,5405,Varthur,380450,114300,266150,0.6995663030621633,0
5405,5406,Varthur,315300,56690,258610,0.8202029812876626,-1
5406,5407,Kammanahalli,425400,27980,397420,0.9342266102491772,-1
5407,5408,Malleswaram,58900,93810,-34910,-0.5926994906621392,1
5408,5409,Hebbal,373800,70350,303450,0.8117977528089888,-1
5409,5410,Krishnarajapuram,278050,114630,163420,0.5877360187016724,0
5410,5411,Shivajinagar,76350,119340,-42990,-0.5630648330058939,1
5411,5412,Indiranagar,439200,70780,368420,0.8388433515482696,-1
5412,5413,Hebbal,158700,153930,4770,0.03005671077504726,1
5413,5414,Rajajinagar,50900,62120,-11220,-0.22043222003929272,1
5414,5415,Mahadevapura,302300,109660,192640,0.6372477671187562,0
5415,5416,Rajajinagar,73600,16980,56620,0.7692934782608696,-1
5416,5417,Hoodi,154200,44130,110070,0.7138132295719845,-1
5417,5418,Hoodi,218750,35200,183550,0.8390857142857143,-1
5418,5419,Rajajinagar,355650,83780,271870,0.7644313229298467,0
5419,5420,Rajajinagar,249300,79390,169910,0.6815483353389491,0
5420,5421,Jalahalli,82950,58170,24780,0.29873417721518986,1
5421,5422,Shivajinagar,159100,72680,86420,0.5431803896920177,0
5422,5423,Shivajinagar,74600,24880,49720,0.6664879356568365,0
5423,5424,Kalyan Nagar,346350,135300,211050,0.6093546990038978,0
5424,5425,Rajajinagar,71100,52300,18800,0.26441631504922647,1
5425,5426,Marathahalli,344100,102550,241550,0.7019761697181052,-1
5426,5427,Indiranagar,116700,89320,27380,0.23461868037703512,1
5427,5428,Vasanth Nagar,167700,92310,75390,0.44955277280858674,1
5428,5429,Horamavu,154000,48650,105350,0.6840909090909091,0
5429,5430,Hebbal,81800,49130,32670,0.3993887530562347,1
5430,5431,Rajajinagar,369300,57520,311780,0.8442458705659356,-1
5431,5432,Kalyan Nagar,194200,38160,156040,0.8035015447991761,-1
5432,5433,Horamavu,349050,31590,317460,0.9094972067039107,-1
5433,5434,Kammanahalli,449650,74160,375490,0.8350717224507951,0
5434,5435,Marathahalli,32400,66480,-34080,-1.0518518518518518,1
5435,5436,Rajajinagar,211650,7310,204340,0.9654618473895582,-1
5436,5437,Jalahalli,224700,36380,188320,0.8380952380952381,-1
5437,5438,Vasanth Nagar,205550,138400,67150,0.32668450498662127,1
5438,5439,Rajajinagar,361350,106100,255250,0.7063788570637886,0
5439,5440,Varthur,210400,38730,171670,0.8159220532319391,0
5440,5441,Shivajinagar,111600,57290,54310,0.48664874551971327,1
5441,5442,Indiranagar,435850,68710,367140,0.8423540208787427,-1
5442,5443,Varthur,71900,12840,59060,0.8214186369958275,-1
5443,5444,CV Raman Nagar,222000,74220,147780,0.6656756756756756,0
5444,5445,HBR Layout,236900,45580,191320,0.8075981426762346,0
5445,5446,Varthur,347300,75680,271620,0.7820904117477685,0
5446,5447,Mahadevapura,276800,62950,213850,0.7725794797687862,-1
5447,5448,Malleswaram,324600,94660,229940,0.7083795440542205,-1
5448,5449,Rajajinagar,175600,118400,57200,0.32574031890660593,1
5449,5450,Hebbal,292100,28830,263270,0.9013009243409791,-1
5450,5451,Hoodi,260700,35080,225620,0.8654392021480629,-1
5451,5452,Rajajinagar,103800,74120,29680,0.2859344894026975,1
5452,5453,Rajajinagar,291300,106430,184870,0.6346378304153794,0
5453,5454,Banaswadi,293250,0,293250,1.0,-1
5454,5455,Jalahalli,244200,72270,171930,0.7040540540540541,0
5455,5456,Indiranagar,374850,137850,237000,0.6322529011604642,0
5456,5457,Marathahalli,222000,89540,132460,0.5966666666666667,0
5457,5458,Rajajinagar,440800,47830,392970,0.8914927404718693,-1
5458,5459,Kalyan Nagar,303450,97250,206200,0.6795188663700774,0
5459,5460,Shivajinagar,286100,60270,225830,0.7893393918210416,0
5460,5461,Mahadevapura,43150,66530,-23380,-0.5418308227114716,1
5461,5462,CV Raman Nagar,295400,59720,235680,0.7978334461746784,-1
5462,5463,Varthur,130450,121160,9290,0.07121502491376006,1
5463,5464,CV Raman Nagar,290900,105680,185220,0.6367136473014782,0
5464,5465,Mahadevapura,359250,59300,299950,0.8349338900487125,0
5465,5466,Varthur,287850,71810,216040,0.7505297898210874,0
5466,5467,Vasanth Nagar,95950,41510,54440,0.5673788431474727,1
5467,5468,Hebbal,380900,94610,286290,0.7516145970070884,0
5468,5469,Whitefield,84600,44210,40390,0.47742316784869976,0
5469,5470,Hebbal,125000,41040,83960,0.67168,0
5470,5471,Horamavu,306550,129010,177540,0.5791551133583428,1
5471,5472,Shivajinagar,362100,16900,345200,0.9533278099972383,-1
5472,5473,Mahadevapura,420100,80190,339910,0.8091168769340633,-1
5473,5474,Shivajinagar,259700,75030,184670,0.7110897189064305,0
5474,5475,Hoodi,125650,48660,76990,0.612733784321528,0
5475,5476,Jalahalli,437250,74280,362970,0.8301200686106347,0
5476,5477,CV Raman Nagar,220400,68550,151850,0.6889745916515426,0
5477,5478,Rajajinagar,145250,73850,71400,0.491566265060241,1
5478,5479,Hoodi,69250,71260,-2010,-0.029025270758122744,1
5479,5480,Mahadevapura,120600,94280,26320,0.21824212271973467,1
5480,5481,HBR Layout,430550,122520,308030,0.7154337475322262,-1
5481,5482,HBR Layout,29950,32460,-2510,-0.08380634390651086,1
5482,5483,Kammanahalli,245750,0,245750,1.0,-1
5483,5484,Jalahalli,120200,93220,26980,0.22445923460898504,1
5484,5485,Banaswadi,114250,50600,63650,0.5571115973741795,0
5485,5486,Vasanth Nagar,327550,92770,234780,0.7167760647229431,-1
5486,5487,Rajajinagar,434350,61550,372800,0.8582940025325199,0
5487,5488,Jalahalli,244400,144180,100220,0.41006546644844516,1
5488,5489,Horamavu,80100,32350,47750,0.5961298377028714,0
5489,5490,Kammanahalli,53250,44890,8360,0.15699530516431925,1
5490,5491,Whitefield,112000,95460,16540,0.14767857142857144,1
5491,5492,Varthur,83800,41280,42520,0.5073985680190931,1
5492,5493,Whitefield,256500,86340,170160,0.6633918128654971,0
5493,5494,CV Raman Nagar,305250,110430,194820,0.6382309582309582,0
5494,5495,Shivajinagar,144650,56510,88140,0.6093328724507432,0
5495,5496,CV Raman Nagar,240750,50200,190550,0.791484942886812,0
5496,5497,Marathahalli,225500,48250,177250,0.7860310421286031,0
5497,5498,Kammanahalli,120900,98000,22900,0.18941273779983459,1
5498,5499,Whitefield,107550,87890,19660,0.18279869827986983,1
5499,5500,Rajajinagar,410150,121170,288980,0.704571498232354,0
5500,5501,Vasanth Nagar,81000,78520,2480,0.030617283950617285,1
5501,5502,Banaswadi,169550,24770,144780,0.8539074019463285,-1
5502,5503,Hoodi,248450,38770,209680,0.8439525055343128,0
5503,5504,Indiranagar,262900,41570,221330,0.8418790414606314,-1
5504,5505,Kammanahalli,342500,32280,310220,0.9057518248175183,-1
5505,5506,Hoodi,45450,57510,-12060,-0.26534653465346536,1
5506,5507,Shivajinagar,288800,106330,182470,0.6318213296398892,0
5507,5508,Kammanahalli,205150,42270,162880,0.7939556422130148,0
5508,5509,Hoodi,313850,70820,243030,0.7743508045244544,0
5509,5510,Varthur,200950,86280,114670,0.5706394625528739,0
5510,5511,Hebbal,26950,59490,-32540,-1.2074211502782932,1
5511,5512,Rajajinagar,140200,49550,90650,0.6465763195435092,0
5512,5513,Whitefield,60700,72300,-11600,-0.19110378912685339,1
5513,5514,CV Raman Nagar,332550,93480,239070,0.7188994136220117,-1
5514,5515,Kalyan Nagar,302400,47760,254640,0.8420634920634921,-1
5515,5516,Hebbal,295550,42320,253230,0.8568093385214007,0
5516,5517,Kalyan Nagar,134200,67420,66780,0.4976154992548435,0
5517,5518,Kalyan Nagar,58600,22950,35650,0.6083617747440273,0
5518,5519,Kalyan Nagar,343250,68650,274600,0.8,0
5519,5520,Shivajinagar,279750,90440,189310,0.6767113494191243,0
5520,5521,Hebbal,76900,62600,14300,0.1859557867360208,1
5521,5522,Rajajinagar,217050,55140,161910,0.7459571527297858,-1
5522,5523,Hebbal,429850,19810,410040,0.9539141561009654,-1
5523,5524,Hebbal,177350,44550,132800,0.7488018043416972,0
5524,5525,Hoodi,128800,66010,62790,0.4875,1
5525,5526,Shivajinagar,395100,96210,298890,0.756492027334852,-1
5526,5527,Kalyan Nagar,169250,88010,81240,0.48,1
5527,5528,Shivajinagar,154550,73490,81060,0.524490456163054,0
5528,5529,Jalahalli,156050,92250,63800,0.40884331944889457,1
5529,5530,HBR Layout,269350,116110,153240,0.5689251902728791,0
5530,5531,Kalyan Nagar,446500,102570,343930,0.7702799552071669,0
5531,5532,Hebbal,50850,121660,-70810,-1.392527040314651,1
5532,5533,Kalyan Nagar,370750,58140,312610,0.8431827376938638,-1
5533,5534,Jalahalli,442000,60930,381070,0.8621493212669683,-1
5534,5535,CV Raman Nagar,437200,26830,410370,0.9386322049405307,-1
5535,5536,Hoodi,381700,21090,360610,0.9447471836520828,-1
5536,5537,Jalahalli,310050,46570,263480,0.8497984196097403,0
5537,5538,Krishnarajapuram,142750,67800,74950,0.5250437828371278,0
5538,5539,Hebbal,283050,133390,149660,0.5287405052110934,0
5539,5540,Mahadevapura,372400,78900,293500,0.7881310418904404,-1
5540,5541,Horamavu,122500,67930,54570,0.44546938775510203,1
5541,5542,Mahadevapura,386650,48790,337860,0.8738135264451053,-1
5542,5543,Mahadevapura,109200,41900,67300,0.6163003663003663,0
5543,5544,Horamavu,104950,76030,28920,0.2755597903763697,1
5544,5545,Hoodi,442000,36200,405800,0.9180995475113122,-1
5545,5546,CV Raman Nagar,314800,73300,241500,0.7671537484116899,-1
5546,5547,Varthur,271500,156240,115260,0.4245303867403315,0
5547,5548,Whitefield,200550,32780,167770,0.8365494889055098,-1
5548,5549,HBR Layout,433600,54260,379340,0.8748616236162362,-1
5549,5550,Hoodi,96600,63900,32700,0.3385093167701863,1
5550,5551,Whitefield,315600,59090,256510,0.8127693282636248,-1
5551,5552,Rajajinagar,446850,24850,422000,0.9443884972585879,-1
5552,5553,Banaswadi,439000,61520,377480,0.8598633257403189,-1
5553,5554,Vasanth Nagar,353300,38580,314720,0.8908010189640532,-1
5554,5555,Jalahalli,251300,78090,173210,0.6892558694787108,0
5555,5556,Hebbal,299600,86160,213440,0.7124165554072096,0
5556,5557,HBR Layout,443850,50440,393410,0.8863580038301228,-1
5557,5558,Whitefield,383400,77710,305690,0.7973135106937924,0
5558,5559,Horamavu,358650,30160,328490,0.9159068729959571,-1
5559,5560,Kalyan Nagar,421300,43600,377700,0.8965107999050558,-1
5560,5561,Vasanth Nagar,373300,90820,282480,0.7567104205732654,-1
5561,5562,Horamavu,341600,45500,296100,0.8668032786885246,0
5562,5563,Malleswaram,133900,137200,-3300,-0.024645257654966394,1
5563,5564,Hebbal,444250,62610,381640,0.8590658413055712,-1
5564,5565,Hebbal,392700,52870,339830,0.8653679653679653,0
5565,5566,Marathahalli,422950,60170,362780,0.8577373211963589,-1
5566,5567,Varthur,347600,96210,251390,0.7232163406214039,-1
5567,5568,Jalahalli,84400,65170,19230,0.2278436018957346,1
5568,5569,CV Raman Nagar,324600,35950,288650,0.8892483056069008,-1
5569,5570,Hebbal,228550,78080,150470,0.6583679719973747,0
5570,5571,Varthur,234000,26620,207380,0.8862393162393163,-1
5571,5572,Hoodi,362400,125120,237280,0.6547461368653421,0
5572,5573,Horamavu,311150,55920,255230,0.8202796079061546,0
5573,5574,Jalahalli,216650,112860,103790,0.47906762058619895,1
5574,5575,Kalyan Nagar,337400,38420,298980,0.8861292234736218,-1
5575,5576,Krishnarajapuram,432950,51980,380970,0.8799399468760827,-1
5576,5577,Jalahalli,337750,47430,290320,0.8595706883789785,-1
5577,5578,Mahadevapura,101600,45170,56430,0.5554133858267717,1
5578,5579,Kalyan Nagar,370200,40310,329890,0.8911129119394922,-1
5579,5580,Shivajinagar,25700,114200,-88500,-3.443579766536965,1
5580,5581,Krishnarajapuram,186900,35370,151530,0.8107544141252007,-1
5581,5582,CV Raman Nagar,440500,27840,412660,0.9367990919409762,-1
5582,5583,Hoodi,177550,50590,126960,0.715066178541256,-1
5583,5584,Kammanahalli,342500,5590,336910,0.9836788321167883,-1
5584,5585,Banaswadi,139100,28390,110710,0.795902228612509,0
5585,5586,Horamavu,315550,59640,255910,0.8109966724766281,-1
5586,5587,Indiranagar,130200,135800,-5600,-0.043010752688172046,1
5587,5588,Hoodi,26200,105350,-79150,-3.0209923664122136,1
5588,5589,Jalahalli,179250,65810,113440,0.6328591352859135,0
5589,5590,Vasanth Nagar,334400,66340,268060,0.8016148325358852,0
5590,5591,Krishnarajapuram,445450,21780,423670,0.9511056235267706,-1
5591,5592,Marathahalli,297750,33350,264400,0.8879932829554996,-1
5592,5593,CV Raman Nagar,29850,58280,-28430,-0.952428810720268,1
5593,5594,HBR Layout,418500,32890,385610,0.9214097968936679,-1
5594,5595,Shivajinagar,408300,25640,382660,0.9372030369826109,-1
5595,5596,Hebbal,155900,16940,138960,0.8913406029506094,-1
5596,5597,Mahadevapura,208400,68960,139440,0.6690978886756238,0
5597,5598,Whitefield,259000,82790,176210,0.6803474903474903,0
5598,5599,Hebbal,266050,79450,186600,0.7013719225709453,0
5599,5600,Vasanth Nagar,322900,57670,265230,0.8213998141839579,0
5600,5601,Malleswaram,124050,16230,107820,0.8691656590084643,0
5601,5602,Vasanth Nagar,231600,54520,177080,0.764594127806563,-1
5602,5603,Shivajinagar,137150,72770,64380,0.46941305140357276,1
5603,5604,Hoodi,121700,165390,-43690,-0.3589975349219392,1
5604,5605,Indiranagar,272700,32160,240540,0.8820682068206821,-1
5605,5606,Whitefield,182850,55160,127690,0.6983319660924255,0
5606,5607,Krishnarajapuram,155850,71210,84640,0.5430863009303818,0
5607,5608,Kalyan Nagar,410600,85660,324940,0.7913784705309304,0
5608,5609,Rajajinagar,204200,69610,134590,0.6591087169441724,0
5609,5610,Mahadevapura,259300,39320,219980,0.8483609718472811,-1
5610,5611,Malleswaram,213350,74920,138430,0.6488399343801265,0
5611,5612,Malleswaram,246600,103210,143390,0.5814679643146796,0
5612,5613,Shivajinagar,66950,35090,31860,0.4758775205377147,0
5613,5614,Indiranagar,317600,12260,305340,0.9613979848866498,-1
5614,5615,CV Raman Nagar,164750,71040,93710,0.5688012139605463,1
5615,5616,Shivajinagar,137350,13300,124050,0.9031670913724062,-1
5616,5617,Kammanahalli,250900,61760,189140,0.7538461538461538,0
5617,5618,Banaswadi,233750,70480,163270,0.6984812834224599,0
5618,5619,Whitefield,130900,46160,84740,0.6473644003055767,0
5619,5620,Varthur,332200,83460,248740,0.7487658037326912,0
5620,5621,Malleswaram,341450,145700,195750,0.5732903792648997,0
5621,5622,Malleswaram,97900,96520,1380,0.014096016343207354,1
5622,5623,Kalyan Nagar,383450,11790,371660,0.9692528360933629,-1
5623,5624,Whitefield,251250,67510,183740,0.7313034825870647,-1
5624,5625,Hebbal,287600,56620,230980,0.8031293463143254,-1
5625,5626,Jalahalli,123800,66560,57240,0.46235864297253637,1
5626,5627,Mahadevapura,150700,62930,87770,0.5824153948241539,0
5627,5628,Malleswaram,437400,42720,394680,0.9023319615912209,-1
5628,5629,Mahadevapura,95450,98480,-3030,-0.03174436877946569,1
5629,5630,Mahadevapura,198600,96600,102000,0.513595166163142,0
5630,5631,Marathahalli,273150,124330,148820,0.5448288486179754,0
5631,5632,Vasanth Nagar,246750,36590,210160,0.8517122593718338,0
5632,5633,Shivajinagar,289950,50510,239440,0.8257975513019487,-1
5633,5634,Krishnarajapuram,26150,109970,-83820,-3.205353728489484,1
5634,5635,CV Raman Nagar,63950,22930,41020,0.6414386239249413,0
5635,5636,Whitefield,47950,6910,41040,0.8558915537017727,-1
5636,5637,Kalyan Nagar,89700,73200,16500,0.18394648829431437,1
5637,5638,CV Raman Nagar,371700,66340,305360,0.8215227333871402,-1
5638,5639,Mahadevapura,225950,48130,177820,0.7869882717415357,0
5639,5640,Vasanth Nagar,155900,72330,83570,0.536048749198204,0
5640,5641,Jalahalli,342800,47990,294810,0.8600058343057176,-1
5641,5642,Varthur,363850,138500,225350,0.6193486326783015,0
5642,5643,Banaswadi,413950,34650,379300,0.9162942384345936,-1
5643,5644,HBR Layout,133200,64560,68640,0.5153153153153153,1
5644,5645,Hebbal,164400,151700,12700,0.07725060827250609,1
5645,5646,Horamavu,376100,39370,336730,0.8953203935123637,-1
5646,5647,Hoodi,353200,71070,282130,0.7987825594563986,0
5647,5648,Kalyan Nagar,169300,55440,113860,0.6725339633786178,0
5648,5649,HBR Layout,269600,28240,241360,0.8952522255192878,-1
5649,5650,Hebbal,275800,106620,169180,0.6134155184916606,0
5650,5651,Banaswadi,260650,66830,193820,0.7436025321312104,-1
5651,5652,Indiranagar,101650,0,101650,1.0,-1
5652,5653,Mahadevapura,332250,97270,234980,0.7072385252069225,-1
5653,5654,Marathahalli,393100,79210,313890,0.7984991096413127,-1
5654,5655,Marathahalli,409200,52270,356930,0.8722629521016618,-1
5655,5656,Varthur,142650,58210,84440,0.5919383105502979,0
5656,5657,CV Raman Nagar,264950,86910,178040,0.6719758444989621,0
5657,5658,Malleswaram,147800,55280,92520,0.6259810554803789,0
5658,5659,Kalyan Nagar,39550,141290,-101740,-2.5724399494310997,1
5659,5660,Malleswaram,168250,61800,106450,0.6326894502228826,0
5660,5661,Rajajinagar,99500,64720,34780,0.34954773869346734,1
5661,5662,Mahadevapura,157200,27720,129480,0.8236641221374046,-1
5662,5663,Hebbal,81800,30870,50930,0.6226161369193154,0
5663,5664,Jalahalli,38300,81680,-43380,-1.1326370757180158,1
5664,5665,Hebbal,61650,54610,7040,0.11419302514193025,1
5665,5666,Malleswaram,448950,72130,376820,0.8393362289787282,-1
5666,5667,Horamavu,209250,82240,127010,0.6069772998805257,0
5667,5668,Banaswadi,96500,75270,21230,0.22,1
5668,5669,Rajajinagar,301150,55580,245570,0.8154408102274614,-1
5669,5670,Jalahalli,431250,76600,354650,0.822376811594203,0
5670,5671,Hoodi,335900,50090,285810,0.8508782375707056,-1
5671,5672,Marathahalli,99450,93350,6100,0.06133735545500251,1
5672,5673,Horamavu,66350,104750,-38400,-0.5787490580256217,1
5673,5674,Jalahalli,445700,66930,378770,0.8498317253758133,-1
5674,5675,Horamavu,269150,106380,162770,0.6047557124280141,0
5675,5676,Jalahalli,136500,67540,68960,0.5052014652014652,0
5676,5677,Banaswadi,294000,83390,210610,0.716360544217687,0
5677,5678,Rajajinagar,429350,65120,364230,0.8483288692209153,-1
5678,5679,Shivajinagar,390600,45110,345490,0.8845110087045571,-1
5679,5680,Indiranagar,376200,62380,313820,0.8341839447102605,-1
5680,5681,Kalyan Nagar,438900,20210,418690,0.9539530644793802,-1
5681,5682,Malleswaram,318500,57070,261430,0.8208163265306122,0
5682,5683,Krishnarajapuram,30450,88530,-58080,-1.9073891625615764,1
5683,5684,Varthur,150250,78570,71680,0.4770715474209651,1
5684,5685,Malleswaram,233900,93810,140090,0.5989311671654554,0
5685,5686,Whitefield,221550,81550,140000,0.631911532385466,0
5686,5687,Malleswaram,179250,37900,141350,0.7885634588563459,0
5687,5688,Hoodi,417350,45700,371650,0.8904995806876722,-1
5688,5689,Krishnarajapuram,316150,54410,261740,0.8278981496125257,-1
5689,5690,Marathahalli,415550,66630,348920,0.8396582842016604,0
5690,5691,Malleswaram,400250,67940,332310,0.8302560899437851,-1
5691,5692,HBR Layout,310050,58320,251730,0.8119013062409289,-1
5692,5693,Kammanahalli,269150,69680,199470,0.7411109046999814,-1
5693,5694,Whitefield,124800,80480,44320,0.35512820512820514,1
5694,5695,Vasanth Nagar,288350,8950,279400,0.9689613317149298,-1
5695,5696,Krishnarajapuram,217750,77570,140180,0.6437657864523536,0
5696,5697,Kammanahalli,299750,0,299750,1.0,-1
5697,5698,Kammanahalli,351900,57820,294080,0.8356919579425973,-1
5698,5699,Mahadevapura,105500,52170,53330,0.5054976303317535,0
5699,5700,Marathahalli,383650,122190,261460,0.6815065815196142,0
5700,5701,Varthur,443200,112250,330950,0.7467283393501805,0
5701,5702,Hebbal,203000,133550,69450,0.34211822660098523,1
5702,5703,Hebbal,306200,63400,242800,0.7929457870672763,0
5703,5704,Rajajinagar,160350,32270,128080,0.7987527284066105,0
5704,5705,Jalahalli,53450,44760,8690,0.1625818521983162,1
5705,5706,Rajajinagar,412550,30840,381710,0.9252454247969943,-1
5706,5707,Kammanahalli,33700,19620,14080,0.41780415430267065,0
5707,5708,Varthur,373050,22600,350450,0.9394183085377296,-1
5708,5709,Indiranagar,105250,50720,54530,0.5180997624703088,0
5709,5710,Indiranagar,360900,69710,291190,0.8068440011083403,-1
5710,5711,Horamavu,62200,80180,-17980,-0.28906752411575565,1
5711,5712,Rajajinagar,370350,16450,353900,0.9555825570406372,-1
5712,5713,Whitefield,339500,58240,281260,0.8284536082474226,-1
5713,5714,HBR Layout,232200,53250,178950,0.770671834625323,-1
5714,5715,Banaswadi,161500,50030,111470,0.6902167182662539,0
5715,5716,Malleswaram,64350,31260,33090,0.5142191142191143,0
5716,5717,Indiranagar,284200,31290,252910,0.8899014778325123,-1
5717,5718,Krishnarajapuram,206400,52980,153420,0.7433139534883721,0
5718,5719,Shivajinagar,113200,121060,-7860,-0.06943462897526502,1
5719,5720,HBR Layout,246500,87830,158670,0.6436916835699797,0
5720,5721,Horamavu,228000,84580,143420,0.6290350877192983,0
5721,5722,Hebbal,370750,91710,279040,0.7526365475387727,-1
5722,5723,Shivajinagar,247250,10570,236680,0.9572497472194136,-1
5723,5724,CV Raman Nagar,196050,92580,103470,0.5277735271614384,1
5724,5725,Shivajinagar,296250,26210,270040,0.9115274261603376,-1
5725,5726,Horamavu,162100,53620,108480,0.6692165330043183,0
5726,5727,Vasanth Nagar,57250,3110,54140,0.9456768558951965,-1
5727,5728,Malleswaram,277100,46960,230140,0.8305304944063515,-1
5728,5729,Hoodi,204550,19550,185000,0.9044243461256416,-1
5729,5730,Jalahalli,59950,48450,11500,0.19182652210175147,1
5730,5731,Horamavu,160150,88920,71230,0.4447705276303465,0
5731,5732,Banaswadi,263550,94970,168580,0.6396509201290078,0
5732,5733,Vasanth Nagar,271700,47610,224090,0.8247699668752301,0
5733,5734,Kalyan Nagar,135850,62010,73840,0.5435406698564593,0
5734,5735,Krishnarajapuram,53000,47080,5920,0.11169811320754718,1
5735,5736,Malleswaram,106650,67020,39630,0.37158931082981717,1
5736,5737,HBR Layout,246100,83690,162410,0.6599349857781389,0
5737,5738,Vasanth Nagar,214550,82330,132220,0.6162666045210906,0
5738,5739,Horamavu,425400,80400,345000,0.8110014104372355,-1
5739,5740,Kalyan Nagar,174550,148510,26040,0.14918361501002578,1
5740,5741,Krishnarajapuram,353850,51760,302090,0.853723329094249,-1
5741,5742,Shivajinagar,438050,38220,399830,0.9127496861088917,-1
5742,5743,Varthur,426150,43350,382800,0.8982752551918338,-1
5743,5744,Hebbal,380600,54450,326150,0.8569364161849711,-1
5744,5745,Krishnarajapuram,270500,79590,190910,0.7057670979667283,0
5745,5746,Shivajinagar,256500,48820,207680,0.8096686159844054,-1
5746,5747,Whitefield,319100,54720,264380,0.8285177060482607,0
5747,5748,Rajajinagar,323900,42380,281520,0.8691571472676752,-1
5748,5749,Krishnarajapuram,207950,44650,163300,0.7852849242606396,0
5749,5750,Kalyan Nagar,280200,113900,166300,0.5935046395431834,1
5750,5751,Horamavu,235300,16610,218690,0.9294092647683808,-1
5751,5752,Marathahalli,424200,71920,352280,0.8304573314474305,0
5752,5753,Varthur,133300,28080,105220,0.7893473368342085,0
5753,5754,Horamavu,114950,36690,78260,0.680817746846455,0
5754,5755,Rajajinagar,405850,104900,300950,0.7415301219662437,0
5755,5756,Whitefield,116550,18280,98270,0.8431574431574431,0
5756,5757,Rajajinagar,75000,68100,6900,0.092,1
5757,5758,Mahadevapura,244850,61690,183160,0.7480498264243415,0
5758,5759,Indiranagar,124850,34040,90810,0.7273528233880657,0
5759,5760,Kammanahalli,104550,85770,18780,0.17962697274031564,1
5760,5761,CV Raman Nagar,168300,70880,97420,0.5788472964943553,1
5761,5762,Hoodi,426850,40350,386500,0.9054703057280075,-1
5762,5763,CV Raman Nagar,211850,68540,143310,0.6764691999055936,0
5763,5764,Kalyan Nagar,408700,11650,397050,0.9714949840959138,-1
5764,5765,Horamavu,270900,97860,173040,0.6387596899224807,0
5765,5766,Krishnarajapuram,306000,67770,238230,0.7785294117647059,0
5766,5767,Banaswadi,218050,47540,170510,0.7819766108690668,-1
5767,5768,Mahadevapura,25800,110080,-84280,-3.2666666666666666,1
5768,5769,HBR Layout,329100,15850,313250,0.9518383470069888,-1
5769,5770,Horamavu,124800,53750,71050,0.5693108974358975,0
5770,5771,Banaswadi,200150,88190,111960,0.5593804646515114,1
5771,5772,Malleswaram,449650,44510,405140,0.9010118981430001,-1
5772,5773,Hebbal,216850,60060,156790,0.7230343555453078,-1
5773,5774,Kalyan Nagar,271950,101880,170070,0.6253723110865969,0
5774,5775,HBR Layout,178850,71690,107160,0.59916130835896,1
5775,5776,CV Raman Nagar,237950,62450,175500,0.7375499054423198,-1
5776,5777,Malleswaram,338100,82690,255410,0.755427388346643,0
5777,5778,CV Raman Nagar,319950,57160,262790,0.8213470854821066,-1
5778,5779,Varthur,260900,63310,197590,0.7573399770026831,-1
5779,5780,Whitefield,288900,35940,252960,0.8755970924195223,-1
5780,5781,Hoodi,271800,61770,210030,0.7727373068432671,-1
5781,5782,Horamavu,172200,52590,119610,0.6945993031358885,0
5782,5783,Horamavu,38650,46120,-7470,-0.19327296248382925,1
5783,5784,Jalahalli,378850,36660,342190,0.9032334697109674,-1
5784,5785,Jalahalli,354700,69460,285240,0.8041725401747956,0
5785,5786,Malleswaram,147700,60640,87060,0.5894380501015573,0
5786,5787,Whitefield,406550,21500,385050,0.9471159758947238,-1
5787,5788,HBR Layout,244150,37540,206610,0.8462420643047307,-1
5788,5789,Krishnarajapuram,299100,36270,262830,0.8787362086258776,-1
5789,5790,HBR Layout,103900,19150,84750,0.8156881616939364,-1
5790,5791,Hebbal,354950,82690,272260,0.7670376109311171,-1
5791,5792,Hoodi,390350,43980,346370,0.8873318816446778,0
5792,5793,Indiranagar,226950,100290,126660,0.5580964970257766,1
5793,5794,Hebbal,345500,42100,303400,0.8781476121562952,-1
5794,5795,Krishnarajapuram,30200,79150,-48950,-1.6208609271523178,1
5795,5796,Hebbal,34050,18210,15840,0.46519823788546255,0
5796,5797,Krishnarajapuram,106150,13010,93140,0.8774375883184173,-1
5797,5798,Rajajinagar,56350,72370,-16020,-0.2842945874001775,1
5798,5799,Whitefield,249650,96030,153620,0.6153414780692971,0
5799,5800,Hebbal,60950,100620,-39670,-0.6508613617719442,1
5800,5801,Marathahalli,96200,64260,31940,0.332016632016632,1
5801,5802,Kammanahalli,90100,80640,9460,0.10499445061043285,1
5802,5803,Shivajinagar,247250,81560,165690,0.6701314459049545,0
5803,5804,Malleswaram,248950,48660,200290,0.8045390640690901,-1
5804,5805,Vasanth Nagar,127350,39720,87630,0.6881036513545348,0
5805,5806,Krishnarajapuram,425700,74080,351620,0.8259807376086445,-1
5806,5807,Hebbal,39550,40820,-1270,-0.03211125158027813,1
5807,5808,Krishnarajapuram,382150,84150,298000,0.7797985084390946,0
5808,5809,Shivajinagar,152800,93620,59180,0.38730366492146595,1
5809,5810,Malleswaram,398850,27950,370900,0.9299235301491788,-1
5810,5811,Hoodi,259600,10840,248760,0.9582434514637904,-1
5811,5812,Rajajinagar,395400,77720,317680,0.8034395548811331,-1
5812,5813,Varthur,418500,58760,359740,0.8595937873357228,-1
5813,5814,Krishnarajapuram,393900,35300,358600,0.9103833460269104,-1
5814,5815,Indiranagar,268650,18220,250430,0.932179415596501,-1
5815,5816,Krishnarajapuram,169850,79370,90480,0.5327053282307919,0
5816,5817,Whitefield,45050,98020,-52970,-1.1758046614872364,1
5817,5818,Marathahalli,199950,46180,153770,0.7690422605651412,0
5818,5819,Whitefield,155200,91860,63340,0.4081185567010309,1
5819,5820,Malleswaram,427200,80860,346340,0.8107209737827715,-1
5820,5821,CV Raman Nagar,416450,59190,357260,0.857870092448073,-1
5821,5822,Marathahalli,396350,2360,393990,0.9940456667087171,-1
5822,5823,Horamavu,392450,109060,283390,0.7221047267167792,-1
5823,5824,Shivajinagar,302150,13070,289080,0.9567433394009598,-1
5824,5825,Whitefield,149150,30070,119080,0.7983908816627556,0
5825,5826,Kammanahalli,217200,67510,149690,0.6891804788213628,0
5826,5827,Hebbal,423500,90670,332830,0.7859031877213696,0
5827,5828,Mahadevapura,114850,50840,64010,0.557335655202438,0
5828,5829,Whitefield,205500,77830,127670,0.6212652068126521,0
5829,5830,Hoodi,120600,28380,92220,0.7646766169154229,0
5830,5831,Malleswaram,418100,115780,302320,0.7230806027266204,0
5831,5832,Varthur,175550,166390,9160,0.05217886641982341,1
5832,5833,CV Raman Nagar,394500,47810,346690,0.878808618504436,0
5833,5834,Kammanahalli,210100,52870,157230,0.7483579247977153,0
5834,5835,Kalyan Nagar,353000,40370,312630,0.8856373937677053,-1
5835,5836,Vasanth Nagar,89650,69180,20470,0.22833240379252648,1
5836,5837,Mahadevapura,448000,94120,353880,0.7899107142857142,0
5837,5838,Jalahalli,430750,101410,329340,0.7645734184561811,-1
5838,5839,Krishnarajapuram,331000,36410,294590,0.89,-1
5839,5840,Banaswadi,39250,3400,35850,0.913375796178344,-1
5840,5841,HBR Layout,276500,46430,230070,0.8320795660036167,-1
5841,5842,Hoodi,96400,48110,48290,0.5009336099585062,0
5842,5843,Indiranagar,165500,61580,103920,0.6279154078549849,0
5843,5844,Rajajinagar,191750,77300,114450,0.596870925684485,1
5844,5845,Banaswadi,156800,65490,91310,0.5823341836734693,0
5845,5846,Varthur,200850,41470,159380,0.7935275080906149,0
5846,5847,Hebbal,380150,75990,304160,0.8001052216230435,0
5847,5848,Krishnarajapuram,198350,83450,114900,0.579279052180489,0
5848,5849,HBR Layout,188600,59520,129080,0.6844114528101802,0
5849,5850,Malleswaram,289300,121160,168140,0.5811959903214656,1
5850,5851,Hebbal,169200,56040,113160,0.6687943262411348,0
5851,5852,Mahadevapura,324000,82250,241750,0.746141975308642,0
5852,5853,Kalyan Nagar,223850,34710,189140,0.8449408085771722,-1
5853,5854,Jalahalli,92500,13860,78640,0.8501621621621621,-1
5854,5855,Vasanth Nagar,203000,70830,132170,0.6510837438423646,0
5855,5856,Kalyan Nagar,280150,133690,146460,0.5227913617704801,0
5856,5857,Rajajinagar,34850,121260,-86410,-2.47948350071736,1
5857,5858,Shivajinagar,27500,70960,-43460,-1.5803636363636364,1
5858,5859,Malleswaram,119850,79900,39950,0.3333333333333333,1
5859,5860,Vasanth Nagar,328100,45760,282340,0.8605303261200853,0
5860,5861,Shivajinagar,44500,48000,-3500,-0.07865168539325842,1
5861,5862,Whitefield,198800,34720,164080,0.8253521126760563,-1
5862,5863,Mahadevapura,59750,137670,-77920,-1.3041004184100418,1
5863,5864,Whitefield,365250,55800,309450,0.8472279260780288,-1
5864,5865,Hebbal,150650,48520,102130,0.6779289744440756,0
5865,5866,Krishnarajapuram,170100,62080,108020,0.6350382128159906,0
5866,5867,Kalyan Nagar,330250,94370,235880,0.7142467827403483,0
5867,5868,Horamavu,294300,28010,266290,0.9048250084947332,-1
5868,5869,Vasanth Nagar,448650,73350,375300,0.8365095285857572,0
5869,5870,Marathahalli,316200,57370,258830,0.8185641998734978,0
5870,5871,Shivajinagar,415400,68000,347400,0.8363023591718826,-1
5871,5872,Kalyan Nagar,339700,41910,297790,0.8766264350897851,-1
5872,5873,Kammanahalli,198250,40180,158070,0.7973266078184111,0
5873,5874,Vasanth Nagar,426100,42190,383910,0.9009856841117109,-1
5874,5875,Hebbal,318850,38220,280630,0.8801317233809001,-1
5875,5876,Marathahalli,153150,65690,87460,0.5710741103493308,0
5876,5877,Shivajinagar,135250,87520,47730,0.35290203327171904,1
5877,5878,Whitefield,204050,65020,139030,0.6813526096544964,0
5878,5879,Malleswaram,168650,134670,33980,0.20148235991698785,1
5879,5880,Whitefield,297000,67300,229700,0.7734006734006734,0
5880,5881,Varthur,331500,56070,275430,0.8308597285067874,-1
5881,5882,Rajajinagar,129700,0,129700,1.0,-1
5882,5883,Rajajinagar,124250,36530,87720,0.7059959758551307,-1
5883,5884,Hebbal,358650,50620,308030,0.8588596124355221,0
5884,5885,Marathahalli,243650,95270,148380,0.6089883028934948,0
5885,5886,HBR Layout,363600,52560,311040,0.8554455445544554,-1
5886,5887,Varthur,364200,132780,231420,0.6354200988467875,0
5887,5888,Indiranagar,196200,69880,126320,0.6438328236493374,0
5888,5889,Indiranagar,295200,52560,242640,0.8219512195121951,-1
5889,5890,Shivajinagar,33100,104770,-71670,-2.1652567975830816,1
5890,5891,Hoodi,340600,116050,224550,0.6592777451556078,0
5891,5892,Jalahalli,274450,67840,206610,0.7528147203497905,0
5892,5893,Rajajinagar,43550,56660,-13110,-0.3010332950631458,1
5893,5894,Kalyan Nagar,173900,84230,89670,0.5156411730879816,0
5894,5895,Vasanth Nagar,243750,80800,162950,0.6685128205128205,0
5895,5896,Mahadevapura,174750,59500,115250,0.6595135908440629,0
5896,5897,Shivajinagar,377200,64780,312420,0.8282608695652174,-1
5897,5898,CV Raman Nagar,302050,62250,239800,0.7939082933289191,-1
5898,5899,Krishnarajapuram,380000,45530,334470,0.8801842105263158,-1
5899,5900,Kalyan Nagar,267150,86220,180930,0.6772599663110612,0
5900,5901,Hoodi,194250,71570,122680,0.6315572715572716,0
5901,5902,Indiranagar,169000,58430,110570,0.6542603550295858,0
5902,5903,Vasanth Nagar,52500,48760,3740,0.07123809523809524,1
5903,5904,Kammanahalli,238600,95620,142980,0.5992455993294217,0
5904,5905,Banaswadi,140700,56150,84550,0.6009239516702203,0
5905,5906,Vasanth Nagar,222550,30320,192230,0.8637609525949225,-1
5906,5907,Kalyan Nagar,135550,25920,109630,0.8087790483216525,0
5907,5908,Hoodi,346000,91880,254120,0.7344508670520231,0
5908,5909,Marathahalli,86950,66100,20850,0.23979298447383554,1
5909,5910,Hoodi,49650,94110,-44460,-0.8954682779456193,1
5910,5911,Hoodi,267300,39590,227710,0.8518892630003742,-1
5911,5912,Banaswadi,44600,100690,-56090,-1.2576233183856502,1
5912,5913,Hoodi,366500,19080,347420,0.9479399727148704,-1
5913,5914,Jalahalli,153700,71900,81800,0.5322055953155498,0
5914,5915,Shivajinagar,137150,96160,40990,0.2988698505286183,1
5915,5916,Whitefield,79250,73330,5920,0.07470031545741325,1
5916,5917,Hoodi,73000,78600,-5600,-0.07671232876712329,1
5917,5918,Rajajinagar,33700,52730,-19030,-0.5646884272997033,1
5918,5919,Banaswadi,40950,56480,-15530,-0.37924297924297923,1
5919,5920,HBR Layout,419200,19820,399380,0.952719465648855,-1
5920,5921,Krishnarajapuram,402700,46330,356370,0.8849515768562205,-1
5921,5922,Jalahalli,157450,67590,89860,0.570720863766275,0
5922,5923,HBR Layout,158100,138120,19980,0.12637571157495256,1
5923,5924,Banaswadi,177050,44170,132880,0.7505224512849478,-1
5924,5925,Malleswaram,330850,112330,218520,0.6604805803234094,0
5925,5926,Krishnarajapuram,348850,37050,311800,0.8937938942238784,-1
5926,5927,Rajajinagar,338050,32020,306030,0.9052802839816595,-1
5927,5928,Hebbal,26600,70960,-44360,-1.6676691729323307,1
5928,5929,Shivajinagar,256050,59010,197040,0.7695371997656708,0
5929,5930,Mahadevapura,323050,59540,263510,0.8156941649899396,0
5930,5931,Vasanth Nagar,249100,35600,213500,0.8570855078281815,-1
5931,5932,Whitefield,172900,32520,140380,0.8119144013880856,-1
5932,5933,Kammanahalli,134850,5050,129800,0.9625509825732295,-1
5933,5934,Jalahalli,61250,88900,-27650,-0.4514285714285714,1
5934,5935,CV Raman Nagar,285650,57900,227750,0.7973043934885349,0
5935,5936,Jalahalli,131800,36870,94930,0.720257966616085,-1
5936,5937,Malleswaram,261150,52880,208270,0.7975110089986598,0
5937,5938,Kammanahalli,277500,104900,172600,0.621981981981982,0
5938,5939,Horamavu,98900,79650,19250,0.19464105156723963,1
5939,5940,Kammanahalli,423400,94720,328680,0.7762871988663202,0
5940,5941,Indiranagar,248550,80200,168350,0.6773285053309194,0
5941,5942,Banaswadi,254800,55000,199800,0.7841444270015698,-1
5942,5943,Kammanahalli,304150,89710,214440,0.7050468518822949,0
5943,5944,Banaswadi,219700,93160,126540,0.575967228038234,0
5944,5945,Mahadevapura,86950,101540,-14590,-0.16779758481886142,1
5945,5946,Malleswaram,82600,63540,19060,0.23075060532687652,1
5946,5947,Marathahalli,335750,71540,264210,0.7869247952345495,-1
5947,5948,Vasanth Nagar,376150,90520,285630,0.7593513226106606,-1
5948,5949,Shivajinagar,331750,7300,324450,0.9779954785229842,-1
5949,5950,Banaswadi,368100,101500,266600,0.7242597120347731,0
5950,5951,Whitefield,247000,82800,164200,0.6647773279352227,0
5951,5952,Jalahalli,59350,10610,48740,0.8212299915754002,-1
5952,5953,Horamavu,140000,69550,70450,0.5032142857142857,0
5953,5954,Vasanth Nagar,137150,93650,43500,0.3171709806780897,1
5954,5955,Varthur,103350,29880,73470,0.7108853410740203,-1
5955,5956,Indiranagar,408800,38610,370190,0.9055528375733856,-1
5956,5957,Rajajinagar,424450,45720,378730,0.8922841324066438,0
5957,5958,CV Raman Nagar,110150,96420,13730,0.12464820699046754,1
5958,5959,Mahadevapura,230600,65030,165570,0.7179965307892454,0
5959,5960,Hoodi,84100,143460,-59360,-0.7058263971462545,1
5960,5961,Mahadevapura,282700,82900,199800,0.7067562787407146,0
5961,5962,Jalahalli,242850,41650,201200,0.8284949557339921,-1
5962,5963,Kammanahalli,360350,38370,321980,0.8935201887054253,0
5963,5964,CV Raman Nagar,293500,30040,263460,0.897649063032368,-1
5964,5965,Mahadevapura,300050,91570,208480,0.6948175304115981,0
5965,5966,Kammanahalli,378550,90260,288290,0.7615638621054022,0
5966,5967,Banaswadi,107300,28980,78320,0.7299161230195713,0
5967,5968,Hebbal,136800,44070,92730,0.6778508771929824,0
5968,5969,Horamavu,27000,66010,-39010,-1.4448148148148148,1
5969,5970,Vasanth Nagar,239800,19180,220620,0.9200166805671393,-1
5970,5971,Kammanahalli,250650,130950,119700,0.47755834829443444,1
5971,5972,Kalyan Nagar,303100,31090,272010,0.8974265918838668,-1
5972,5973,CV Raman Nagar,317450,120860,196590,0.619278626555363,0
5973,5974,Mahadevapura,63150,32490,30660,0.4855106888361045,1
5974,5975,Horamavu,150250,14140,136110,0.9058901830282862,-1
5975,5976,CV Raman Nagar,424400,53690,370710,0.8734919886899152,-1
5976,5977,Hoodi,197000,32980,164020,0.8325888324873096,0
5977,5978,Indiranagar,339150,24760,314390,0.9269939554769276,-1
5978,5979,Mahadevapura,320900,20120,300780,0.9373013399813026,-1
5979,5980,CV Raman Nagar,372000,72210,299790,0.8058870967741936,0
5980,5981,Marathahalli,106400,85400,21000,0.19736842105263158,1
5981,5982,Vasanth Nagar,198900,30090,168810,0.8487179487179487,-1
5982,5983,Banaswadi,369500,75630,293870,0.79531799729364,0
5983,5984,Mahadevapura,404500,53890,350610,0.8667737948084054,-1
5984,5985,Kalyan Nagar,309600,48680,260920,0.842764857881137,-1
5985,5986,Shivajinagar,76850,95860,-19010,-0.24736499674690957,1
5986,5987,Banaswadi,204000,50370,153630,0.7530882352941176,-1
5987,5988,CV Raman Nagar,316650,78200,238450,0.7530396336649298,0
5988,5989,Shivajinagar,106200,84520,21680,0.2041431261770245,1
5989,5990,Kammanahalli,130550,41220,89330,0.6842589046342398,0
5990,5991,Kammanahalli,99450,20910,78540,0.7897435897435897,0
5991,5992,Jalahalli,174000,107760,66240,0.38068965517241377,1
5992,5993,Kalyan Nagar,315800,86930,228870,0.7247308423052565,-1
5993,5994,Malleswaram,411650,26300,385350,0.9361107737155351,-1
5994,5995,Jalahalli,45400,105760,-60360,-1.3295154185022027,1
5995,5996,Banaswadi,178900,59270,119630,0.6686975964225824,0
5996,5997,Kalyan Nagar,449100,37110,411990,0.9173680694722779,-1
5997,5998,Krishnarajapuram,202750,20760,181990,0.8976078914919852,0
5998,5999,Whitefield,295800,79500,216300,0.731237322515213,-1
5999,6000,Mahadevapura,235150,49030,186120,0.7914947905592176,0
6000,6001,Vasanth Nagar,408750,44950,363800,0.8900305810397553,0
6001,6002,Kalyan Nagar,366400,26780,339620,0.926910480349345,-1
6002,6003,Horamavu,302200,25260,276940,0.9164129715420252,-1
6003,6004,Whitefield,217400,20150,197250,0.9073137074517019,-1
6004,6005,Vasanth Nagar,112350,0,112350,1.0,-1
6005,6006,Marathahalli,131450,71400,60050,0.4568276911373146,1
6006,6007,Jalahalli,377450,77040,300410,0.7958934958272619,0
6007,6008,Vasanth Nagar,212150,49070,163080,0.7687013905255715,0
6008,6009,Shivajinagar,96750,93760,2990,0.03090439276485788,1
6009,6010,Hoodi,57400,36970,20430,0.3559233449477352,1
6010,6011,Rajajinagar,435700,84880,350820,0.8051870553132889,0
6011,6012,Kalyan Nagar,85850,73150,12700,0.14793244030285382,1
6012,6013,Hebbal,368050,21130,346920,0.9425893221029752,-1
6013,6014,Whitefield,249000,53950,195050,0.7833333333333333,0
6014,6015,Malleswaram,417350,67590,349760,0.8380495986582005,-1
6015,6016,CV Raman Nagar,52350,81510,-29160,-0.5570200573065902,1
6016,6017,HBR Layout,250550,124440,126110,0.5033326681301138,0
6017,6018,CV Raman Nagar,354100,53000,301100,0.8503247670149675,0
6018,6019,Kalyan Nagar,49450,104870,-55420,-1.1207280080889788,1
6019,6020,Hebbal,300500,51780,248720,0.8276871880199668,-1
6020,6021,Hebbal,299550,62450,237100,0.7915206142547154,0
6021,6022,Shivajinagar,87000,59680,27320,0.3140229885057471,1
6022,6023,CV Raman Nagar,165250,33910,131340,0.7947957639939486,0
6023,6024,Horamavu,416450,93230,323220,0.7761315884259815,0
6024,6025,Marathahalli,294950,37520,257430,0.8727919986438379,0
6025,6026,Jalahalli,415650,26290,389360,0.9367496691928305,-1
6026,6027,HBR Layout,91500,9710,81790,0.8938797814207651,-1
6027,6028,Kammanahalli,227050,88920,138130,0.6083682008368201,0
6028,6029,Shivajinagar,54250,94730,-40480,-0.7461751152073732,1
6029,6030,Whitefield,209350,103280,106070,0.5066634822068307,0
6030,6031,CV Raman Nagar,55800,13810,41990,0.7525089605734767,0
6031,6032,Whitefield,439250,74890,364360,0.8295048377916904,0
6032,6033,Varthur,246000,104660,141340,0.5745528455284553,0
6033,6034,Banaswadi,125350,50210,75140,0.5994415636218587,0
6034,6035,Hebbal,383250,52510,330740,0.8629876060013046,-1
6035,6036,Shivajinagar,302400,69330,233070,0.770734126984127,-1
6036,6037,Vasanth Nagar,245350,107810,137540,0.5605869166496841,0
6037,6038,Malleswaram,330100,112000,218100,0.6607088760981521,0
6038,6039,Rajajinagar,209300,77810,131490,0.6282369804108935,0
6039,6040,Mahadevapura,156250,75700,80550,0.51552,0
6040,6041,Whitefield,109600,75960,33640,0.30693430656934306,1
6041,6042,Jalahalli,44500,41980,2520,0.05662921348314607,1
6042,6043,Vasanth Nagar,307850,119860,187990,0.6106545395484814,0
6043,6044,CV Raman Nagar,270950,96800,174150,0.6427385126407086,0
6044,6045,Vasanth Nagar,162350,106710,55640,0.34271635355712965,1
6045,6046,CV Raman Nagar,351850,47580,304270,0.8647719198522098,-1
6046,6047,Rajajinagar,104100,102330,1770,0.017002881844380403,1
6047,6048,HBR Layout,233050,43390,189660,0.8138167775155546,-1
6048,6049,Hoodi,287400,46770,240630,0.8372651356993737,-1
6049,6050,CV Raman Nagar,373500,36120,337380,0.903293172690763,-1
6050,6051,Rajajinagar,358500,50190,308310,0.86,0
6051,6052,Horamavu,243050,86570,156480,0.6438181444147295,0
6052,6053,Horamavu,243000,55580,187420,0.7712757201646091,0
6053,6054,Malleswaram,72550,21880,50670,0.6984148862853204,0
6054,6055,CV Raman Nagar,353700,74100,279600,0.7905004240882103,-1
6055,6056,Kammanahalli,203200,34170,169030,0.8318405511811023,-1
6056,6057,Vasanth Nagar,260450,110930,149520,0.5740833173353811,0
6057,6058,Varthur,121350,80150,41200,0.3395138030490317,1
6058,6059,Marathahalli,41700,75110,-33410,-0.8011990407673861,1
6059,6060,Malleswaram,396800,50560,346240,0.8725806451612903,-1
6060,6061,Horamavu,375000,42230,332770,0.8873866666666667,0
6061,6062,Banaswadi,306050,112300,193750,0.6330664924032021,0
6062,6063,HBR Layout,194250,89890,104360,0.5372458172458172,1
6063,6064,CV Raman Nagar,315850,97150,218700,0.6924172866867184,0
6064,6065,Horamavu,50050,62400,-12350,-0.24675324675324675,1
6065,6066,Marathahalli,220950,82930,138020,0.6246662140755828,0
6066,6067,Indiranagar,214650,64100,150550,0.701374330305148,0
6067,6068,Hebbal,383900,25750,358150,0.9329252409481635,-1
6068,6069,Vasanth Nagar,142200,75200,67000,0.4711673699015471,0
6069,6070,Rajajinagar,133650,107440,26210,0.196109240553685,1
6070,6071,Rajajinagar,313900,58910,254990,0.8123287671232877,0
6071,6072,Hoodi,433950,71580,362370,0.83505012098168,-1
6072,6073,Jalahalli,445650,9180,436470,0.9794008751262201,-1
6073,6074,Marathahalli,314400,89900,224500,0.714058524173028,0
6074,6075,Banaswadi,363200,31040,332160,0.9145374449339208,-1
6075,6076,Marathahalli,262500,26440,236060,0.8992761904761905,0
6076,6077,Kammanahalli,322900,74320,248580,0.7698358624961288,0
6077,6078,Hoodi,427150,93980,333170,0.7799836123141753,0
6078,6079,Rajajinagar,173900,54220,119680,0.6882116158711903,0
6079,6080,Shivajinagar,84150,39820,44330,0.526797385620915,0
6080,6081,Horamavu,91450,134430,-42980,-0.46998359759431385,1
6081,6082,Malleswaram,134350,57460,76890,0.5723111276516561,0
6082,6083,Whitefield,71400,85160,-13760,-0.1927170868347339,1
6083,6084,Vasanth Nagar,128900,58130,70770,0.5490302560124127,0
6084,6085,Krishnarajapuram,398300,21670,376630,0.9455937735375345,-1
6085,6086,Hebbal,61100,79670,-18570,-0.3039279869067103,1
6086,6087,Shivajinagar,344850,64930,279920,0.8117152385094969,-1
6087,6088,Hoodi,329800,74220,255580,0.7749545178896301,-1
6088,6089,Whitefield,39400,67450,-28050,-0.7119289340101523,1
6089,6090,Shivajinagar,93400,33830,59570,0.6377944325481799,0
6090,6091,Jalahalli,394200,127200,267000,0.6773211567732116,0
6091,6092,Mahadevapura,218700,56660,162040,0.7409236396890718,0
6092,6093,Vasanth Nagar,25200,39450,-14250,-0.5654761904761905,1
6093,6094,Marathahalli,358000,89210,268790,0.7508100558659218,0
6094,6095,HBR Layout,325500,9230,316270,0.9716436251920123,-1
6095,6096,Whitefield,247100,78380,168720,0.6828004856333468,0
6096,6097,Jalahalli,387500,27930,359570,0.9279225806451613,-1
6097,6098,Horamavu,75350,45120,30230,0.40119442601194427,0
6098,6099,Varthur,316100,37400,278700,0.8816830117051566,0
6099,6100,Jalahalli,175550,31510,144040,0.8205069780689263,-1
6100,6101,Vasanth Nagar,77400,9190,68210,0.881266149870801,0
6101,6102,Vasanth Nagar,298600,75240,223360,0.7480241125251172,0
6102,6103,Banaswadi,54450,124370,-69920,-1.2841138659320477,1
6103,6104,Mahadevapura,408450,43460,364990,0.8935977475823235,-1
6104,6105,Marathahalli,256550,39380,217170,0.8465016565971546,-1
6105,6106,Hebbal,441250,49900,391350,0.8869121813031161,-1
6106,6107,Kammanahalli,195200,40140,155060,0.7943647540983606,0
6107,6108,Rajajinagar,182800,40430,142370,0.7788293216630197,-1
6108,6109,Rajajinagar,67600,37080,30520,0.4514792899408284,1
6109,6110,Malleswaram,207650,95560,112090,0.5398025523717794,0
6110,6111,Horamavu,134500,106930,27570,0.2049814126394052,1
6111,6112,CV Raman Nagar,269350,44630,224720,0.8343048078708001,-1
6112,6113,Vasanth Nagar,181800,20760,161040,0.8858085808580858,-1
6113,6114,Kammanahalli,419400,60970,358430,0.854625655698617,-1
6114,6115,Shivajinagar,122050,77410,44640,0.3657517410897173,1
6115,6116,Horamavu,212250,84040,128210,0.6040518256772673,0
6116,6117,Shivajinagar,413300,88800,324500,0.7851439632228405,0
6117,6118,Shivajinagar,34550,33450,1100,0.03183791606367583,1
6118,6119,Krishnarajapuram,257000,34740,222260,0.8648249027237354,0
6119,6120,Malleswaram,89500,27530,61970,0.6924022346368716,0
6120,6121,Hebbal,298750,34410,264340,0.8848200836820084,0
6121,6122,Vasanth Nagar,406600,15960,390640,0.9607476635514018,-1
6122,6123,Malleswaram,341100,19200,321900,0.9437115215479331,-1
6123,6124,Malleswaram,322650,24670,297980,0.9235394390206105,-1
6124,6125,Kammanahalli,405450,27920,377530,0.931138241460106,-1
6125,6126,Kalyan Nagar,51200,56890,-5690,-0.1111328125,1
6126,6127,Banaswadi,55100,57490,-2390,-0.04337568058076225,1
6127,6128,Whitefield,279000,38410,240590,0.8623297491039427,0
6128,6129,Banaswadi,357500,48400,309100,0.8646153846153846,-1
6129,6130,Whitefield,317900,75240,242660,0.7633217993079585,0
6130,6131,Krishnarajapuram,41700,116820,-75120,-1.8014388489208633,1
6131,6132,Hoodi,324900,189240,135660,0.41754385964912283,1
6132,6133,Kammanahalli,39250,67590,-28340,-0.7220382165605096,1
6133,6134,Whitefield,257750,103590,154160,0.5980989330746848,1
6134,6135,Hebbal,352450,37570,314880,0.8934033196198042,-1
6135,6136,Hoodi,320950,92570,228380,0.7115750116840629,-1
6136,6137,Vasanth Nagar,143000,72350,70650,0.49405594405594405,1
6137,6138,Indiranagar,448650,38560,410090,0.9140532709238828,-1
6138,6139,CV Raman Nagar,291450,63740,227710,0.7813003945788299,0
6139,6140,Vasanth Nagar,294050,12720,281330,0.9567420506716545,-1
6140,6141,Mahadevapura,385900,86720,299180,0.7752785695776108,0
6141,6142,Kalyan Nagar,64400,18290,46110,0.7159937888198757,0
6142,6143,Hebbal,192850,93150,99700,0.5169821104485351,0
6143,6144,Banaswadi,40050,93500,-53450,-1.33458177278402,1
6144,6145,Jalahalli,166200,62610,103590,0.6232851985559567,0
6145,6146,HBR Layout,43000,64930,-21930,-0.51,1
6146,6147,Indiranagar,180800,102420,78380,0.43351769911504423,1
6147,6148,Kalyan Nagar,62350,58830,3520,0.05645549318364074,1
6148,6149,Marathahalli,406600,19150,387450,0.9529021151008362,-1
6149,6150,Jalahalli,112900,70030,42870,0.37971656333038084,1
6150,6151,Krishnarajapuram,31700,57740,-26040,-0.8214511041009463,1
6151,6152,HBR Layout,379350,88410,290940,0.7669434559114274,0
6152,6153,Rajajinagar,49400,63340,-13940,-0.28218623481781374,1
6153,6154,Krishnarajapuram,421950,85720,336230,0.7968479677686929,-1
6154,6155,Mahadevapura,319400,63970,255430,0.799718221665623,-1
6155,6156,Kalyan Nagar,164650,28280,136370,0.8282417248709384,0
6156,6157,Malleswaram,427450,40130,387320,0.9061176745818225,-1
6157,6158,Banaswadi,445800,24460,421340,0.9451323463436518,-1
6158,6159,Indiranagar,383850,62070,321780,0.838296209456819,0
6159,6160,Horamavu,441500,51970,389530,0.8822876557191393,0
6160,6161,Mahadevapura,176450,69460,106990,0.6063474071975063,0
6161,6162,CV Raman Nagar,396400,32940,363460,0.9169021190716448,-1
6162,6163,Hoodi,337450,50300,287150,0.8509408801303897,-1
6163,6164,Hoodi,149650,157270,-7620,-0.0509188105579686,1
6164,6165,Marathahalli,65700,46990,18710,0.284779299847793,1
6165,6166,Whitefield,79400,50660,28740,0.3619647355163728,1
6166,6167,Kammanahalli,323650,42370,281280,0.8690869766723313,0
6167,6168,CV Raman Nagar,445850,50170,395680,0.8874733654816642,-1
6168,6169,Krishnarajapuram,317150,56350,260800,0.822323821535551,-1
6169,6170,Rajajinagar,286350,45740,240610,0.8402654094639427,-1
6170,6171,Hebbal,244600,82350,162250,0.6633278822567457,0
6171,6172,Krishnarajapuram,243700,24140,219560,0.9009437833401723,-1
6172,6173,Kalyan Nagar,195450,71420,124030,0.6345868508569966,0
6173,6174,Vasanth Nagar,249750,131630,118120,0.472952952952953,1
6174,6175,Shivajinagar,320900,35710,285190,0.8887192271735743,-1
6175,6176,Rajajinagar,428550,63110,365440,0.8527359701318399,-1
6176,6177,Jalahalli,179950,36270,143680,0.7984440122256182,0
6177,6178,Horamavu,81750,20840,60910,0.7450764525993884,0
6178,6179,Shivajinagar,176300,77200,99100,0.5621100397050482,0
6179,6180,Indiranagar,130150,69420,60730,0.466615443718786,1
6180,6181,Shivajinagar,277700,41890,235810,0.849153763053655,0
6181,6182,CV Raman Nagar,69350,50470,18880,0.2722422494592646,1
6182,6183,Jalahalli,206150,89200,116950,0.5673053601746301,0
6183,6184,Malleswaram,402000,78690,323310,0.8042537313432836,0
6184,6185,CV Raman Nagar,214350,60360,153990,0.7184044786564031,-1
6185,6186,HBR Layout,204900,59430,145470,0.7099560761346998,-1
6186,6187,Kammanahalli,425050,89410,335640,0.7896482766733326,-1
6187,6188,Whitefield,372100,103850,268250,0.7209083579682881,0
6188,6189,Hoodi,445300,79650,365650,0.8211318212441051,-1
6189,6190,Kammanahalli,213800,69330,144470,0.6757249766136576,0
6190,6191,Indiranagar,209200,165660,43540,0.20812619502868068,1
6191,6192,Rajajinagar,210850,60970,149880,0.710837087977235,-1
6192,6193,Kalyan Nagar,90600,85780,4820,0.0532008830022075,1
6193,6194,Kammanahalli,284800,57010,227790,0.7998244382022472,0
6194,6195,Horamavu,100850,75330,25520,0.253049082796232,1
6195,6196,Kammanahalli,226350,55460,170890,0.7549812237685001,0
6196,6197,Marathahalli,355800,61380,294420,0.8274873524451939,-1
6197,6198,Shivajinagar,372350,76950,295400,0.7933395998388613,-1
6198,6199,Banaswadi,439700,50030,389670,0.8862178758244258,0
6199,6200,Krishnarajapuram,268050,74140,193910,0.723409811602313,0
6200,6201,Rajajinagar,106000,82000,24000,0.22641509433962265,1
6201,6202,Krishnarajapuram,235800,12150,223650,0.9484732824427481,-1
6202,6203,Hebbal,259350,66970,192380,0.7417775207248891,0
6203,6204,CV Raman Nagar,210950,77680,133270,0.6317610808248401,0
6204,6205,Banaswadi,380600,36340,344260,0.9045191802417236,-1
6205,6206,Hoodi,160650,49670,110980,0.690818549642079,0
6206,6207,Marathahalli,376950,45200,331750,0.8800901976389441,-1
6207,6208,Hebbal,381050,60570,320480,0.8410444823513975,-1
6208,6209,Kalyan Nagar,144900,90500,54400,0.3754313319530711,1
6209,6210,Kammanahalli,311100,39750,271350,0.8722275795564127,-1
6210,6211,Indiranagar,138000,69470,68530,0.4965942028985507,1
6211,6212,Hebbal,445850,74480,371370,0.8329483009980936,0
6212,6213,Jalahalli,104200,82070,22130,0.21238003838771594,1
6213,6214,Jalahalli,434250,49500,384750,0.8860103626943006,0
6214,6215,Varthur,394300,66710,327590,0.8308141009383718,-1
6215,6216,Mahadevapura,272700,98790,173910,0.6377337733773377,0
6216,6217,Kammanahalli,227800,162240,65560,0.2877963125548727,1
6217,6218,Jalahalli,155350,16610,138740,0.8930801416157065,-1
6218,6219,Malleswaram,111400,11290,100110,0.898653500897666,0
6219,6220,Vasanth Nagar,194850,61660,133190,0.683551449833205,0
6220,6221,HBR Layout,216700,48480,168220,0.7762805722196585,-1
6221,6222,Horamavu,386900,79260,307640,0.7951408632721634,0
6222,6223,Kammanahalli,34050,70060,-36010,-1.0575624082232011,1
6223,6224,Kalyan Nagar,370400,7600,362800,0.9794816414686826,-1
6224,6225,Shivajinagar,134350,26280,108070,0.8043915147004094,-1
6225,6226,Mahadevapura,337750,90070,247680,0.7333234641006662,0
6226,6227,Whitefield,152250,53530,98720,0.6484072249589491,0
6227,6228,Krishnarajapuram,335050,78750,256300,0.7649604536636323,0
6228,6229,Kalyan Nagar,45400,76520,-31120,-0.6854625550660793,1
6229,6230,Krishnarajapuram,436750,131640,305110,0.6985918717801947,0
6230,6231,Varthur,293350,105530,187820,0.6402590761888529,0
6231,6232,Kalyan Nagar,256000,105720,150280,0.58703125,0
6232,6233,Malleswaram,446800,47650,399150,0.8933527305282005,-1
6233,6234,Kammanahalli,245050,31910,213140,0.8697816772087329,0
6234,6235,Indiranagar,190050,55190,134860,0.7096027361220731,0
6235,6236,Jalahalli,356450,78450,278000,0.7799130312806846,0
6236,6237,Jalahalli,29000,30490,-1490,-0.05137931034482759,1
6237,6238,CV Raman Nagar,293950,9680,284270,0.9670692294607927,-1
6238,6239,CV Raman Nagar,36550,37540,-990,-0.027086183310533515,1
6239,6240,HBR Layout,224900,109040,115860,0.5151622943530458,1
6240,6241,Marathahalli,391900,42200,349700,0.8923194692523603,-1
6241,6242,Marathahalli,184550,82770,101780,0.5515036575453807,1
6242,6243,Indiranagar,357550,68240,289310,0.8091455740455881,-1
6243,6244,Banaswadi,360800,37490,323310,0.8960920177383592,-1
6244,6245,Marathahalli,255900,41660,214240,0.8372020320437671,-1
6245,6246,Kalyan Nagar,364000,103330,260670,0.7161263736263737,0
6246,6247,Horamavu,113850,56800,57050,0.5010979358805446,0
6247,6248,Hoodi,199300,101730,97570,0.4895634721525339,0
6248,6249,Whitefield,368650,95470,273180,0.7410280754102807,0
6249,6250,Kammanahalli,299200,68070,231130,0.7724933155080214,-1
6250,6251,Rajajinagar,338900,69110,269790,0.7960755385069342,-1
6251,6252,Whitefield,238550,110420,128130,0.537120100607839,1
6252,6253,Marathahalli,428900,36720,392180,0.9143856376777804,-1
6253,6254,Varthur,265950,106530,159420,0.5994359842075578,0
6254,6255,Rajajinagar,95050,63210,31840,0.33498158863755917,1
6255,6256,Shivajinagar,37150,67220,-30070,-0.809421265141319,1
6256,6257,Shivajinagar,120900,152030,-31130,-0.2574855252274607,1
6257,6258,Marathahalli,140350,26770,113580,0.8092625578909868,-1
6258,6259,Horamavu,449250,87780,361470,0.8046076794657763,-1
6259,6260,Shivajinagar,312350,34840,277510,0.8884584600608292,0
6260,6261,CV Raman Nagar,221350,41490,179860,0.8125592952337927,0
6261,6262,Banaswadi,327100,55110,271990,0.8315194130235402,0
6262,6263,Varthur,256250,65500,190750,0.744390243902439,-1
6263,6264,Indiranagar,25150,34270,-9120,-0.36262425447316105,1
6264,6265,Mahadevapura,262050,85550,176500,0.6735355848120588,0
6265,6266,Whitefield,347650,0,347650,1.0,-1
6266,6267,Kammanahalli,182350,136550,45800,0.25116534137647384,1
6267,6268,Vasanth Nagar,323050,95960,227090,0.7029561987308466,0
6268,6269,Rajajinagar,35200,118760,-83560,-2.3738636363636365,1
6269,6270,Horamavu,35500,92150,-56650,-1.595774647887324,1
6270,6271,Whitefield,432550,79360,353190,0.8165298809386198,-1
6271,6272,Horamavu,309650,88030,221620,0.7157112869368643,0
6272,6273,Hebbal,27550,90270,-62720,-2.2765880217785845,1
6273,6274,Whitefield,447800,14220,433580,0.9682447521214828,-1
6274,6275,Mahadevapura,91550,33460,58090,0.6345166575641726,0
6275,6276,Shivajinagar,37100,75980,-38880,-1.0479784366576819,1
6276,6277,Shivajinagar,246000,103010,142990,0.581260162601626,1
6277,6278,HBR Layout,267850,54090,213760,0.7980586148963973,0
6278,6279,CV Raman Nagar,226300,54300,172000,0.760053026955369,0
6279,6280,Varthur,402600,108810,293790,0.7297317436661699,0
6280,6281,Jalahalli,126900,49450,77450,0.6103230890464934,0
6281,6282,Hoodi,271650,99760,171890,0.6327627461807472,0
6282,6283,Whitefield,432100,79560,352540,0.8158759546401296,-1
6283,6284,Kammanahalli,58350,65160,-6810,-0.1167095115681234,1
6284,6285,CV Raman Nagar,388450,66910,321540,0.8277513193461192,-1
6285,6286,Horamavu,273450,70370,203080,0.7426586213201682,-1
6286,6287,Hoodi,96150,35200,60950,0.6339053562142486,0
6287,6288,Hebbal,324250,119780,204470,0.6305936777178104,0
6288,6289,Jalahalli,134350,52260,82090,0.6110160029772981,0
6289,6290,HBR Layout,233300,112180,121120,0.5191598799828547,0
6290,6291,Malleswaram,262350,43400,218950,0.8345721364589289,0
6291,6292,Krishnarajapuram,115850,14110,101740,0.8782045748813121,0
6292,6293,Rajajinagar,241800,98640,143160,0.5920595533498759,0
6293,6294,Whitefield,446100,52270,393830,0.8828289621161175,-1
6294,6295,Krishnarajapuram,31450,46360,-14910,-0.4740858505564388,1
6295,6296,Horamavu,335900,75990,259910,0.7737719559392676,0
6296,6297,CV Raman Nagar,102100,84630,17470,0.17110675808031342,1
6297,6298,Varthur,64100,46830,17270,0.26942277691107647,1
6298,6299,Malleswaram,87450,77230,10220,0.11686678101772441,1
6299,6300,Hoodi,102450,41110,61340,0.5987310883357736,1
6300,6301,Vasanth Nagar,437250,93310,343940,0.7865980560320183,0
6301,6302,Marathahalli,127000,85360,41640,0.3278740157480315,1
6302,6303,Whitefield,358400,114800,243600,0.6796875,0
6303,6304,Hebbal,104450,45460,58990,0.5647678314983245,0
6304,6305,Mahadevapura,66900,41630,25270,0.37772795216741406,1
6305,6306,Kammanahalli,309000,22300,286700,0.927831715210356,-1
6306,6307,Kalyan Nagar,119650,104930,14720,0.12302549101546176,1
6307,6308,Whitefield,381250,53500,327750,0.8596721311475409,-1
6308,6309,Rajajinagar,447900,52620,395280,0.8825184192900201,-1
6309,6310,Mahadevapura,167950,85410,82540,0.49145579041381365,0
6310,6311,Mahadevapura,425650,17010,408640,0.9600375895688946,-1
6311,6312,Varthur,443900,10530,433370,0.9762784410903357,-1
6312,6313,Shivajinagar,149600,27210,122390,0.8181149732620321,-1
6313,6314,Shivajinagar,203500,45550,157950,0.7761670761670761,0
6314,6315,Whitefield,130850,29290,101560,0.7761559037065342,-1
6315,6316,Horamavu,76650,54700,21950,0.28636660143509457,1
6316,6317,Hebbal,41200,86650,-45450,-1.1031553398058251,1
6317,6318,Shivajinagar,414350,11520,402830,0.97219741764209,-1
6318,6319,Malleswaram,161300,98350,62950,0.3902665840049597,1
6319,6320,Indiranagar,150450,41350,109100,0.7251578597540711,-1
6320,6321,CV Raman Nagar,383900,54330,329570,0.8584787705131545,0
6321,6322,Marathahalli,445700,64780,380920,0.8546555979358312,-1
6322,6323,Whitefield,388650,48510,340140,0.8751833269008105,0
6323,6324,Marathahalli,374750,37340,337410,0.9003602401601067,-1
6324,6325,Marathahalli,299150,79440,219710,0.7344476015376902,0
6325,6326,Hebbal,335500,97060,238440,0.7107004470938897,0
6326,6327,Indiranagar,255900,5400,250500,0.9788980070339977,-1
6327,6328,Malleswaram,304550,76740,227810,0.7480216713183385,0
6328,6329,Kalyan Nagar,340900,31380,309520,0.9079495453212085,-1
6329,6330,HBR Layout,167800,95320,72480,0.43194278903456496,1
6330,6331,Hebbal,182100,101530,80570,0.442449203734212,0
6331,6332,Hebbal,64050,34830,29220,0.4562060889929742,1
6332,6333,Banaswadi,34200,81780,-47580,-1.3912280701754387,1
6333,6334,Hebbal,199550,60200,139350,0.6983212227511901,0
6334,6335,Mahadevapura,374750,51690,323060,0.8620680453635757,-1
6335,6336,Hoodi,242600,140940,101660,0.4190436933223413,1
6336,6337,Hebbal,120450,87120,33330,0.27671232876712326,1
6337,6338,Mahadevapura,27300,39370,-12070,-0.4421245421245421,1
6338,6339,Horamavu,379750,42270,337480,0.8886899275839368,-1
6339,6340,Indiranagar,183650,20930,162720,0.8860332153552954,-1
6340,6341,Hoodi,175050,71800,103250,0.5898314767209368,1
6341,6342,Banaswadi,43300,114580,-71280,-1.6461893764434181,1
6342,6343,Banaswadi,448200,53890,394310,0.8797634984381972,-1
6343,6344,Kalyan Nagar,262600,68850,193750,0.7378141660319878,0
6344,6345,Mahadevapura,47050,70610,-23560,-0.5007438894792774,1
6345,6346,HBR Layout,287550,97590,189960,0.6606155451225874,0
6346,6347,Mahadevapura,136650,123810,12840,0.09396267837541164,1
6347,6348,Hoodi,146650,86850,59800,0.40777361063757245,1
6348,6349,Indiranagar,74200,51420,22780,0.3070080862533693,1
6349,6350,CV Raman Nagar,430250,75570,354680,0.8243579314352121,-1
6350,6351,Jalahalli,264600,23230,241370,0.912207105064248,-1
6351,6352,Whitefield,383100,70650,312450,0.8155833985904464,0
6352,6353,Kalyan Nagar,75350,22200,53150,0.7053749170537492,0
6353,6354,CV Raman Nagar,286300,38040,248260,0.8671323786238212,-1
6354,6355,Mahadevapura,312550,109310,203240,0.6502639577667573,0
6355,6356,Hoodi,126600,49820,76780,0.606477093206951,0
6356,6357,Varthur,388950,78990,309960,0.7969147705360586,0
6357,6358,Malleswaram,88650,19240,69410,0.7829667230682459,0
6358,6359,Malleswaram,71200,9290,61910,0.8695224719101123,0
6359,6360,Varthur,164200,69870,94330,0.5744823386114495,1
6360,6361,Rajajinagar,439300,48180,391120,0.8903255178693376,-1
6361,6362,Jalahalli,213350,58660,154690,0.7250527302554488,0
6362,6363,Rajajinagar,67650,56250,11400,0.16851441241685144,1
6363,6364,Banaswadi,445300,52050,393250,0.883112508421289,0
6364,6365,CV Raman Nagar,396500,39950,356550,0.8992433795712484,0
6365,6366,CV Raman Nagar,442750,84510,358240,0.809124788255223,-1
6366,6367,Malleswaram,305250,84100,221150,0.7244881244881245,0
6367,6368,Shivajinagar,430050,53530,376520,0.8755261016160911,-1
6368,6369,CV Raman Nagar,227700,16490,211210,0.9275801493192798,-1
6369,6370,Rajajinagar,308150,46510,261640,0.8490670128184326,-1
6370,6371,Jalahalli,424100,21520,402580,0.949257250648432,-1
6371,6372,Horamavu,127800,67010,60790,0.4756651017214398,1
6372,6373,CV Raman Nagar,176400,55780,120620,0.6837868480725624,0
6373,6374,Hebbal,139050,106620,32430,0.2332254584681769,1
6374,6375,Jalahalli,335400,80070,255330,0.7612701252236136,0
6375,6376,Malleswaram,251600,91740,159860,0.6353736089030206,0
6376,6377,Indiranagar,401350,20840,380510,0.9480752460445995,-1
6377,6378,Kammanahalli,341200,63890,277310,0.812749120750293,0
6378,6379,Mahadevapura,109350,137700,-28350,-0.25925925925925924,1
6379,6380,Varthur,223250,45860,177390,0.7945800671892497,0
6380,6381,Hoodi,229500,80380,149120,0.649760348583878,0
6381,6382,Horamavu,218450,102590,115860,0.5303730830853742,0
6382,6383,Jalahalli,381750,46120,335630,0.8791879502292076,-1
6383,6384,Horamavu,150350,46730,103620,0.689191885600266,0
6384,6385,Hoodi,152650,113530,39120,0.2562725188339338,1
6385,6386,Hoodi,99250,39440,59810,0.6026196473551637,0
6386,6387,Varthur,197700,32250,165450,0.8368740515933232,-1
6387,6388,Jalahalli,340450,91530,248920,0.7311499485974445,-1
6388,6389,Horamavu,192450,71650,120800,0.6276955053260587,0
6389,6390,HBR Layout,43700,25360,18340,0.4196796338672769,1
6390,6391,Varthur,138200,82990,55210,0.39949348769898696,1
6391,6392,Jalahalli,338850,49510,289340,0.8538881510993065,0
6392,6393,Banaswadi,346450,71510,274940,0.7935921489392409,0
6393,6394,Kammanahalli,341650,61130,280520,0.821074198741402,-1
6394,6395,Horamavu,172300,40560,131740,0.7645966337782937,-1
6395,6396,Whitefield,99600,81920,17680,0.17751004016064256,1
6396,6397,Krishnarajapuram,287550,62410,225140,0.7829594853069032,-1
6397,6398,Horamavu,138150,44000,94150,0.681505609844372,0
6398,6399,Hebbal,409300,40740,368560,0.9004642071829954,-1
6399,6400,Whitefield,208850,42550,166300,0.7962652621498684,-1
6400,6401,Horamavu,346050,59390,286660,0.8283774021095217,-1
6401,6402,Shivajinagar,263900,110830,153070,0.5800303145130732,0
6402,6403,Krishnarajapuram,275300,100140,175160,0.6362513621503814,0
6403,6404,Banaswadi,279000,126820,152180,0.5454480286738351,1
6404,6405,Krishnarajapuram,153550,34960,118590,0.7723217193096711,0
6405,6406,Jalahalli,395350,55530,339820,0.859542177817124,0
6406,6407,Rajajinagar,170900,36730,134170,0.7850789935634874,0
6407,6408,Kammanahalli,381500,37250,344250,0.9023591087811271,-1
6408,6409,Vasanth Nagar,152150,34860,117290,0.7708839960565231,0
6409,6410,Varthur,429700,116260,313440,0.7294391435885501,0
6410,6411,Rajajinagar,204850,21140,183710,0.896802538442763,0
6411,6412,Whitefield,357000,101940,255060,0.7144537815126051,0
6412,6413,Kammanahalli,203100,54210,148890,0.7330871491875923,0
6413,6414,Banaswadi,57100,107450,-50350,-0.8817863397548161,1
6414,6415,Krishnarajapuram,229700,96430,133270,0.5801915542011319,1
6415,6416,CV Raman Nagar,240150,30850,209300,0.8715386216947741,-1
6416,6417,Mahadevapura,435950,35140,400810,0.9193944259662805,-1
6417,6418,Kalyan Nagar,87100,53660,33440,0.3839265212399541,1
6418,6419,Kammanahalli,146100,46510,99590,0.681656399726215,0
6419,6420,Marathahalli,304200,47090,257110,0.8452005259697567,-1
6420,6421,Krishnarajapuram,367650,28680,338970,0.9219910240718074,-1
6421,6422,Whitefield,336450,90790,245660,0.7301530688066578,0
6422,6423,CV Raman Nagar,113500,54570,58930,0.5192070484581498,1
6423,6424,Kalyan Nagar,303900,19030,284870,0.9373807173412306,-1
6424,6425,Hoodi,214800,40160,174640,0.8130353817504655,-1
6425,6426,CV Raman Nagar,53450,71520,-18070,-0.3380729653882133,1
6426,6427,Horamavu,270900,58300,212600,0.7847914359542266,0
6427,6428,Malleswaram,165150,88170,76980,0.46612170753860127,0
6428,6429,Marathahalli,300900,59380,241520,0.802658690594882,-1
6429,6430,Hoodi,169450,74330,95120,0.5613455296547654,0
6430,6431,Mahadevapura,299250,45940,253310,0.846482873851295,-1
6431,6432,Kammanahalli,254700,118490,136210,0.5347860227718885,0
6432,6433,Shivajinagar,42250,50550,-8300,-0.19644970414201182,1
6433,6434,Varthur,195400,27620,167780,0.8586489252814739,-1
6434,6435,CV Raman Nagar,254600,81040,173560,0.6816967792615868,0
6435,6436,Marathahalli,168750,85520,83230,0.49321481481481483,0
6436,6437,Kammanahalli,122300,15610,106690,0.8723630417007359,-1
6437,6438,CV Raman Nagar,235650,56420,179230,0.7605771270952684,0
6438,6439,Rajajinagar,63400,14310,49090,0.7742902208201893,0
6439,6440,Varthur,360000,59280,300720,0.8353333333333334,-1
6440,6441,Vasanth Nagar,27900,76670,-48770,-1.7480286738351254,1
6441,6442,Whitefield,426300,28400,397900,0.9333802486511846,-1
6442,6443,CV Raman Nagar,441800,93070,348730,0.7893390674513354,0
6443,6444,Krishnarajapuram,256800,97310,159490,0.6210669781931464,0
6444,6445,Marathahalli,242550,19070,223480,0.92137703566275,-1
6445,6446,Vasanth Nagar,216450,53520,162930,0.7527373527373528,0
6446,6447,Kammanahalli,58600,18900,39700,0.6774744027303754,0
6447,6448,Mahadevapura,377350,113740,263610,0.6985822180999073,0
6448,6449,Whitefield,353800,111370,242430,0.6852176370830978,0
6449,6450,Banaswadi,391600,106700,284900,0.7275280898876404,0
6450,6451,HBR Layout,404450,17040,387410,0.9578687105946347,-1
6451,6452,Krishnarajapuram,128200,24880,103320,0.8059282371294851,0
6452,6453,Shivajinagar,261800,54140,207660,0.7932009167303284,0
6453,6454,Rajajinagar,370100,39930,330170,0.8921102404755471,-1
6454,6455,Shivajinagar,426600,89650,336950,0.7898499765588373,0
6455,6456,Hoodi,419550,95420,324130,0.7725658443570492,0
6456,6457,Kammanahalli,219400,35450,183950,0.8384229717411121,-1
6457,6458,Indiranagar,222200,47400,174800,0.7866786678667866,0
6458,6459,Jalahalli,39650,33090,6560,0.16544766708701136,1
6459,6460,Kalyan Nagar,236250,119780,116470,0.492994708994709,1
6460,6461,Krishnarajapuram,84850,43460,41390,0.4878020035356512,1
6461,6462,HBR Layout,184100,69440,114660,0.6228136882129277,0
6462,6463,Vasanth Nagar,88100,57970,30130,0.3419977298524404,1
6463,6464,Whitefield,275700,65710,209990,0.7616612259702575,-1
6464,6465,Horamavu,396100,60730,335370,0.8466801312799798,0
6465,6466,Horamavu,316700,91570,225130,0.7108620145247868,0
6466,6467,Kammanahalli,372200,62200,310000,0.8328855454056958,-1
6467,6468,Krishnarajapuram,72850,56060,16790,0.2304735758407687,1
6468,6469,Horamavu,414300,118020,296280,0.7151339608979,0
6469,6470,Varthur,354400,84210,270190,0.7623871331828442,0
6470,6471,CV Raman Nagar,133300,7430,125870,0.9442610652663166,-1
6471,6472,Kalyan Nagar,166800,112410,54390,0.3260791366906475,1
6472,6473,Varthur,45650,61840,-16190,-0.35465498357064623,1
6473,6474,Whitefield,48750,40700,8050,0.16512820512820514,1
6474,6475,Mahadevapura,365900,0,365900,1.0,-1
6475,6476,HBR Layout,347650,95650,252000,0.7248669639004747,0
6476,6477,Kalyan Nagar,202950,74300,128650,0.63389997536339,0
6477,6478,Shivajinagar,219750,105860,113890,0.5182707622298066,0
6478,6479,Rajajinagar,424350,160050,264300,0.6228349240014139,0
6479,6480,Jalahalli,406500,39290,367210,0.9033456334563346,-1
6480,6481,Kalyan Nagar,114750,95490,19260,0.16784313725490196,1
6481,6482,Whitefield,112800,68150,44650,0.3958333333333333,1
6482,6483,Indiranagar,422500,15680,406820,0.9628875739644971,-1
6483,6484,Vasanth Nagar,308750,73710,235040,0.7612631578947369,0
6484,6485,Kalyan Nagar,361450,87770,273680,0.7571724996541707,0
6485,6486,Varthur,176650,124940,51710,0.2927257288423436,1
6486,6487,Krishnarajapuram,208550,15640,192910,0.9250059937664828,-1
6487,6488,Hebbal,445000,44200,400800,0.9006741573033707,-1
6488,6489,Vasanth Nagar,123150,55740,67410,0.5473812423873325,0
6489,6490,Kammanahalli,341900,65840,276060,0.8074290728283123,-1
6490,6491,CV Raman Nagar,132200,55330,76870,0.5814674735249622,1
6491,6492,CV Raman Nagar,45000,90950,-45950,-1.021111111111111,1
6492,6493,Kammanahalli,143550,175440,-31890,-0.22215256008359457,1
6493,6494,Whitefield,262800,60740,202060,0.7688736681887367,-1
6494,6495,Vasanth Nagar,279200,65340,213860,0.765974212034384,0
6495,6496,Shivajinagar,357150,36720,320430,0.8971860562788744,-1
6496,6497,HBR Layout,88650,110220,-21570,-0.24331641285956007,1
6497,6498,Horamavu,212600,48380,164220,0.7724365004703669,-1
6498,6499,Varthur,176250,41070,135180,0.7669787234042553,-1
6499,6500,Shivajinagar,283450,101330,182120,0.6425119068618804,0
6500,6501,Malleswaram,439700,37150,402550,0.915510575392313,-1
6501,6502,CV Raman Nagar,423400,62460,360940,0.852479924421351,0
6502,6503,Horamavu,163200,25920,137280,0.8411764705882353,-1
6503,6504,Banaswadi,256400,76350,180050,0.7022230889235569,0
6504,6505,Hoodi,85000,63490,21510,0.2530588235294118,1
6505,6506,Banaswadi,207000,63890,143110,0.691352657004831,0
6506,6507,Mahadevapura,232900,62760,170140,0.7305281236582224,0
6507,6508,Malleswaram,362500,49850,312650,0.8624827586206897,-1
6508,6509,Marathahalli,416650,69290,347360,0.8336973478939158,-1
6509,6510,Horamavu,355650,8830,346820,0.9751722198790946,-1
6510,6511,CV Raman Nagar,99250,47890,51360,0.5174811083123426,0
6511,6512,HBR Layout,195200,75600,119600,0.6127049180327869,0
6512,6513,Shivajinagar,290650,13640,277010,0.9530707035953896,-1
6513,6514,Rajajinagar,393950,68220,325730,0.8268308160934129,-1
6514,6515,Banaswadi,426950,77100,349850,0.8194167935355428,0
6515,6516,Kammanahalli,65250,88920,-23670,-0.3627586206896552,1
6516,6517,CV Raman Nagar,149750,29910,119840,0.8002671118530885,-1
6517,6518,Jalahalli,220450,18090,202360,0.9179405760943524,-1
6518,6519,Banaswadi,300800,43490,257310,0.8554188829787234,-1
6519,6520,Whitefield,405600,77870,327730,0.8080128205128205,0
6520,6521,Krishnarajapuram,354650,29720,324930,0.916199069505146,-1
6521,6522,Krishnarajapuram,62600,6650,55950,0.8937699680511182,0
6522,6523,Horamavu,186300,103690,82610,0.44342458400429413,1
6523,6524,Mahadevapura,239500,29740,209760,0.8758246346555324,-1
6524,6525,Kalyan Nagar,314650,68410,246240,0.7825838232957254,-1
6525,6526,Jalahalli,168200,95570,72630,0.431807372175981,1
6526,6527,Krishnarajapuram,96950,73930,23020,0.23744198040226921,1
6527,6528,CV Raman Nagar,387750,60210,327540,0.8447195357833656,-1
6528,6529,Indiranagar,224850,98850,126000,0.5603735823882589,0
6529,6530,Vasanth Nagar,313100,9190,303910,0.9706483551580964,-1
6530,6531,Hebbal,29550,29120,430,0.01455160744500846,1
6531,6532,Whitefield,230600,114600,116000,0.5030355594102341,0
6532,6533,Varthur,303550,32710,270840,0.8922418053039038,0
6533,6534,CV Raman Nagar,86200,64260,21940,0.2545243619489559,1
6534,6535,Horamavu,311100,34860,276240,0.8879459980713597,-1
6535,6536,Hoodi,404100,28730,375370,0.928903736698837,-1
6536,6537,Malleswaram,201950,59900,142050,0.7033919286952216,-1
6537,6538,Kammanahalli,405950,35890,370060,0.9115900973026235,-1
6538,6539,Krishnarajapuram,37450,43610,-6160,-0.16448598130841122,1
6539,6540,Indiranagar,355350,46430,308920,0.8693400872379344,-1
6540,6541,Horamavu,34750,134780,-100030,-2.8785611510791367,1
6541,6542,Rajajinagar,192400,56790,135610,0.7048336798336798,0
6542,6543,Horamavu,25600,116160,-90560,-3.5375,1
6543,6544,Marathahalli,248100,63250,184850,0.7450624748085449,-1
6544,6545,Mahadevapura,61100,42050,19050,0.3117839607201309,1
6545,6546,Indiranagar,250700,54890,195810,0.7810530514559234,0
6546,6547,CV Raman Nagar,52750,50180,2570,0.04872037914691943,1
6547,6548,Kammanahalli,286650,43670,242980,0.847653933368219,0
6548,6549,Whitefield,186450,102270,84180,0.4514883346741754,1
6549,6550,Marathahalli,437000,89370,347630,0.7954919908466819,0
6550,6551,Rajajinagar,388000,56990,331010,0.8531185567010309,0
6551,6552,Hebbal,200500,13050,187450,0.9349127182044887,-1
6552,6553,Vasanth Nagar,72600,35500,37100,0.5110192837465565,0
6553,6554,Marathahalli,328100,26310,301790,0.9198110332215788,-1
6554,6555,Hoodi,317700,38760,278940,0.8779981114258735,-1
6555,6556,Whitefield,71950,69400,2550,0.035441278665740095,1
6556,6557,Banaswadi,391550,92190,299360,0.7645511428936279,0
6557,6558,Malleswaram,287750,72910,214840,0.7466203301476977,-1
6558,6559,Hebbal,101950,40290,61660,0.6048062775870525,0
6559,6560,Horamavu,186550,82070,104480,0.5600643259179845,0
6560,6561,Shivajinagar,317200,80170,237030,0.7472572509457756,-1
6561,6562,Whitefield,436800,45020,391780,0.8969322344322345,-1
6562,6563,Marathahalli,224300,69510,154790,0.6901025412394115,0
6563,6564,Kammanahalli,279800,86830,192970,0.6896711937097927,0
6564,6565,Kammanahalli,142000,47880,94120,0.6628169014084507,0
6565,6566,CV Raman Nagar,155400,49020,106380,0.6845559845559845,0
6566,6567,Shivajinagar,395750,77090,318660,0.8052053063802906,-1
6567,6568,Hebbal,430150,55810,374340,0.8702545623619667,-1
6568,6569,Kammanahalli,315400,64690,250710,0.7948953709575143,-1
6569,6570,Shivajinagar,301550,43450,258100,0.8559111258497761,-1
6570,6571,Whitefield,313950,36510,277440,0.883707596751075,-1
6571,6572,Banaswadi,50650,54570,-3920,-0.0773938795656466,1
6572,6573,HBR Layout,401900,125190,276710,0.6885046031351082,0
6573,6574,Horamavu,87200,13010,74190,0.8508027522935779,-1
6574,6575,Varthur,431050,8210,422840,0.9809534856745157,-1
6575,6576,CV Raman Nagar,65450,21770,43680,0.667379679144385,0
6576,6577,Jalahalli,263550,69930,193620,0.7346613545816733,0
6577,6578,HBR Layout,383200,32390,350810,0.9154749478079331,-1
6578,6579,Hebbal,324400,75580,248820,0.7670160295930949,0
6579,6580,Kalyan Nagar,378350,50070,328280,0.8676622175234571,0
6580,6581,Hoodi,175850,100310,75540,0.42957065680978107,0
6581,6582,Banaswadi,301800,86780,215020,0.7124585818422796,0
6582,6583,Banaswadi,316550,67690,248860,0.7861633233296478,-1
6583,6584,Banaswadi,407550,70130,337420,0.8279229542387437,-1
6584,6585,Krishnarajapuram,41450,73340,-31890,-0.7693606755126658,1
6585,6586,CV Raman Nagar,367750,103960,263790,0.7173079537729435,0
6586,6587,Hebbal,158150,36210,121940,0.7710401517546633,0
6587,6588,Hebbal,339850,41670,298180,0.8773870825364132,-1
6588,6589,Krishnarajapuram,143550,34070,109480,0.7626610936955764,0
6589,6590,Krishnarajapuram,396350,85280,311070,0.7848366342878769,-1
6590,6591,Hebbal,151250,36500,114750,0.7586776859504132,-1
6591,6592,Hoodi,385650,21730,363920,0.9436535718916116,-1
6592,6593,Malleswaram,292250,32320,259930,0.8894097519247219,-1
6593,6594,Banaswadi,255250,138150,117100,0.45876591576885406,0
6594,6595,Rajajinagar,321600,72230,249370,0.7754042288557214,0
6595,6596,Whitefield,137100,84290,52810,0.3851932895696572,1
6596,6597,HBR Layout,41750,40660,1090,0.026107784431137725,1
6597,6598,Hoodi,54450,98970,-44520,-0.8176308539944903,1
6598,6599,HBR Layout,63350,73550,-10200,-0.16101026045777428,1
6599,6600,Horamavu,365650,59970,305680,0.8359907014904964,-1
6600,6601,Kalyan Nagar,388100,36330,351770,0.9063901056428756,-1
6601,6602,Mahadevapura,400250,35650,364600,0.9109306683322923,-1
6602,6603,Varthur,270900,1310,269590,0.9951642672572905,-1
6603,6604,Hebbal,40400,105050,-64650,-1.6002475247524752,1
6604,6605,Hebbal,25000,77890,-52890,-2.1156,1
6605,6606,Krishnarajapuram,238650,35040,203610,0.853174104336895,-1
6606,6607,Mahadevapura,264900,30140,234760,0.8862212155530389,-1
6607,6608,Banaswadi,80050,19240,60810,0.7596502186133667,-1
6608,6609,Hebbal,312900,46160,266740,0.8524768296580377,-1
6609,6610,Kammanahalli,91750,171780,-80030,-0.8722615803814714,1
6610,6611,Indiranagar,77800,79750,-1950,-0.02506426735218509,1
6611,6612,Whitefield,414150,12250,401900,0.970421344923337,-1
6612,6613,Vasanth Nagar,309500,92930,216570,0.6997415185783522,0
6613,6614,Hebbal,308650,69010,239640,0.7764134132512555,-1
6614,6615,Jalahalli,301700,23530,278170,0.9220086178322837,-1
6615,6616,Banaswadi,277900,23140,254760,0.9167326376394387,-1
6616,6617,Mahadevapura,429800,47580,382220,0.8892973476035365,-1
6617,6618,Varthur,311150,30170,280980,0.903037120359955,-1
6618,6619,Rajajinagar,36600,85000,-48400,-1.3224043715846994,1
6619,6620,Rajajinagar,256300,56510,199790,0.7795161919625438,-1
6620,6621,Marathahalli,275300,72810,202490,0.735524881946967,0
6621,6622,Varthur,300650,80970,219680,0.7306835190420755,0
6622,6623,Rajajinagar,423050,70010,353040,0.8345112870819053,-1
6623,6624,Shivajinagar,43200,105390,-62190,-1.4395833333333334,1
6624,6625,Varthur,293450,92270,201180,0.6855682399045834,0
6625,6626,Horamavu,203950,67140,136810,0.6708016670752636,0
6626,6627,Mahadevapura,98200,34710,63490,0.6465376782077393,0
6627,6628,Indiranagar,235800,121770,114030,0.48358778625954196,0
6628,6629,Vasanth Nagar,49950,65910,-15960,-0.3195195195195195,1
6629,6630,Hebbal,327000,77830,249170,0.7619877675840978,0
6630,6631,Rajajinagar,105950,45730,60220,0.5683813119395942,1
6631,6632,Kalyan Nagar,53750,153580,-99830,-1.8573023255813954,1
6632,6633,Banaswadi,146900,23310,123590,0.8413206262763785,0
6633,6634,HBR Layout,379450,12080,367370,0.9681644485439452,-1
6634,6635,CV Raman Nagar,334200,83150,251050,0.7511968880909635,0
6635,6636,Kalyan Nagar,156400,75900,80500,0.5147058823529411,0
6636,6637,Whitefield,368200,34830,333370,0.9054046713742532,-1
6637,6638,Varthur,229600,55400,174200,0.7587108013937283,0
6638,6639,Kammanahalli,360600,60010,300590,0.8335829173599556,-1
6639,6640,Varthur,183250,61820,121430,0.6626466575716234,0
6640,6641,Hebbal,237350,56600,180750,0.7615336001685274,0
6641,6642,Indiranagar,110500,41140,69360,0.6276923076923077,0
6642,6643,Rajajinagar,163150,24500,138650,0.8498314434569415,-1
6643,6644,Whitefield,180250,22080,158170,0.8775034674063801,-1
6644,6645,Varthur,391650,61760,329890,0.8423081833269501,-1
6645,6646,Horamavu,437700,35280,402420,0.919396847155586,-1
6646,6647,Mahadevapura,315600,62860,252740,0.8008238276299113,-1
6647,6648,Varthur,344600,81980,262620,0.7621009866511897,0
6648,6649,Hoodi,412000,61780,350220,0.8500485436893204,-1
6649,6650,Kammanahalli,93200,23940,69260,0.7431330472103004,-1
6650,6651,Horamavu,119050,62840,56210,0.4721545569088618,1
6651,6652,Vasanth Nagar,367750,92390,275360,0.7487695445275323,0
6652,6653,Mahadevapura,204850,55030,149820,0.731364412985111,0
6653,6654,Marathahalli,347450,65820,281630,0.8105626708878976,-1
6654,6655,Kammanahalli,68900,21170,47730,0.6927431059506531,0
6655,6656,Krishnarajapuram,370500,68160,302340,0.8160323886639677,0
6656,6657,Vasanth Nagar,36800,34520,2280,0.06195652173913044,1
6657,6658,Vasanth Nagar,312100,25960,286140,0.9168215315603974,-1
6658,6659,Hebbal,429350,84210,345140,0.8038663095376732,-1
6659,6660,Rajajinagar,147250,28020,119230,0.8097113752122241,0
6660,6661,Whitefield,92700,84070,8630,0.09309600862998921,1
6661,6662,HBR Layout,165600,56500,109100,0.658816425120773,0
6662,6663,Rajajinagar,188100,35840,152260,0.8094630515683148,-1
6663,6664,Horamavu,267900,70560,197340,0.7366181410974244,0
6664,6665,CV Raman Nagar,415850,24880,390970,0.9401707346398942,-1
6665,6666,Horamavu,193600,51050,142550,0.7363119834710744,-1
6666,6667,Marathahalli,53050,92290,-39240,-0.7396795475966069,1
6667,6668,Marathahalli,202150,75670,126480,0.6256740044521395,0
6668,6669,CV Raman Nagar,328100,28590,299510,0.912861932337702,-1
6669,6670,Hebbal,412950,85660,327290,0.792565685918392,0
6670,6671,Shivajinagar,369800,45430,324370,0.8771498107084911,0
6671,6672,Mahadevapura,164500,74170,90330,0.5491185410334346,0
6672,6673,Shivajinagar,290850,111420,179430,0.61691593604951,0
6673,6674,Kalyan Nagar,307150,58910,248240,0.8082044603613869,-1
6674,6675,Marathahalli,79600,43190,36410,0.45741206030150755,1
6675,6676,Krishnarajapuram,42600,81090,-38490,-0.9035211267605634,1
6676,6677,CV Raman Nagar,99500,17820,81680,0.8209045226130653,-1
6677,6678,Kammanahalli,424950,28890,396060,0.9320155312389693,-1
6678,6679,Hebbal,151450,64050,87400,0.5770881479035985,1
6679,6680,Varthur,53800,59730,-5930,-0.11022304832713754,1
6680,6681,Kammanahalli,333550,51890,281660,0.8444311197721481,-1
6681,6682,Whitefield,187600,82360,105240,0.5609808102345416,1
6682,6683,Horamavu,194750,71740,123010,0.6316302952503209,0
6683,6684,Mahadevapura,44850,70460,-25610,-0.5710144927536231,1
6684,6685,Krishnarajapuram,262600,71670,190930,0.7270753998476771,-1
6685,6686,Krishnarajapuram,408750,0,408750,1.0,-1
6686,6687,Jalahalli,200500,52500,148000,0.7381546134663342,-1
6687,6688,Kammanahalli,206500,45700,160800,0.7786924939467312,0
6688,6689,Hebbal,156500,47660,108840,0.6954632587859425,0
6689,6690,Shivajinagar,220200,122670,97530,0.4429155313351499,1
6690,6691,Malleswaram,356500,34290,322210,0.9038148667601683,-1
6691,6692,Mahadevapura,41400,20850,20550,0.4963768115942029,1
6692,6693,Malleswaram,197550,100140,97410,0.49309035687167807,0
6693,6694,Hebbal,296600,67350,229250,0.7729265003371544,0
6694,6695,Indiranagar,230850,20740,210110,0.910158111327702,-1
6695,6696,Whitefield,255350,32210,223140,0.8738594086547875,0
6696,6697,Banaswadi,133050,70030,63020,0.4736565201052236,1
6697,6698,Krishnarajapuram,89850,38460,51390,0.5719532554257095,1
6698,6699,Hebbal,162950,78480,84470,0.5183798711261123,0
6699,6700,Vasanth Nagar,242150,66060,176090,0.7271938880858971,-1
6700,6701,Indiranagar,243800,106650,137150,0.5625512715340443,0
6701,6702,Hoodi,221850,64190,157660,0.7106603560964616,0
6702,6703,HBR Layout,280150,25910,254240,0.9075138318757808,-1
6703,6704,Kalyan Nagar,133500,40440,93060,0.6970786516853933,0
6704,6705,Jalahalli,378600,75510,303090,0.8005546751188589,-1
6705,6706,Kammanahalli,411800,28830,382970,0.9299902865468674,-1
6706,6707,Marathahalli,447000,97860,349140,0.7810738255033557,0
6707,6708,Hebbal,330550,106530,224020,0.6777189532597186,0
6708,6709,Hebbal,134900,29780,105120,0.7792438843587843,0
6709,6710,Jalahalli,310800,126670,184130,0.5924388674388674,1
6710,6711,Indiranagar,298650,139870,158780,0.5316591327641051,0
6711,6712,Hoodi,380400,62190,318210,0.8365141955835962,-1
6712,6713,Vasanth Nagar,379700,76360,303340,0.7988938635765078,0
6713,6714,CV Raman Nagar,44850,66610,-21760,-0.48517279821627646,1
6714,6715,Hoodi,315500,68700,246800,0.7822503961965135,-1
6715,6716,Vasanth Nagar,373600,118480,255120,0.6828693790149893,0
6716,6717,Marathahalli,319900,31640,288260,0.9010940919037199,-1
6717,6718,Shivajinagar,128400,80860,47540,0.3702492211838006,1
6718,6719,Whitefield,286700,47330,239370,0.8349145448203698,-1
6719,6720,Hoodi,210750,62010,148740,0.7057651245551602,0
6720,6721,Malleswaram,247400,40110,207290,0.8378738884397736,-1
6721,6722,Whitefield,279050,58740,220310,0.7895000895896793,0
6722,6723,Indiranagar,163350,38270,125080,0.7657177838996021,-1
6723,6724,Varthur,399800,66730,333070,0.8330915457728865,-1
6724,6725,Banaswadi,354700,80840,273860,0.7720890893712997,0
6725,6726,Hoodi,141050,0,141050,1.0,-1
6726,6727,Varthur,311800,48980,262820,0.8429121231558692,-1
6727,6728,Rajajinagar,431550,96990,334560,0.7752519986096629,0
6728,6729,Horamavu,254350,29890,224460,0.8824847650874779,0
6729,6730,Shivajinagar,279650,13150,266500,0.952976935455033,-1
6730,6731,Indiranagar,336450,48130,288320,0.856947540496359,0
6731,6732,Kammanahalli,179700,28060,151640,0.8438508625486922,-1
6732,6733,Kammanahalli,155050,102080,52970,0.34163173169945177,1
6733,6734,Krishnarajapuram,164650,15930,148720,0.9032493167324628,-1
6734,6735,HBR Layout,178250,44510,133740,0.7502945301542777,-1
6735,6736,Hebbal,339200,31290,307910,0.9077535377358491,-1
6736,6737,Mahadevapura,31450,66710,-35260,-1.1211446740858506,1
6737,6738,Hoodi,331100,9120,321980,0.972455451525219,-1
6738,6739,Kammanahalli,36500,89140,-52640,-1.4421917808219178,1
6739,6740,Krishnarajapuram,54800,30670,24130,0.44032846715328466,1
6740,6741,Kammanahalli,235200,74610,160590,0.6827806122448979,0
6741,6742,Varthur,351800,72870,278930,0.792865264354747,0
6742,6743,Indiranagar,333750,10490,323260,0.9685692883895131,-1
6743,6744,Vasanth Nagar,87650,91300,-3650,-0.04164289788933257,1
6744,6745,Vasanth Nagar,65900,43100,22800,0.34597875569044007,1
6745,6746,Kammanahalli,248550,85000,163550,0.6580164956749145,0
6746,6747,CV Raman Nagar,245350,21480,223870,0.9124515997554514,-1
6747,6748,Marathahalli,75550,37750,37800,0.500330906684315,0
6748,6749,Varthur,29400,43080,-13680,-0.46530612244897956,1
6749,6750,Varthur,163250,7050,156200,0.9568147013782542,-1
6750,6751,CV Raman Nagar,80000,63290,16710,0.208875,1
6751,6752,Rajajinagar,318750,123790,194960,0.6116392156862746,0
6752,6753,Kammanahalli,148050,50060,97990,0.661870989530564,0
6753,6754,Kalyan Nagar,133300,75680,57620,0.432258064516129,1
6754,6755,Varthur,173100,11340,161760,0.9344887348353553,-1
6755,6756,Whitefield,206400,28830,177570,0.8603197674418605,-1
6756,6757,Vasanth Nagar,199300,67500,131800,0.6613146011038635,0
6757,6758,Varthur,408900,95990,312910,0.7652482269503547,0
6758,6759,Kammanahalli,101000,61370,39630,0.3923762376237624,1
6759,6760,Mahadevapura,97450,41550,55900,0.5736275012827091,1
6760,6761,Hebbal,404850,38230,366620,0.9055699641842658,-1
6761,6762,Hebbal,129400,66280,63120,0.48778979907264297,1
6762,6763,Krishnarajapuram,351700,84470,267230,0.7598237133920955,0
6763,6764,Hoodi,166450,84460,81990,0.49258035446079906,0
6764,6765,Marathahalli,387900,146790,241110,0.6215777262180975,0
6765,6766,Shivajinagar,348700,120340,228360,0.6548895899053627,0
6766,6767,Jalahalli,310050,66280,243770,0.7862280277374617,0
6767,6768,HBR Layout,90700,63100,27600,0.30429988974641675,1
6768,6769,Rajajinagar,28750,62870,-34120,-1.186782608695652,1
6769,6770,Rajajinagar,193600,90130,103470,0.534452479338843,0
6770,6771,Hoodi,119450,7360,112090,0.9383842611971536,-1
6771,6772,Vasanth Nagar,405650,63350,342300,0.8438308886971527,-1
6772,6773,Shivajinagar,233150,104570,128580,0.5514904567874759,1
6773,6774,Hebbal,337950,67190,270760,0.8011836070424619,-1
6774,6775,Rajajinagar,356250,18910,337340,0.946919298245614,-1
6775,6776,Shivajinagar,262950,94710,168240,0.6398174557900742,0
6776,6777,Whitefield,345450,93280,252170,0.7299753944130843,0
6777,6778,Jalahalli,261100,20350,240750,0.9220605132133283,-1
6778,6779,Kalyan Nagar,437900,99170,338730,0.7735327700388217,0
6779,6780,Jalahalli,332550,76420,256130,0.7701999699293339,0
6780,6781,Hebbal,110350,77410,32940,0.29850475758948797,1
6781,6782,Vasanth Nagar,228950,61720,167230,0.7304214894081678,0
6782,6783,Hoodi,446850,52760,394090,0.8819290589683338,-1
6783,6784,Vasanth Nagar,416500,30360,386140,0.9271068427370949,-1
6784,6785,Kammanahalli,95650,44360,51290,0.5362258233141662,1
6785,6786,Varthur,96150,54790,41360,0.43016120644825795,1
6786,6787,Varthur,267750,4240,263510,0.9841643323996265,-1
6787,6788,Hebbal,356300,101160,255140,0.7160819534100478,0
6788,6789,Kalyan Nagar,388500,22330,366170,0.9425225225225226,-1
6789,6790,CV Raman Nagar,328450,76480,251970,0.7671487288780636,0
6790,6791,Malleswaram,244150,85980,158170,0.6478394429653901,0
6791,6792,Shivajinagar,355150,13530,341620,0.9619034210896804,-1
6792,6793,Mahadevapura,127450,74100,53350,0.4185955276579051,1
6793,6794,Mahadevapura,438350,14960,423390,0.9658720200752823,-1
6794,6795,Whitefield,203300,77320,125980,0.6196753566158386,0
6795,6796,Kammanahalli,119400,30160,89240,0.7474036850921273,0
6796,6797,Vasanth Nagar,108450,56420,52030,0.4797602581834947,1
6797,6798,CV Raman Nagar,146350,9560,136790,0.9346771438332764,-1
6798,6799,CV Raman Nagar,127650,61960,65690,0.5146102624363494,1
6799,6800,Marathahalli,313950,22680,291270,0.9277591973244147,-1
6800,6801,Kammanahalli,143900,48390,95510,0.663724808895066,0
6801,6802,Varthur,358400,66230,292170,0.8152064732142857,-1
6802,6803,Hebbal,72150,102740,-30590,-0.42397782397782396,1
6803,6804,Malleswaram,105250,62190,43060,0.4091211401425178,1
6804,6805,Hebbal,226300,54810,171490,0.7577993813521874,0
6805,6806,Varthur,302100,34360,267740,0.8862628268785171,0
6806,6807,Shivajinagar,271750,56250,215500,0.7930082796688133,-1
6807,6808,Horamavu,274500,76050,198450,0.7229508196721312,0
6808,6809,Hebbal,313200,59110,254090,0.8112707535121328,0
6809,6810,Indiranagar,443450,79620,363830,0.8204532641785997,-1
6810,6811,CV Raman Nagar,283950,132590,151360,0.5330515935904209,0
6811,6812,Malleswaram,433850,48160,385690,0.8889938918981215,0
6812,6813,HBR Layout,92250,61860,30390,0.32943089430894307,1
6813,6814,Kammanahalli,357900,24140,333760,0.9325509918971779,-1
6814,6815,Vasanth Nagar,35200,37510,-2310,-0.065625,1
6815,6816,Whitefield,426400,31930,394470,0.9251172607879925,-1
6816,6817,Whitefield,402350,27530,374820,0.9315769852118801,-1
6817,6818,Indiranagar,287600,93940,193660,0.67336578581363,0
6818,6819,Indiranagar,127650,81500,46150,0.3615354484919702,1
6819,6820,Mahadevapura,412550,19830,392720,0.9519330990183008,-1
6820,6821,Varthur,63900,43490,20410,0.31940532081377154,1
6821,6822,HBR Layout,167100,77500,89600,0.5362058647516457,1
6822,6823,Kammanahalli,100150,111260,-11110,-0.1109335996005991,1
6823,6824,HBR Layout,355950,62350,293600,0.8248349487287541,-1
6824,6825,Hoodi,443500,100100,343400,0.7742953776775648,0
6825,6826,Whitefield,419900,63060,356840,0.8498213860442962,-1
6826,6827,Varthur,306000,37160,268840,0.878562091503268,-1
6827,6828,HBR Layout,152000,35720,116280,0.765,-1
6828,6829,Kalyan Nagar,366150,56060,310090,0.8468933497200601,0
6829,6830,Mahadevapura,308300,141110,167190,0.5422964644826468,0
6830,6831,Malleswaram,244100,113780,130320,0.5338795575583777,1
6831,6832,Hebbal,269050,74040,195010,0.7248095149600446,-1
6832,6833,Kalyan Nagar,433250,75230,358020,0.8263589151759954,-1
6833,6834,Horamavu,289600,41570,248030,0.856457182320442,-1
6834,6835,Hoodi,32550,81240,-48690,-1.495852534562212,1
6835,6836,Indiranagar,49200,67330,-18130,-0.36849593495934957,1
6836,6837,Malleswaram,60200,107890,-47690,-0.7921926910299003,1
6837,6838,Hebbal,343700,4860,338840,0.9858597614198429,-1
6838,6839,Hebbal,354750,55500,299250,0.8435517970401691,0
6839,6840,Horamavu,154550,90770,63780,0.4126819799417664,1
6840,6841,Kalyan Nagar,341650,40890,300760,0.880316112981121,-1
6841,6842,Horamavu,361650,7500,354150,0.9792617171298217,-1
6842,6843,Horamavu,248200,56880,191320,0.7708299758259468,0
6843,6844,Hoodi,414850,18300,396550,0.9558876702422562,-1
6844,6845,Hoodi,255900,100170,155730,0.6085580304806565,0
6845,6846,Mahadevapura,118050,78120,39930,0.33824650571791615,1
6846,6847,HBR Layout,27400,0,27400,1.0,-1
6847,6848,Indiranagar,429850,47110,382740,0.8904036291729673,-1
6848,6849,Hebbal,296800,48030,248770,0.8381738544474393,-1
6849,6850,Malleswaram,134450,38260,96190,0.7154332465600595,-1
6850,6851,Banaswadi,390850,103290,287560,0.7357298196238966,-1
6851,6852,Rajajinagar,157000,59210,97790,0.6228662420382166,0
6852,6853,Marathahalli,268500,129970,138530,0.5159404096834265,1
6853,6854,Kalyan Nagar,421350,47380,373970,0.8875519164590008,0
6854,6855,Whitefield,338300,54950,283350,0.8375702039609814,-1
6855,6856,Rajajinagar,47150,79040,-31890,-0.6763520678685048,1
6856,6857,Hoodi,140300,134920,5380,0.0383464005702067,1
6857,6858,Whitefield,328000,37720,290280,0.885,-1
6858,6859,HBR Layout,137850,29590,108260,0.7853463910047153,0
6859,6860,Shivajinagar,313450,32940,280510,0.8949114691338331,-1
6860,6861,Kalyan Nagar,145550,58990,86560,0.5947097217451047,0
6861,6862,Malleswaram,177700,24130,153570,0.8642093415869443,-1
6862,6863,Hoodi,193200,81710,111490,0.5770703933747412,0
6863,6864,Varthur,229200,44190,185010,0.8071989528795811,0
6864,6865,Malleswaram,267900,67680,200220,0.7473684210526316,0
6865,6866,Banaswadi,93600,62860,30740,0.3284188034188034,1
6866,6867,Krishnarajapuram,86850,30190,56660,0.6523891767415083,0
6867,6868,CV Raman Nagar,399000,44030,354970,0.8896491228070176,-1
6868,6869,Whitefield,151600,85020,66580,0.4391820580474934,1
6869,6870,Vasanth Nagar,447800,117830,329970,0.7368691380080393,-1
6870,6871,Indiranagar,79800,94830,-15030,-0.18834586466165412,1
6871,6872,Vasanth Nagar,129200,74950,54250,0.4198916408668731,0
6872,6873,Mahadevapura,339850,115480,224370,0.6602030307488598,0
6873,6874,Rajajinagar,243550,50440,193110,0.7928967357832067,0
6874,6875,Hoodi,47100,50020,-2920,-0.06199575371549894,1
6875,6876,Rajajinagar,276000,16840,259160,0.9389855072463769,-1
6876,6877,Vasanth Nagar,193000,65240,127760,0.6619689119170984,0
6877,6878,Vasanth Nagar,432150,106180,325970,0.7542982760615528,0
6878,6879,Horamavu,365950,36900,329050,0.8991665528077606,-1
6879,6880,Varthur,336450,8670,327780,0.9742309407044137,-1
6880,6881,Hebbal,183600,83720,99880,0.5440087145969499,0
6881,6882,Mahadevapura,207350,11850,195500,0.9428502531950808,-1
6882,6883,Varthur,295100,80100,215000,0.7285665875974247,0
6883,6884,Kammanahalli,98550,34480,64070,0.650126839167935,0
6884,6885,Kammanahalli,153300,29180,124120,0.8096542726679713,0
6885,6886,Whitefield,189400,85070,104330,0.5508447729672651,0
6886,6887,Shivajinagar,233550,86510,147040,0.6295868122457717,0
6887,6888,Horamavu,180900,41040,139860,0.7731343283582089,0
6888,6889,Hebbal,86500,67680,18820,0.21757225433526012,1
6889,6890,Whitefield,379800,62330,317470,0.8358873091100579,-1
6890,6891,Krishnarajapuram,279600,37560,242040,0.8656652360515021,0
6891,6892,Vasanth Nagar,178500,66800,111700,0.6257703081232493,0
6892,6893,CV Raman Nagar,350950,92550,258400,0.7362872204017666,0
6893,6894,Jalahalli,138500,58560,79940,0.5771841155234657,0
6894,6895,Vasanth Nagar,154800,80980,73820,0.47687338501291987,1
6895,6896,Mahadevapura,33600,115450,-81850,-2.4360119047619047,1
6896,6897,Krishnarajapuram,340300,76560,263740,0.7750220393770203,0
6897,6898,Hebbal,82700,40630,42070,0.5087061668681984,0
6898,6899,Marathahalli,144900,63240,81660,0.5635610766045549,0
6899,6900,Hebbal,403250,114400,288850,0.716305021698698,0
6900,6901,Varthur,313750,39910,273840,0.872796812749004,0
6901,6902,Rajajinagar,157250,22660,134590,0.8558982511923688,0
6902,6903,Mahadevapura,65500,48490,17010,0.2596946564885496,1
6903,6904,Whitefield,339000,14370,324630,0.9576106194690266,-1
6904,6905,Shivajinagar,307200,67830,239370,0.77919921875,0
6905,6906,Vasanth Nagar,28050,130340,-102290,-3.6467023172905524,1
6906,6907,Vasanth Nagar,55550,57840,-2290,-0.04122412241224122,1
6907,6908,Kalyan Nagar,278750,70720,208030,0.7462959641255605,0
6908,6909,Whitefield,243300,75980,167320,0.6877106452938758,0
6909,6910,Hoodi,386500,70290,316210,0.818137128072445,0
6910,6911,Shivajinagar,154800,80710,74090,0.47861757105943153,0
6911,6912,Kammanahalli,143100,75310,67790,0.4737246680642907,1
6912,6913,Shivajinagar,380850,27330,353520,0.9282394643560457,-1
6913,6914,Hoodi,323000,63920,259080,0.8021052631578948,-1
6914,6915,Vasanth Nagar,29650,102470,-72820,-2.4559865092748736,1
6915,6916,Kalyan Nagar,86750,63980,22770,0.26247838616714697,1
6916,6917,Varthur,448500,32690,415810,0.9271125975473802,-1
6917,6918,Mahadevapura,86150,88170,-2020,-0.023447475333720255,1
6918,6919,CV Raman Nagar,397500,74700,322800,0.8120754716981132,-1
6919,6920,Varthur,215950,83830,132120,0.6118082889557768,0
6920,6921,Shivajinagar,349600,30840,318760,0.9117848970251716,-1
6921,6922,Indiranagar,189350,72050,117300,0.6194877211513071,0
6922,6923,Varthur,309050,101810,207240,0.670571104999191,0
6923,6924,Krishnarajapuram,155000,48360,106640,0.688,0
6924,6925,Mahadevapura,365200,40620,324580,0.8887732749178532,-1
6925,6926,Mahadevapura,227300,11480,215820,0.9494940607127145,-1
6926,6927,Varthur,289350,13660,275690,0.9527907378607223,-1
6927,6928,Kammanahalli,358050,47570,310480,0.8671414606898478,-1
6928,6929,Whitefield,160050,76450,83600,0.5223367697594502,0
6929,6930,Kalyan Nagar,70600,53630,16970,0.24036827195467422,1
6930,6931,Varthur,30900,70370,-39470,-1.277346278317152,1
6931,6932,Marathahalli,337600,11900,325700,0.9647511848341233,-1
6932,6933,Varthur,293600,71200,222400,0.7574931880108992,0
6933,6934,Banaswadi,168850,38110,130740,0.774296713058928,0
6934,6935,Whitefield,435700,107510,328190,0.7532476474638513,0
6935,6936,CV Raman Nagar,168400,91410,76990,0.45718527315914487,0
6936,6937,Kalyan Nagar,328800,47130,281670,0.8566605839416058,-1
6937,6938,Kammanahalli,232800,65560,167240,0.7183848797250859,0
6938,6939,Indiranagar,202050,71900,130150,0.6441474882454838,0
6939,6940,Kalyan Nagar,449200,14870,434330,0.9668967052537845,-1
6940,6941,Rajajinagar,179850,119670,60180,0.3346121768140117,1
6941,6942,Hebbal,319300,42700,276600,0.8662699655496399,-1
6942,6943,Varthur,265350,83950,181400,0.6836254004145468,0
6943,6944,Mahadevapura,134300,64150,70150,0.5223380491437081,1
6944,6945,Kalyan Nagar,312750,57290,255460,0.8168185451638689,0
6945,6946,Banaswadi,91300,31440,59860,0.6556407447973713,0
6946,6947,Krishnarajapuram,321250,67640,253610,0.7894474708171206,0
6947,6948,HBR Layout,115700,53770,61930,0.5352636127917026,1
6948,6949,Mahadevapura,25300,42820,-17520,-0.6924901185770751,1
6949,6950,Mahadevapura,215450,35110,180340,0.8370387560919007,-1
6950,6951,Hebbal,205300,22360,182940,0.8910862152946907,-1
6951,6952,Kammanahalli,47350,47320,30,0.0006335797254487857,1
6952,6953,Rajajinagar,381500,38330,343170,0.8995281782437746,-1
6953,6954,CV Raman Nagar,442150,28240,413910,0.9361302725319461,-1
6954,6955,Mahadevapura,432850,70640,362210,0.8368025875014439,0
6955,6956,Vasanth Nagar,162300,31400,130900,0.8065311152187308,-1
6956,6957,HBR Layout,311600,33660,277940,0.891976893453145,-1
6957,6958,Jalahalli,182200,25220,156980,0.8615806805708013,-1
6958,6959,CV Raman Nagar,389850,48870,340980,0.8746440938822624,-1
6959,6960,Whitefield,97350,88190,9160,0.0940934771443246,1
6960,6961,Jalahalli,254850,45510,209340,0.8214243672748676,0
6961,6962,Vasanth Nagar,236300,89440,146860,0.6214980956411341,0
6962,6963,Banaswadi,187750,116950,70800,0.3770972037283622,1
6963,6964,Krishnarajapuram,121700,86870,34830,0.28619556285949055,1
6964,6965,CV Raman Nagar,440900,47470,393430,0.892333862553867,-1
6965,6966,HBR Layout,76250,67010,9240,0.12118032786885245,1
6966,6967,Shivajinagar,406150,45350,360800,0.8883417456604703,0
6967,6968,Varthur,61000,38310,22690,0.3719672131147541,1
6968,6969,Shivajinagar,50500,38190,12310,0.24376237623762376,1
6969,6970,Varthur,214150,37190,176960,0.8263366798972682,-1
6970,6971,Hoodi,154450,29600,124850,0.8083522175461314,-1
6971,6972,Indiranagar,276800,64700,212100,0.766257225433526,0
6972,6973,Marathahalli,388200,36480,351720,0.9060278207109738,-1
6973,6974,Mahadevapura,74250,87270,-13020,-0.17535353535353534,1
6974,6975,HBR Layout,175800,85740,90060,0.5122866894197953,0
6975,6976,HBR Layout,395200,74950,320250,0.8103491902834008,-1
6976,6977,Kammanahalli,203100,51890,151210,0.7445100935499753,-1
6977,6978,Vasanth Nagar,158100,90840,67260,0.425426944971537,1
6978,6979,Kammanahalli,287100,53380,233720,0.8140717520027865,-1
6979,6980,Hoodi,387850,30170,357680,0.92221219543638,-1
6980,6981,Hebbal,38300,54920,-16620,-0.4339425587467363,1
6981,6982,Hebbal,361250,48420,312830,0.8659653979238754,-1
6982,6983,Krishnarajapuram,175600,59480,116120,0.6612756264236902,0
6983,6984,CV Raman Nagar,386550,13930,372620,0.9639632647781659,-1
6984,6985,Mahadevapura,176550,24880,151670,0.859076748796375,-1
6985,6986,CV Raman Nagar,323600,109700,213900,0.6610012360939431,0
6986,6987,Varthur,421150,33160,387990,0.9212632078831771,-1
6987,6988,Hebbal,391000,63650,327350,0.8372122762148337,-1
6988,6989,Hebbal,84450,74130,10320,0.122202486678508,1
6989,6990,Malleswaram,48350,55360,-7010,-0.14498448810754913,1
6990,6991,Rajajinagar,168250,102100,66150,0.39316493313521544,1
6991,6992,Varthur,373600,90550,283050,0.7576284796573876,-1
6992,6993,Malleswaram,371900,96370,275530,0.7408712019360043,0
6993,6994,Marathahalli,182700,40000,142700,0.7810618500273673,0
6994,6995,Shivajinagar,254800,19840,234960,0.9221350078492936,-1
6995,6996,Kalyan Nagar,166400,46530,119870,0.7203725961538462,-1
6996,6997,Shivajinagar,55850,47330,8520,0.15255147717099374,1
6997,6998,Jalahalli,184800,49150,135650,0.7340367965367965,0
6998,6999,Krishnarajapuram,282000,116900,165100,0.5854609929078014,1
6999,7000,Malleswaram,383650,42380,341270,0.8895347321777662,-1
7000,7001,Krishnarajapuram,33400,117870,-84470,-2.5290419161676647,1
7001,7002,Varthur,393550,56360,337190,0.8567907508575785,0
7002,7003,Kalyan Nagar,314550,56350,258200,0.8208551899539024,0
7003,7004,Marathahalli,181250,26530,154720,0.8536275862068966,0
7004,7005,Malleswaram,150100,35020,115080,0.766688874083944,0
7005,7006,HBR Layout,331450,49070,282380,0.8519535374868005,-1
7006,7007,Kalyan Nagar,116450,35610,80840,0.6942035208243882,0
7007,7008,Mahadevapura,161250,71260,89990,0.558077519379845,0
7008,7009,Krishnarajapuram,400050,33100,366950,0.9172603424571929,-1
7009,7010,Malleswaram,116050,105420,10630,0.09159844894442051,1
7010,7011,Marathahalli,30450,14880,15570,0.5113300492610837,0
7011,7012,Vasanth Nagar,270650,0,270650,1.0,-1
7012,7013,Rajajinagar,427250,80330,346920,0.8119836161497952,-1
7013,7014,Banaswadi,342950,15620,327330,0.9544540020411139,-1
7014,7015,Banaswadi,231400,39770,191630,0.828133102852204,-1
7015,7016,Hebbal,227800,81450,146350,0.642449517120281,0
7016,7017,Shivajinagar,96550,63220,33330,0.34520973588814086,1
7017,7018,Hoodi,51600,71320,-19720,-0.3821705426356589,1
7018,7019,Hebbal,276800,24400,252400,0.911849710982659,-1
7019,7020,Mahadevapura,391750,109670,282080,0.7200510529674538,-1
7020,7021,Banaswadi,355150,87120,268030,0.7546951992116008,-1
7021,7022,Hebbal,371400,56720,314680,0.8472805600430803,0
7022,7023,Banaswadi,334400,42690,291710,0.8723385167464115,-1
7023,7024,Malleswaram,321450,90710,230740,0.7178099237828589,-1
7024,7025,HBR Layout,61100,41360,19740,0.3230769230769231,1
7025,7026,Hebbal,296850,92410,204440,0.6886979956206839,0
7026,7027,Mahadevapura,214200,33950,180250,0.8415032679738562,-1
7027,7028,Jalahalli,118550,71340,47210,0.3982285955293125,1
7028,7029,HBR Layout,154250,45590,108660,0.7044408427876824,0
7029,7030,Kammanahalli,176850,64840,112010,0.6333616058806899,0
7030,7031,Kammanahalli,131400,23950,107450,0.8177321156773212,-1
7031,7032,Malleswaram,263550,89910,173640,0.65885031303358,0
7032,7033,Indiranagar,47550,73310,-25760,-0.541745531019979,1
7033,7034,HBR Layout,292400,80400,212000,0.7250341997264022,-1
7034,7035,CV Raman Nagar,396450,32870,363580,0.9170891663513684,-1
7035,7036,Whitefield,422800,165420,257380,0.6087511825922421,0
7036,7037,Jalahalli,373300,98260,275040,0.7367800696490758,-1
7037,7038,Varthur,324550,72320,252230,0.777168386997381,0
7038,7039,HBR Layout,29700,35360,-5660,-0.19057239057239056,1
7039,7040,Krishnarajapuram,385250,49360,335890,0.8718754055807917,-1
7040,7041,Varthur,406200,16330,389870,0.9597981290004923,-1
7041,7042,Rajajinagar,430950,19700,411250,0.954287040259891,-1
7042,7043,Varthur,273950,7430,266520,0.9728782624566527,-1
7043,7044,Rajajinagar,276150,42780,233370,0.8450841933731668,-1
7044,7045,Krishnarajapuram,402800,39870,362930,0.9010178748758689,-1
7045,7046,Mahadevapura,38300,39660,-1360,-0.035509138381201046,1
7046,7047,Horamavu,345200,120700,224500,0.6503476245654692,0
7047,7048,Horamavu,409800,67360,342440,0.8356271351878966,0
7048,7049,Shivajinagar,286200,21170,265030,0.926030747728861,-1
7049,7050,Rajajinagar,193350,114980,78370,0.4053271269718128,1
7050,7051,Mahadevapura,106650,124460,-17810,-0.16699484294421002,1
7051,7052,Kammanahalli,159150,39040,120110,0.7546968268928683,0
7052,7053,Vasanth Nagar,35500,89120,-53620,-1.5104225352112677,1
7053,7054,HBR Layout,214800,56480,158320,0.7370577281191807,0
7054,7055,HBR Layout,150650,35630,115020,0.7634915366744108,-1
7055,7056,Whitefield,282250,28190,254060,0.9001240035429584,-1
7056,7057,Kammanahalli,345250,44730,300520,0.8704417089065895,-1
7057,7058,Malleswaram,178800,64660,114140,0.6383668903803132,0
7058,7059,Hoodi,167800,70370,97430,0.5806317044100119,1
7059,7060,Indiranagar,233750,76670,157080,0.672,0
7060,7061,Jalahalli,406550,87220,319330,0.7854630426761776,-1
7061,7062,Marathahalli,265650,30620,235030,0.8847355543007717,-1
7062,7063,Hoodi,146200,42660,103540,0.7082079343365253,0
7063,7064,HBR Layout,359300,40670,318630,0.8868076816031172,0
7064,7065,Kammanahalli,64350,60920,3430,0.0533022533022533,1
7065,7066,Varthur,188300,88230,100070,0.5314391927774827,1
7066,7067,CV Raman Nagar,105700,92310,13390,0.12667928098391676,1
7067,7068,CV Raman Nagar,187050,89160,97890,0.5233360064153969,0
7068,7069,Banaswadi,208900,38400,170500,0.8161799904260412,-1
7069,7070,Krishnarajapuram,116950,64380,52570,0.4495083368961095,1
7070,7071,Hoodi,346550,80390,266160,0.7680277016303564,0
7071,7072,Horamavu,77900,122120,-44220,-0.5676508344030808,1
7072,7073,Rajajinagar,159500,79040,80460,0.5044514106583072,0
7073,7074,Hoodi,308750,113860,194890,0.6312226720647773,0
7074,7075,Indiranagar,125950,58120,67830,0.5385470424771734,0
7075,7076,Krishnarajapuram,395750,38670,357080,0.9022867972204675,-1
7076,7077,Banaswadi,434800,85300,349500,0.8038178472861086,-1
7077,7078,Kammanahalli,155900,44320,111580,0.7157152020525979,0
7078,7079,Rajajinagar,108100,51390,56710,0.5246068455134135,0
7079,7080,Horamavu,100000,104120,-4120,-0.0412,1
7080,7081,Jalahalli,349900,67860,282040,0.8060588739639897,0
7081,7082,Kalyan Nagar,222000,39650,182350,0.8213963963963964,-1
7082,7083,Varthur,246700,81370,165330,0.6701661937576003,0
7083,7084,Shivajinagar,272650,89540,183110,0.6715936181918211,0
7084,7085,Kalyan Nagar,391750,50830,340920,0.870248883216337,0
7085,7086,Hoodi,266700,63820,202880,0.7607049118860143,0
7086,7087,Kammanahalli,250600,103580,147020,0.5866719872306464,0
7087,7088,Kammanahalli,390600,48340,342260,0.8762416794674859,0
7088,7089,Marathahalli,411600,48220,363380,0.8828474246841593,0
7089,7090,Indiranagar,408700,34110,374590,0.916540249571813,-1
7090,7091,CV Raman Nagar,100100,15410,84690,0.846053946053946,0
7091,7092,Marathahalli,252300,153480,98820,0.3916765755053508,1
7092,7093,Whitefield,296150,58910,237240,0.8010805335134222,-1
7093,7094,Rajajinagar,157050,80330,76720,0.48850684495383634,0
7094,7095,Malleswaram,327650,86740,240910,0.735266290248741,0
7095,7096,Indiranagar,165200,83290,81910,0.4958232445520581,1
7096,7097,CV Raman Nagar,221550,58010,163540,0.7381629429022794,0
7097,7098,Mahadevapura,159150,11860,147290,0.9254791077599749,-1
7098,7099,Indiranagar,282900,62760,220140,0.7781548250265111,0
7099,7100,Kalyan Nagar,300950,34200,266750,0.8863598604419338,-1
7100,7101,Mahadevapura,281150,56810,224340,0.7979370442824115,0
7101,7102,Rajajinagar,316800,127160,189640,0.5986111111111111,1
7102,7103,Mahadevapura,238700,113760,124940,0.5234185169669041,1
7103,7104,Marathahalli,372600,56160,316440,0.8492753623188406,0
7104,7105,Indiranagar,262050,104350,157700,0.6017935508490746,0
7105,7106,Malleswaram,367650,74550,293100,0.7972256221950225,0
7106,7107,Jalahalli,142250,0,142250,1.0,-1
7107,7108,Rajajinagar,212600,117360,95240,0.4479774223894638,1
7108,7109,Marathahalli,75350,59680,15670,0.2079628400796284,1
7109,7110,Whitefield,116750,61580,55170,0.47254817987152037,1
7110,7111,HBR Layout,214400,157860,56540,0.2637126865671642,1
7111,7112,Whitefield,330200,42080,288120,0.8725620835857056,-1
7112,7113,Vasanth Nagar,173750,34000,139750,0.8043165467625899,0
7113,7114,Rajajinagar,446250,117130,329120,0.7375238095238095,-1
7114,7115,Jalahalli,393200,6240,386960,0.9841302136317396,-1
7115,7116,CV Raman Nagar,212450,71300,141150,0.6643916215580137,0
7116,7117,Whitefield,62000,23210,38790,0.6256451612903225,0
7117,7118,Hebbal,411600,97480,314120,0.7631681243926142,0
7118,7119,Rajajinagar,164850,107180,57670,0.34983318168031546,1
7119,7120,Kammanahalli,287850,30310,257540,0.8947021017891262,-1
7120,7121,CV Raman Nagar,307300,112420,194880,0.6341685649202734,0
7121,7122,Indiranagar,342900,118430,224470,0.6546223388743074,0
7122,7123,Vasanth Nagar,57050,18550,38500,0.6748466257668712,0
7123,7124,Banaswadi,44500,25190,19310,0.4339325842696629,0
7124,7125,Hoodi,236000,21480,214520,0.9089830508474577,-1
7125,7126,Krishnarajapuram,86650,6820,79830,0.9212925562608194,-1
7126,7127,Vasanth Nagar,96550,39570,56980,0.5901605385810461,1
7127,7128,CV Raman Nagar,53250,46110,7140,0.13408450704225353,1
7128,7129,Vasanth Nagar,182300,71550,110750,0.6075150850246845,0
7129,7130,Rajajinagar,385900,121430,264470,0.685332987820679,0
7130,7131,Indiranagar,44100,29360,14740,0.33424036281179137,1
7131,7132,Jalahalli,160600,32170,128430,0.7996886674968867,0
7132,7133,Shivajinagar,373550,28740,344810,0.9230625083656806,-1
7133,7134,Vasanth Nagar,365350,32550,332800,0.9109073491172848,-1
7134,7135,Horamavu,388450,78180,310270,0.7987385763933582,-1
7135,7136,Mahadevapura,190400,61650,128750,0.6762079831932774,0
7136,7137,Vasanth Nagar,361450,44150,317300,0.87785309171393,0
7137,7138,Rajajinagar,304550,135380,169170,0.555475291413561,0
7138,7139,Krishnarajapuram,443900,22020,421880,0.9503942329353458,-1
7139,7140,Varthur,259400,47260,212140,0.8178103315343099,-1
7140,7141,Malleswaram,350050,36870,313180,0.8946721896871875,-1
7141,7142,HBR Layout,103800,27760,76040,0.7325626204238921,0
7142,7143,Indiranagar,179700,35330,144370,0.8033945464663328,-1
7143,7144,Hoodi,60750,19060,41690,0.6862551440329218,0
7144,7145,Vasanth Nagar,387200,93430,293770,0.7587035123966942,0
7145,7146,Shivajinagar,151700,111910,39790,0.2622940013183916,1
7146,7147,Marathahalli,325550,83810,241740,0.7425587467362924,0
7147,7148,Marathahalli,115050,38530,76520,0.6651021295089091,0
7148,7149,HBR Layout,158350,29570,128780,0.8132617619197979,0
7149,7150,Kammanahalli,326650,105870,220780,0.6758916271238329,0
7150,7151,Mahadevapura,101600,64360,37240,0.36653543307086617,1
7151,7152,Marathahalli,391050,83360,307690,0.7868303286024805,0
7152,7153,Krishnarajapuram,55550,31070,24480,0.44068406840684066,1
7153,7154,Indiranagar,41000,108310,-67310,-1.6417073170731706,1
7154,7155,Marathahalli,93150,25900,67250,0.7219538378958669,-1
7155,7156,Marathahalli,107200,42250,64950,0.6058768656716418,0
7156,7157,CV Raman Nagar,449750,58880,390870,0.869082823790995,-1
7157,7158,Varthur,323550,19130,304420,0.9408746716118065,-1
7158,7159,Krishnarajapuram,314950,95290,219660,0.6974440387363073,0
7159,7160,Marathahalli,316100,100470,215630,0.6821575450806707,0
7160,7161,Whitefield,348450,62870,285580,0.8195723920218109,0
7161,7162,Whitefield,204900,68690,136210,0.664763299170327,0
7162,7163,Rajajinagar,239750,111940,127810,0.533096976016684,0
7163,7164,Rajajinagar,125200,70700,54500,0.4353035143769968,1
7164,7165,Horamavu,409450,158080,251370,0.6139211136890951,0
7165,7166,Marathahalli,111600,43120,68480,0.6136200716845878,0
7166,7167,Malleswaram,100700,111930,-11230,-0.11151936444885799,1
7167,7168,CV Raman Nagar,244550,0,244550,1.0,-1
7168,7169,Kalyan Nagar,217950,41520,176430,0.80949759119064,0
7169,7170,Hebbal,225600,26870,198730,0.880895390070922,-1
7170,7171,Varthur,224250,13430,210820,0.9401114827201784,-1
7171,7172,Malleswaram,73000,88990,-15990,-0.21904109589041096,1
7172,7173,Shivajinagar,169700,43570,126130,0.7432527990571597,-1
7173,7174,Kalyan Nagar,257600,99890,157710,0.6122282608695652,0
7174,7175,Kalyan Nagar,126350,15010,111340,0.881203007518797,-1
7175,7176,Kalyan Nagar,179850,115260,64590,0.3591326105087573,1
7176,7177,Indiranagar,432650,60780,371870,0.8595169305443199,0
7177,7178,Shivajinagar,419100,46440,372660,0.8891911238367931,-1
7178,7179,Hoodi,267150,54310,212840,0.7967059704285981,0
7179,7180,Rajajinagar,258750,29440,229310,0.8862222222222222,-1
7180,7181,Horamavu,406400,86700,319700,0.7866633858267716,0
7181,7182,HBR Layout,443500,85350,358150,0.8075535512965051,-1
7182,7183,Indiranagar,99100,83790,15310,0.1544904137235116,1
7183,7184,HBR Layout,96250,83680,12570,0.1305974025974026,1
7184,7185,Horamavu,217950,100760,117190,0.5376921312227575,0
7185,7186,Varthur,80600,140300,-59700,-0.7406947890818859,1
7186,7187,Hoodi,50800,47390,3410,0.0671259842519685,1
7187,7188,Jalahalli,60900,29210,31690,0.5203612479474549,0
7188,7189,CV Raman Nagar,278650,58480,220170,0.7901309886954961,-1
7189,7190,Kalyan Nagar,249350,7170,242180,0.9712452376178063,-1
7190,7191,CV Raman Nagar,331750,58530,273220,0.8235719668425019,0
7191,7192,Malleswaram,358300,32830,325470,0.90837287189506,-1
7192,7193,Malleswaram,446450,105990,340460,0.7625937954978161,-1
7193,7194,Marathahalli,37600,53990,-16390,-0.43590425531914895,1
7194,7195,Mahadevapura,114250,78000,36250,0.3172866520787746,1
7195,7196,Horamavu,437900,64710,373190,0.8522265357387532,-1
7196,7197,Whitefield,133750,28520,105230,0.7867663551401869,-1
7197,7198,Krishnarajapuram,294950,19990,274960,0.9322258009832175,-1
7198,7199,Banaswadi,208700,39950,168750,0.8085769046478198,0
7199,7200,Rajajinagar,439600,42310,397290,0.9037534121929026,-1
7200,7201,Malleswaram,448350,63960,384390,0.8573435931749749,0
7201,7202,Whitefield,448000,66210,381790,0.8522098214285714,-1
7202,7203,Krishnarajapuram,235750,95770,139980,0.5937645811240722,0
7203,7204,Shivajinagar,336550,34000,302550,0.8989748922894072,0
7204,7205,Varthur,406700,74900,331800,0.8158347676419966,-1
7205,7206,Indiranagar,126750,59120,67630,0.5335700197238659,0
7206,7207,Vasanth Nagar,379100,55610,323490,0.8533104721709311,-1
7207,7208,Mahadevapura,372700,96360,276340,0.7414542527502013,0
7208,7209,HBR Layout,126700,71140,55560,0.438516179952644,0
7209,7210,Varthur,315350,128960,186390,0.5910575550975107,0
7210,7211,Rajajinagar,216600,56370,160230,0.7397506925207756,0
7211,7212,Indiranagar,204950,18580,186370,0.9093437423761893,-1
7212,7213,Kammanahalli,57200,162530,-105330,-1.8414335664335664,1
7213,7214,Krishnarajapuram,31200,28870,2330,0.07467948717948718,1
7214,7215,Shivajinagar,120950,23910,97040,0.8023150062009095,0
7215,7216,Vasanth Nagar,85750,81400,4350,0.05072886297376093,1
7216,7217,Malleswaram,430050,40570,389480,0.9056621323101965,-1
7217,7218,Rajajinagar,92800,50760,42040,0.4530172413793103,0
7218,7219,Vasanth Nagar,136950,16790,120160,0.8774005111354509,0
7219,7220,Varthur,329800,62230,267570,0.8113098847786537,-1
7220,7221,Malleswaram,145050,135660,9390,0.06473629782833505,1
7221,7222,Malleswaram,440900,81190,359710,0.8158539351326831,0
7222,7223,Hebbal,246650,11520,235130,0.9532941414960471,-1
7223,7224,Vasanth Nagar,140050,34440,105610,0.7540878257765083,0
7224,7225,Banaswadi,168250,50600,117650,0.6992570579494799,0
7225,7226,Kalyan Nagar,353100,39940,313160,0.8868875672613991,0
7226,7227,Hoodi,75050,52540,22510,0.29993337774816786,1
7227,7228,Hebbal,187300,68680,118620,0.6333155365723439,0
7228,7229,Hoodi,298050,53880,244170,0.8192249622546552,-1
7229,7230,Hebbal,195350,83030,112320,0.5749680061428206,0
7230,7231,Shivajinagar,135950,97330,38620,0.2840750275836705,1
7231,7232,Indiranagar,172100,58730,113370,0.6587449157466589,0
7232,7233,Shivajinagar,162750,118470,44280,0.272073732718894,1
7233,7234,Kalyan Nagar,429300,19560,409740,0.9544374563242488,-1
7234,7235,Kalyan Nagar,83150,75930,7220,0.08683102826217678,1
7235,7236,Hoodi,384100,56360,327740,0.8532673782869045,0
7236,7237,Mahadevapura,325500,34850,290650,0.8929339477726574,-1
7237,7238,Mahadevapura,354700,56550,298150,0.8405694953481816,-1
7238,7239,Varthur,395900,113410,282490,0.7135387724172771,-1
7239,7240,Rajajinagar,36450,71140,-34690,-0.9517146776406036,1
7240,7241,Banaswadi,425500,9410,416090,0.9778848413631023,-1
7241,7242,Indiranagar,419700,71410,348290,0.8298546580891113,-1
7242,7243,Indiranagar,211450,68690,142760,0.6751477890754315,0
7243,7244,Jalahalli,256600,72570,184030,0.717186282151208,0
7244,7245,Kammanahalli,65050,113020,-47970,-0.7374327440430438,1
7245,7246,Marathahalli,96350,48550,47800,0.49610793980280227,1
7246,7247,Rajajinagar,40550,57090,-16540,-0.40789149198520347,1
7247,7248,Banaswadi,363100,42710,320390,0.8823740016524373,0
7248,7249,Krishnarajapuram,74450,96550,-22100,-0.29684351914036267,1
7249,7250,Vasanth Nagar,421250,15780,405470,0.962540059347181,-1
7250,7251,HBR Layout,278850,93790,185060,0.6636542944235252,0
7251,7252,Horamavu,87000,55470,31530,0.3624137931034483,1
7252,7253,Indiranagar,236500,16530,219970,0.9301057082452431,-1
7253,7254,Banaswadi,30350,75390,-45040,-1.484019769357496,1
7254,7255,Whitefield,115400,67410,47990,0.4158578856152513,0
7255,7256,Hoodi,407300,47950,359350,0.882273508470415,0
7256,7257,Krishnarajapuram,132600,26690,105910,0.7987179487179488,0
7257,7258,Marathahalli,378900,35760,343140,0.9056215360253365,-1
7258,7259,Horamavu,278800,82580,196220,0.7038020086083214,0
7259,7260,Krishnarajapuram,203650,73950,129700,0.6368769948440952,0
7260,7261,Jalahalli,191550,151270,40280,0.21028452101279038,1
7261,7262,Malleswaram,381650,93390,288260,0.7552993580505699,0
7262,7263,Marathahalli,444650,136100,308550,0.69391656358934,0
7263,7264,Marathahalli,169850,82370,87480,0.5150426847218134,1
7264,7265,Hebbal,79000,41240,37760,0.4779746835443038,1
7265,7266,Horamavu,253900,46320,207580,0.8175659708546672,0
7266,7267,Vasanth Nagar,413450,26780,386670,0.9352279598500424,-1
7267,7268,Whitefield,253850,54090,199760,0.7869214102816624,0
7268,7269,Hoodi,54950,98820,-43870,-0.7983621474067334,1
7269,7270,HBR Layout,246750,87020,159730,0.6473353596757853,0
7270,7271,Kammanahalli,359450,47450,312000,0.8679927667269439,-1
7271,7272,HBR Layout,91650,48080,43570,0.47539552645935623,0
7272,7273,Kalyan Nagar,424100,59190,364910,0.8604338599386937,0
7273,7274,HBR Layout,424550,16340,408210,0.9615121893769873,-1
7274,7275,Malleswaram,406450,111670,294780,0.7252552589494403,0
7275,7276,Kalyan Nagar,229400,83290,146110,0.636922406277245,0
7276,7277,Malleswaram,281100,122140,158960,0.5654927072216294,0
7277,7278,CV Raman Nagar,340100,54470,285630,0.839841223169656,-1
7278,7279,Malleswaram,247600,82760,164840,0.665751211631664,0
7279,7280,Jalahalli,223250,56400,166850,0.7473684210526316,0
7280,7281,Hoodi,347650,71420,276230,0.7945634977707464,0
7281,7282,Rajajinagar,413600,147460,266140,0.6434719535783365,0
7282,7283,Indiranagar,41600,68460,-26860,-0.645673076923077,1
7283,7284,Marathahalli,65100,44180,20920,0.32135176651305686,1
7284,7285,Banaswadi,180800,25440,155360,0.8592920353982301,0
7285,7286,Shivajinagar,370300,79840,290460,0.7843910342965164,0
7286,7287,Marathahalli,298800,46240,252560,0.84524765729585,0
7287,7288,Shivajinagar,279950,0,279950,1.0,-1
7288,7289,CV Raman Nagar,133150,142300,-9150,-0.06871948929778446,1
7289,7290,Kalyan Nagar,437200,38770,398430,0.9113220494053065,-1
7290,7291,Banaswadi,404750,91310,313440,0.7744039530574429,0
7291,7292,Malleswaram,94950,84050,10900,0.114797261716693,1
7292,7293,Indiranagar,346600,62540,284060,0.8195614541257934,-1
7293,7294,Hebbal,337100,66270,270830,0.8034114506081281,-1
7294,7295,Kammanahalli,124900,93200,31700,0.25380304243394713,1
7295,7296,Hebbal,83350,46520,36830,0.44187162567486504,0
7296,7297,Rajajinagar,149000,75690,73310,0.49201342281879196,1
7297,7298,Jalahalli,195450,75730,119720,0.6125351752366334,0
7298,7299,Kammanahalli,99200,30530,68670,0.6922379032258065,0
7299,7300,Malleswaram,163700,90220,73480,0.44886988393402566,1
7300,7301,Mahadevapura,189900,27330,162570,0.8560821484992102,-1
7301,7302,Banaswadi,218400,93140,125260,0.5735347985347985,1
7302,7303,Kammanahalli,61700,35190,26510,0.42965964343598056,0
7303,7304,Marathahalli,45950,31290,14660,0.3190424374319913,1
7304,7305,Hebbal,443500,46240,397260,0.895738444193912,-1
7305,7306,CV Raman Nagar,131350,33790,97560,0.7427483821850019,0
7306,7307,Malleswaram,69800,123370,-53570,-0.7674785100286533,1
7307,7308,Marathahalli,423050,54890,368160,0.870251743292755,-1
7308,7309,Rajajinagar,206550,48580,157970,0.76480271120794,0
7309,7310,Horamavu,339100,48530,290570,0.8568858743733412,-1
7310,7311,Banaswadi,157250,73500,83750,0.5325914149443561,0
7311,7312,Vasanth Nagar,337800,45240,292560,0.8660746003552398,-1
7312,7313,Banaswadi,370850,132190,238660,0.6435486045570985,0
7313,7314,Indiranagar,33350,45150,-11800,-0.3538230884557721,1
7314,7315,Kalyan Nagar,362700,24710,337990,0.931872070581748,-1
7315,7316,HBR Layout,266600,47330,219270,0.8224681170292573,-1
7316,7317,CV Raman Nagar,390950,62810,328140,0.83934006906254,-1
7317,7318,Whitefield,40800,76300,-35500,-0.8700980392156863,1
7318,7319,Banaswadi,299750,87750,212000,0.707256046705588,0
7319,7320,Shivajinagar,371750,93730,278020,0.7478681909885676,0
7320,7321,Shivajinagar,118350,28620,89730,0.7581749049429658,0
7321,7322,Rajajinagar,337600,35510,302090,0.8948163507109005,0
7322,7323,Kammanahalli,371700,70120,301580,0.8113532418617164,-1
7323,7324,Indiranagar,149150,98900,50250,0.3369091518605431,1
7324,7325,Jalahalli,71400,41930,29470,0.41274509803921566,1
7325,7326,HBR Layout,310700,69480,241220,0.7763759253299002,0
7326,7327,Vasanth Nagar,52100,52920,-820,-0.015738963531669866,1
7327,7328,Jalahalli,433900,101620,332280,0.7657985710993317,0
7328,7329,Vasanth Nagar,171500,80500,91000,0.5306122448979592,1
7329,7330,Krishnarajapuram,205400,121800,83600,0.4070107108081792,0
7330,7331,Kammanahalli,192450,99310,93140,0.4839698623018966,1
7331,7332,Shivajinagar,166600,128350,38250,0.22959183673469388,1
7332,7333,Varthur,428250,102960,325290,0.7595796847635726,0
7333,7334,Kammanahalli,32050,39690,-7640,-0.23837753510140405,1
7334,7335,Whitefield,210350,44190,166160,0.7899215593059187,0
7335,7336,Rajajinagar,277850,60720,217130,0.7814648191470218,0
7336,7337,Varthur,109050,59100,49950,0.4580467675378267,1
7337,7338,Malleswaram,57400,40950,16450,0.2865853658536585,1
7338,7339,Krishnarajapuram,348550,59000,289550,0.830727298809353,-1
7339,7340,Shivajinagar,219800,136060,83740,0.38098271155596,1
7340,7341,Hebbal,186300,43400,142900,0.7670424047235641,0
7341,7342,Hoodi,61250,29090,32160,0.5250612244897959,0
7342,7343,Shivajinagar,269650,42430,227220,0.8426478768774337,0
7343,7344,Horamavu,427850,140680,287170,0.6711931751782166,0
7344,7345,Marathahalli,86750,47730,39020,0.44979827089337177,1
7345,7346,Shivajinagar,420250,49000,371250,0.883402736466389,0
7346,7347,Krishnarajapuram,194950,52110,142840,0.7327006924852526,0
7347,7348,Kalyan Nagar,357150,49760,307390,0.8606747865042699,-1
7348,7349,Mahadevapura,217650,92090,125560,0.576889501493223,0
7349,7350,Varthur,379600,99430,280170,0.7380663856691254,0
7350,7351,Rajajinagar,192600,68150,124450,0.6461578400830738,0
7351,7352,Krishnarajapuram,207400,54660,152740,0.7364513018322083,0
7352,7353,Jalahalli,343250,44760,298490,0.8695994173343045,-1
7353,7354,Indiranagar,96500,33230,63270,0.6556476683937824,0
7354,7355,HBR Layout,216450,60200,156250,0.7218757218757219,-1
7355,7356,Kalyan Nagar,124350,31510,92840,0.7466023321270607,0
7356,7357,CV Raman Nagar,177200,79800,97400,0.5496613995485328,0
7357,7358,Vasanth Nagar,32700,108750,-76050,-2.3256880733944953,1
7358,7359,Whitefield,63300,177930,-114630,-1.8109004739336494,1
7359,7360,Shivajinagar,155700,47630,108070,0.6940912010276172,0
7360,7361,Jalahalli,376650,115970,260680,0.6921014204168326,0
7361,7362,Krishnarajapuram,352900,55940,296960,0.8414848398979881,-1
7362,7363,Krishnarajapuram,342200,122730,219470,0.6413500876680304,0
7363,7364,Marathahalli,324050,28260,295790,0.9127912359203827,-1
7364,7365,Shivajinagar,244250,18800,225450,0.9230296827021495,-1
7365,7366,Marathahalli,254700,82450,172250,0.6762858264625049,0
7366,7367,Vasanth Nagar,385800,23500,362300,0.9390876101607051,-1
7367,7368,Hebbal,296700,113540,183160,0.6173238961914391,0
7368,7369,Malleswaram,320200,35040,285160,0.8905683947532792,-1
7369,7370,Varthur,422100,27170,394930,0.9356313669746505,-1
7370,7371,Marathahalli,265600,42110,223490,0.8414533132530121,0
7371,7372,Marathahalli,200800,98960,101840,0.5071713147410358,0
7372,7373,HBR Layout,309900,103980,205920,0.6644724104549855,0
7373,7374,Horamavu,277600,16180,261420,0.9417146974063401,-1
7374,7375,Horamavu,172700,31160,141540,0.8195715112912565,0
7375,7376,Kammanahalli,45400,69820,-24420,-0.5378854625550661,1
7376,7377,Whitefield,311400,22410,288990,0.9280346820809249,-1
7377,7378,Jalahalli,242450,127200,115250,0.4753557434522582,1
7378,7379,Krishnarajapuram,61100,84180,-23080,-0.37774140752864155,1
7379,7380,Jalahalli,136400,24370,112030,0.8213343108504398,0
7380,7381,Marathahalli,80100,79680,420,0.0052434456928838954,1
7381,7382,Whitefield,102850,33830,69020,0.6710743801652893,0
7382,7383,Hebbal,179400,87640,91760,0.5114827201783724,1
7383,7384,CV Raman Nagar,423950,32100,391850,0.9242835240004718,-1
7384,7385,Krishnarajapuram,196250,81630,114620,0.5840509554140128,0
7385,7386,Krishnarajapuram,157450,73980,83470,0.5301365512861226,1
7386,7387,Malleswaram,429600,135060,294540,0.6856145251396648,0
7387,7388,Rajajinagar,278750,68590,210160,0.7539372197309417,0
7388,7389,Horamavu,87900,64230,23670,0.2692832764505119,1
7389,7390,Whitefield,159250,34230,125020,0.7850549450549451,0
7390,7391,Mahadevapura,181450,72590,108860,0.599944888399008,0
7391,7392,Vasanth Nagar,229000,26140,202860,0.8858515283842795,-1
7392,7393,Hoodi,284400,88450,195950,0.6889943741209564,0
7393,7394,Malleswaram,145400,75890,69510,0.478060522696011,0
7394,7395,Whitefield,355350,85230,270120,0.7601519628535247,0
7395,7396,Kammanahalli,289550,70000,219550,0.7582455534450009,0
7396,7397,Kammanahalli,59000,45510,13490,0.22864406779661017,1
7397,7398,Kammanahalli,433000,44880,388120,0.8963510392609699,0
7398,7399,Varthur,436850,122090,314760,0.7205219182785854,-1
7399,7400,Shivajinagar,107550,35550,72000,0.6694560669456067,0
7400,7401,Horamavu,119450,121130,-1680,-0.014064462118041021,1
7401,7402,CV Raman Nagar,264500,102260,162240,0.6133837429111532,0
7402,7403,Indiranagar,76900,59680,17220,0.22392717815344604,1
7403,7404,Indiranagar,433350,120060,313290,0.7229491173416407,-1
7404,7405,Kammanahalli,113800,54030,59770,0.5252196836555361,1
7405,7406,Rajajinagar,221800,30210,191590,0.8637962128043283,-1
7406,7407,Shivajinagar,303900,80290,223610,0.7358012504113195,0
7407,7408,Indiranagar,416950,74860,342090,0.8204580884998202,-1
7408,7409,Hebbal,56850,70880,-14030,-0.24678979771328055,1
7409,7410,Malleswaram,438800,31250,407550,0.9287830446672743,-1
7410,7411,Hoodi,271550,64660,206890,0.761885472288713,0
7411,7412,Hebbal,180300,70530,109770,0.6088186356073211,0
7412,7413,Krishnarajapuram,396750,750,396000,0.998109640831758,-1
7413,7414,Banaswadi,201400,60080,141320,0.7016881827209533,0
7414,7415,Krishnarajapuram,206150,45710,160440,0.7782682512733446,0
7415,7416,Malleswaram,388650,90420,298230,0.767348514087225,0
7416,7417,Kalyan Nagar,94050,42730,51320,0.5456671982987773,0
7417,7418,Mahadevapura,153100,58330,94770,0.6190071848465055,0
7418,7419,Marathahalli,39750,93520,-53770,-1.3527044025157233,1
7419,7420,Horamavu,172550,106360,66190,0.38359895682410894,1
7420,7421,Kammanahalli,131700,121370,10330,0.07843583902809416,1
7421,7422,Kalyan Nagar,167450,68670,98780,0.5899074350552403,0
7422,7423,Krishnarajapuram,40900,49290,-8390,-0.20513447432762835,1
7423,7424,Varthur,256500,63780,192720,0.7513450292397661,-1
7424,7425,Shivajinagar,187900,80230,107670,0.5730175625332624,1
7425,7426,Rajajinagar,273350,23080,250270,0.9155661240168282,-1
7426,7427,Rajajinagar,202550,96370,106180,0.524216242902987,0
7427,7428,CV Raman Nagar,145450,53680,91770,0.6309384668270883,0
7428,7429,Vasanth Nagar,46850,58000,-11150,-0.23799359658484526,1
7429,7430,Marathahalli,118050,115720,2330,0.01973739940703092,1
7430,7431,Kalyan Nagar,234300,73660,160640,0.6856167306871532,0
7431,7432,Banaswadi,191950,128590,63360,0.3300859598853868,1
7432,7433,Malleswaram,125550,99120,26430,0.2105137395459976,1
7433,7434,Whitefield,140200,55330,84870,0.6053495007132668,0
7434,7435,HBR Layout,167950,19980,147970,0.8810360226257815,0
7435,7436,Vasanth Nagar,137500,15290,122210,0.8888,-1
7436,7437,Hebbal,75700,0,75700,1.0,-1
7437,7438,Krishnarajapuram,47000,53470,-6470,-0.1376595744680851,1
7438,7439,Vasanth Nagar,235100,40790,194310,0.8264993619736283,-1
7439,7440,Jalahalli,426300,107320,318980,0.7482524044100399,0
7440,7441,Varthur,121050,101810,19240,0.15894258570838496,1
7441,7442,Jalahalli,74550,85540,-10990,-0.14741784037558686,1
7442,7443,Krishnarajapuram,423000,109350,313650,0.7414893617021276,-1
7443,7444,Kalyan Nagar,223350,64450,158900,0.711439444817551,-1
7444,7445,CV Raman Nagar,264850,72820,192030,0.7250519161789692,0
7445,7446,Hoodi,302650,129000,173650,0.5737650751693375,0
7446,7447,Malleswaram,308250,42550,265700,0.8619626926196269,0
7447,7448,Malleswaram,438700,47360,391340,0.8920446774561204,-1
7448,7449,Banaswadi,137900,46270,91630,0.6644670050761421,0
7449,7450,HBR Layout,93100,131310,-38210,-0.4104189044038668,1
7450,7451,Indiranagar,283450,80970,202480,0.7143411536426177,0
7451,7452,Krishnarajapuram,32800,42820,-10020,-0.3054878048780488,1
7452,7453,Jalahalli,410700,28770,381930,0.9299488677867056,-1
7453,7454,Kammanahalli,136400,43800,92600,0.6788856304985337,0
7454,7455,Whitefield,239350,80180,159170,0.665009400459578,0
7455,7456,Malleswaram,174100,63980,110120,0.6325100516944285,0
7456,7457,Hoodi,403250,49860,353390,0.8763546187228767,-1
7457,7458,Varthur,391850,76290,315560,0.8053081536302157,-1
7458,7459,Vasanth Nagar,436150,41770,394380,0.9042301960334748,-1
7459,7460,Horamavu,288650,64990,223660,0.7748484323575264,-1
7460,7461,Marathahalli,224250,64310,159940,0.7132218506131549,0
7461,7462,Rajajinagar,231000,60280,170720,0.7390476190476191,0
7462,7463,Hebbal,104450,23140,81310,0.7784585926280517,0
7463,7464,Krishnarajapuram,447300,18390,428910,0.9588866532528504,-1
7464,7465,Mahadevapura,224350,15210,209140,0.9322041453086695,-1
7465,7466,Horamavu,397850,66150,331700,0.8337313057685057,-1
7466,7467,Mahadevapura,277300,90590,186710,0.6733141002524342,0
7467,7468,Hoodi,85150,39500,45650,0.5361127422196125,0
7468,7469,Malleswaram,149650,91970,57680,0.38543267624457067,1
7469,7470,Horamavu,58350,52240,6110,0.10471293916023994,1
7470,7471,Malleswaram,261750,57250,204500,0.7812798471824259,0
7471,7472,Banaswadi,236700,99990,136710,0.5775665399239543,0
7472,7473,Krishnarajapuram,253100,48730,204370,0.807467404188068,0
7473,7474,Hebbal,72300,92830,-20530,-0.2839557399723375,1
7474,7475,Vasanth Nagar,393900,64160,329740,0.8371160192942371,-1
7475,7476,HBR Layout,155550,13690,141860,0.9119897139183543,-1
7476,7477,Krishnarajapuram,49350,25940,23410,0.47436676798378924,0
7477,7478,CV Raman Nagar,56100,93840,-37740,-0.6727272727272727,1
7478,7479,Varthur,192600,49130,143470,0.7449117341640706,-1
7479,7480,Horamavu,408950,19850,389100,0.9514610588091453,-1
7480,7481,Krishnarajapuram,273250,82010,191240,0.699871912168344,0
7481,7482,Kammanahalli,371600,4020,367580,0.9891819160387514,-1
7482,7483,Rajajinagar,91600,86620,4980,0.054366812227074235,1
7483,7484,Vasanth Nagar,430900,71230,359670,0.8346948247853331,-1
7484,7485,Marathahalli,147900,39460,108440,0.7331981068289385,-1
7485,7486,Banaswadi,374900,39450,335450,0.8947719391837824,0
7486,7487,HBR Layout,132800,124910,7890,0.05941265060240964,1
7487,7488,Kammanahalli,142050,58480,83570,0.5883139739528335,1
7488,7489,Rajajinagar,326100,41300,284800,0.8733517325973628,-1
7489,7490,Malleswaram,47700,79960,-32260,-0.6763102725366876,1
7490,7491,Hebbal,93700,86120,7580,0.0808964781216649,1
7491,7492,CV Raman Nagar,139000,83730,55270,0.3976258992805755,1
7492,7493,Varthur,263700,44130,219570,0.832650739476678,-1
7493,7494,Indiranagar,102100,150440,-48340,-0.47345739471106757,1
7494,7495,Mahadevapura,410050,47270,362780,0.8847213754420192,-1
7495,7496,Krishnarajapuram,448200,43110,405090,0.9038152610441768,-1
7496,7497,HBR Layout,299850,61410,238440,0.7951975987993997,0
7497,7498,HBR Layout,250200,63330,186870,0.7468824940047961,0
7498,7499,CV Raman Nagar,440900,20930,419970,0.9525289181220231,-1
7499,7500,Hebbal,136800,80490,56310,0.41162280701754383,0
7500,7501,Whitefield,417550,16370,401180,0.9607951143575619,-1
7501,7502,Horamavu,140950,19660,121290,0.8605179141539553,-1
7502,7503,Banaswadi,116350,64990,51360,0.4414267296948861,1
7503,7504,Varthur,261350,92420,168930,0.64637459345705,0
7504,7505,Mahadevapura,442650,56600,386050,0.8721337399751496,-1
7505,7506,Hebbal,57500,24520,32980,0.5735652173913044,1
7506,7507,Jalahalli,449350,40420,408930,0.9100478468899521,-1
7507,7508,Kalyan Nagar,384600,20780,363820,0.9459698387935518,-1
7508,7509,Vasanth Nagar,206800,67900,138900,0.6716634429400387,0
7509,7510,Jalahalli,340750,45380,295370,0.8668231841526045,-1
7510,7511,Whitefield,229000,76170,152830,0.6673799126637554,0
7511,7512,Krishnarajapuram,66950,56100,10850,0.16206123973114264,1
7512,7513,Marathahalli,194850,104480,90370,0.46379266102129846,0
7513,7514,Whitefield,316050,75830,240220,0.7600696092390444,0
7514,7515,Hoodi,171600,100190,71410,0.41614219114219114,1
7515,7516,Shivajinagar,168000,17140,150860,0.8979761904761905,-1
7516,7517,Kammanahalli,40600,45350,-4750,-0.11699507389162561,1
7517,7518,Whitefield,291400,115420,175980,0.6039121482498284,0
7518,7519,Vasanth Nagar,430200,61960,368240,0.8559739655973966,-1
7519,7520,Malleswaram,291100,55110,235990,0.8106836138783923,-1
7520,7521,Hebbal,198450,77830,120620,0.6078105316200554,0
7521,7522,Krishnarajapuram,257750,34730,223020,0.8652570320077595,-1
7522,7523,Horamavu,169850,56220,113630,0.6690020606417427,0
7523,7524,CV Raman Nagar,180250,123380,56870,0.315506241331484,1
7524,7525,Vasanth Nagar,98950,60790,38160,0.38564931783729156,1
7525,7526,HBR Layout,272450,61200,211250,0.7753716278216186,0
7526,7527,Banaswadi,252200,55620,196580,0.7794607454401269,0
7527,7528,Hebbal,336450,36680,299770,0.8909793431416257,0
7528,7529,Hebbal,127800,95260,32540,0.2546165884194053,1
7529,7530,CV Raman Nagar,143100,63410,79690,0.5568832983927323,1
7530,7531,CV Raman Nagar,287050,44060,242990,0.8465075770771643,-1
7531,7532,Indiranagar,112450,82440,30010,0.2668741662961316,1
7532,7533,HBR Layout,401050,28560,372490,0.9287869342974692,-1
7533,7534,Kalyan Nagar,70000,56530,13470,0.19242857142857142,1
7534,7535,Mahadevapura,223750,102290,121460,0.5428379888268157,0
7535,7536,Kammanahalli,189000,80570,108430,0.5737037037037037,0
7536,7537,Malleswaram,148750,41950,106800,0.717983193277311,-1
7537,7538,Horamavu,441000,47250,393750,0.8928571428571429,-1
7538,7539,Indiranagar,161800,77090,84710,0.5235475896168109,0
7539,7540,Kalyan Nagar,341150,85490,255660,0.7494064194635791,-1
7540,7541,Rajajinagar,148850,44070,104780,0.7039301310043669,0
7541,7542,Hoodi,358200,80460,277740,0.7753768844221105,-1
7542,7543,Jalahalli,82500,94550,-12050,-0.14606060606060606,1
7543,7544,Kammanahalli,263300,19090,244210,0.9274971515381694,-1
7544,7545,CV Raman Nagar,118300,82190,36110,0.30524091293322064,1
7545,7546,Vasanth Nagar,64600,72190,-7590,-0.1174922600619195,1
7546,7547,CV Raman Nagar,201400,99390,102010,0.5065044687189673,0
7547,7548,HBR Layout,62400,53760,8640,0.13846153846153847,1
7548,7549,Mahadevapura,302750,143990,158760,0.524393063583815,1
7549,7550,Whitefield,414750,50000,364750,0.8794454490657022,-1
7550,7551,Kalyan Nagar,62400,56310,6090,0.09759615384615385,1
7551,7552,Kammanahalli,353650,20960,332690,0.9407323625053019,-1
7552,7553,Malleswaram,378500,43040,335460,0.8862879788639366,0
7553,7554,Indiranagar,91950,68310,23640,0.2570962479608483,1
7554,7555,Jalahalli,131350,3890,127460,0.9703844689760183,-1
7555,7556,HBR Layout,264450,101490,162960,0.6162223482699943,0
7556,7557,Whitefield,364050,137000,227050,0.6236780661996978,0
7557,7558,Malleswaram,58900,45680,13220,0.22444821731748726,1
7558,7559,Hebbal,35950,58300,-22350,-0.6216968011126565,1
7559,7560,Whitefield,145300,63030,82270,0.566207845836201,1
7560,7561,Hoodi,367100,92260,274840,0.7486788341051485,0
7561,7562,Horamavu,145900,164410,-18510,-0.12686771761480467,1
7562,7563,Rajajinagar,321850,146880,174970,0.5436383408420071,0
7563,7564,Krishnarajapuram,244150,115550,128600,0.5267253737456482,1
7564,7565,Marathahalli,116050,92210,23840,0.2054286945282206,1
7565,7566,HBR Layout,179100,113140,65960,0.368285873813512,1
7566,7567,Whitefield,63700,79490,-15790,-0.2478806907378336,1
7567,7568,Banaswadi,26100,43220,-17120,-0.6559386973180077,1
7568,7569,Kalyan Nagar,277100,10040,267060,0.9637675929267413,-1
7569,7570,Vasanth Nagar,343750,62480,281270,0.81824,-1
7570,7571,HBR Layout,179500,76690,102810,0.5727576601671309,1
7571,7572,Marathahalli,161350,56560,104790,0.6494577006507593,0
7572,7573,Malleswaram,201800,43980,157820,0.7820614469772051,-1
7573,7574,Whitefield,433900,57480,376420,0.8675270799723439,-1
7574,7575,Banaswadi,345150,74160,270990,0.7851368970013037,0
7575,7576,Jalahalli,28350,44420,-16070,-0.5668430335097002,1
7576,7577,Mahadevapura,305200,63900,241300,0.7906290956749672,-1
7577,7578,Whitefield,254350,71510,182840,0.7188519756241399,0
7578,7579,Banaswadi,393450,36060,357390,0.908349218452154,-1
7579,7580,Mahadevapura,66950,62090,4860,0.07259148618371919,1
7580,7581,Indiranagar,89350,115030,-25680,-0.28740906547285955,1
7581,7582,Whitefield,52750,105910,-53160,-1.0077725118483412,1
7582,7583,Horamavu,62250,96520,-34270,-0.5505220883534137,1
7583,7584,Kammanahalli,71800,105420,-33620,-0.4682451253481894,1
7584,7585,Horamavu,347600,115490,232110,0.6677502876869965,0
7585,7586,Marathahalli,130750,38460,92290,0.7058508604206502,-1
7586,7587,Shivajinagar,370450,94350,276100,0.7453097584019436,0
7587,7588,Jalahalli,284600,62720,221880,0.7796205200281097,-1
7588,7589,Krishnarajapuram,284800,46760,238040,0.835814606741573,0
7589,7590,Indiranagar,368850,98090,270760,0.7340653382133658,-1
7590,7591,Marathahalli,27900,56260,-28360,-1.0164874551971326,1
7591,7592,Mahadevapura,151500,86550,64950,0.4287128712871287,1
7592,7593,CV Raman Nagar,155850,46280,109570,0.7030478023740776,0
7593,7594,Marathahalli,320900,27280,293620,0.9149890931754441,-1
7594,7595,Marathahalli,209700,101170,108530,0.5175488793514544,0
7595,7596,Varthur,81800,79040,2760,0.03374083129584352,1
7596,7597,Indiranagar,212000,148750,63250,0.2983490566037736,1
7597,7598,Whitefield,35400,66750,-31350,-0.885593220338983,1
7598,7599,Jalahalli,421900,29930,391970,0.9290590187248163,-1
7599,7600,Malleswaram,274150,61810,212340,0.7745394856830202,0
7600,7601,Marathahalli,148550,38870,109680,0.7383372601817569,0
7601,7602,Rajajinagar,260500,159470,101030,0.387831094049904,1
7602,7603,Jalahalli,267900,60680,207220,0.7734975737215379,0
7603,7604,HBR Layout,50350,8550,41800,0.8301886792452831,-1
7604,7605,Kalyan Nagar,374400,23380,351020,0.9375534188034188,-1
7605,7606,CV Raman Nagar,181400,77130,104270,0.5748070562293275,0
7606,7607,Kalyan Nagar,108750,60280,48470,0.4457011494252874,0
7607,7608,Horamavu,304300,46280,258020,0.8479132435096943,-1
7608,7609,Hoodi,252550,60350,192200,0.7610374183330033,-1
7609,7610,Mahadevapura,361650,58650,303000,0.8378266279552053,-1
7610,7611,Whitefield,431300,81300,350000,0.811500115928588,-1
7611,7612,Shivajinagar,32650,116210,-83560,-2.5592649310872893,1
7612,7613,Shivajinagar,253750,40110,213640,0.8419310344827586,-1
7613,7614,Shivajinagar,31000,104160,-73160,-2.36,1
7614,7615,CV Raman Nagar,43650,37580,6070,0.13906071019473082,1
7615,7616,Horamavu,227950,64970,162980,0.71498135556043,-1
7616,7617,Kalyan Nagar,168150,98260,69890,0.41564079690752304,1
7617,7618,Banaswadi,93900,34330,59570,0.6343982960596379,0
7618,7619,Mahadevapura,428200,49200,379000,0.8851004203643157,0
7619,7620,Varthur,217900,67770,150130,0.6889857732905003,0
7620,7621,CV Raman Nagar,260950,27730,233220,0.8937344318835025,-1
7621,7622,Whitefield,269100,33590,235510,0.8751765143069491,0
7622,7623,CV Raman Nagar,341050,64310,276740,0.8114352734203196,-1
7623,7624,Jalahalli,233700,49450,184250,0.7884039366709457,0
7624,7625,Krishnarajapuram,58650,94100,-35450,-0.6044330775788577,1
7625,7626,Rajajinagar,130550,55160,75390,0.5774798927613941,1
7626,7627,Kammanahalli,299500,45290,254210,0.8487813021702838,0
7627,7628,CV Raman Nagar,168100,65080,103020,0.612849494348602,0
7628,7629,Whitefield,56200,47280,8920,0.15871886120996442,1
7629,7630,Kammanahalli,382300,61050,321250,0.8403086581218938,-1
7630,7631,CV Raman Nagar,99400,99680,-280,-0.0028169014084507044,1
7631,7632,Horamavu,45750,101860,-56110,-1.226448087431694,1
7632,7633,Vasanth Nagar,401800,98860,302940,0.7539571926331509,-1
7633,7634,Varthur,65450,13220,52230,0.7980137509549274,0
7634,7635,Jalahalli,403400,72980,330420,0.819087754090233,-1
7635,7636,Kalyan Nagar,124750,108590,16160,0.12953907815631263,1
7636,7637,Marathahalli,76800,48700,28100,0.3658854166666667,1
7637,7638,Hoodi,135200,71180,64020,0.4735207100591716,1
7638,7639,Indiranagar,222150,68790,153360,0.6903443619176233,0
7639,7640,Kalyan Nagar,137700,63060,74640,0.5420479302832244,0
7640,7641,CV Raman Nagar,80600,73820,6780,0.08411910669975187,1
7641,7642,Hebbal,280250,31800,248450,0.8865298840321142,-1
7642,7643,Krishnarajapuram,183450,53930,129520,0.7060234396293268,0
7643,7644,Hoodi,282900,53140,229760,0.8121597737716507,0
7644,7645,Malleswaram,196950,38920,158030,0.8023863924854023,0
7645,7646,Hebbal,108750,115800,-7050,-0.06482758620689655,1
7646,7647,Whitefield,232900,56240,176660,0.7585229712322885,-1
7647,7648,Shivajinagar,271100,57010,214090,0.7897085946145334,0
7648,7649,Rajajinagar,361400,54090,307310,0.8503320420586608,0
7649,7650,HBR Layout,105500,79070,26430,0.25052132701421803,1
7650,7651,Hebbal,48300,73340,-25040,-0.5184265010351967,1
7651,7652,Vasanth Nagar,64400,85130,-20730,-0.3218944099378882,1
7652,7653,HBR Layout,251400,71720,179680,0.7147175815433572,0
7653,7654,Rajajinagar,341250,114510,226740,0.6644395604395604,0
7654,7655,Rajajinagar,257800,35840,221960,0.860977501939488,0
7655,7656,Krishnarajapuram,414850,81110,333740,0.8044835482704592,-1
7656,7657,HBR Layout,336500,115020,221480,0.658187221396731,0
7657,7658,Hoodi,216700,82640,134060,0.6186432856483618,0
7658,7659,Kalyan Nagar,97500,75950,21550,0.221025641025641,1
7659,7660,Vasanth Nagar,183850,48250,135600,0.7375577916779984,-1
7660,7661,Malleswaram,274750,113310,161440,0.5875887170154686,1
7661,7662,Mahadevapura,392300,54890,337410,0.8600815702268672,-1
7662,7663,Vasanth Nagar,385200,93020,292180,0.758515057113188,0
7663,7664,Marathahalli,409450,81150,328300,0.8018073024789352,-1
7664,7665,Rajajinagar,221050,66040,155010,0.7012440624293146,0
7665,7666,Indiranagar,197550,73130,124420,0.6298152366489497,0
7666,7667,Hoodi,164100,58600,105500,0.6429006703229738,0
7667,7668,Shivajinagar,229500,43430,186070,0.8107625272331155,-1
7668,7669,Jalahalli,57150,24620,32530,0.5692038495188102,1
7669,7670,CV Raman Nagar,226200,69780,156420,0.6915119363395226,0
7670,7671,Vasanth Nagar,52900,88640,-35740,-0.6756143667296787,1
7671,7672,Indiranagar,333050,39560,293490,0.8812190361807536,-1
7672,7673,Shivajinagar,140400,24440,115960,0.825925925925926,-1
7673,7674,Varthur,440100,42100,398000,0.9043399227448308,-1
7674,7675,Varthur,116800,46970,69830,0.5978595890410959,0
7675,7676,Kammanahalli,67350,88720,-21370,-0.31729769858945805,1
7676,7677,Shivajinagar,172500,43970,128530,0.7451014492753624,0
7677,7678,Whitefield,179550,4380,175170,0.9756056808688388,-1
7678,7679,Mahadevapura,341250,32760,308490,0.904,-1
7679,7680,Mahadevapura,355350,67450,287900,0.8101871394399888,0
7680,7681,Indiranagar,298900,90130,208770,0.6984610237537638,0
7681,7682,Whitefield,31550,41920,-10370,-0.32868462757527733,1
7682,7683,Malleswaram,98150,166870,-68720,-0.7001528273051452,1
7683,7684,Hebbal,83650,35880,47770,0.5710699342498505,0
7684,7685,Jalahalli,227450,71620,155830,0.6851176082655529,0
7685,7686,CV Raman Nagar,82650,52700,29950,0.3623714458560194,1
7686,7687,Jalahalli,133800,36380,97420,0.728101644245142,0
7687,7688,CV Raman Nagar,66750,76450,-9700,-0.1453183520599251,1
7688,7689,Horamavu,406950,96670,310280,0.7624523897284678,0
7689,7690,Marathahalli,346500,95950,250550,0.7230880230880231,0
7690,7691,Krishnarajapuram,446400,92250,354150,0.7933467741935484,0
7691,7692,Malleswaram,392550,17160,375390,0.9562858234619793,-1
7692,7693,Indiranagar,98500,0,98500,1.0,-1
7693,7694,Krishnarajapuram,60100,38410,21690,0.36089850249584027,1
7694,7695,Marathahalli,103850,70210,33640,0.3239287433798748,1
7695,7696,Hoodi,191800,94460,97340,0.5075078206465068,1
7696,7697,Banaswadi,193850,81550,112300,0.5793139025019345,0
7697,7698,Malleswaram,164100,18600,145500,0.886654478976234,-1
7698,7699,Indiranagar,441850,51590,390260,0.8832409188638678,-1
7699,7700,Kalyan Nagar,325500,43230,282270,0.8671889400921658,0
7700,7701,Whitefield,378100,32160,345940,0.9149431367363131,-1
7701,7702,Kalyan Nagar,199850,46200,153650,0.7688266199649737,0
7702,7703,Jalahalli,399450,24210,375240,0.9393916635373639,-1
7703,7704,Horamavu,360400,29170,331230,0.9190621531631521,-1
7704,7705,Rajajinagar,188900,53780,135120,0.7152991000529381,0
7705,7706,Whitefield,98700,45210,53490,0.5419452887537994,1
7706,7707,Hebbal,329650,27890,301760,0.9153951160321553,-1
7707,7708,Rajajinagar,136000,90540,45460,0.33426470588235296,1
7708,7709,HBR Layout,263900,41730,222170,0.8418719211822661,0
7709,7710,Rajajinagar,422750,64390,358360,0.8476877587226493,-1
7710,7711,Indiranagar,398250,0,398250,1.0,-1
7711,7712,HBR Layout,297250,23510,273740,0.9209083263246426,-1
7712,7713,Hebbal,48300,82190,-33890,-0.701656314699793,1
7713,7714,Kammanahalli,212950,90970,121980,0.5728105189011505,0
7714,7715,Kammanahalli,131850,17600,114250,0.8665149791429655,-1
7715,7716,Shivajinagar,211050,44580,166470,0.788770433546553,0
7716,7717,Mahadevapura,446250,98600,347650,0.7790476190476191,0
7717,7718,Kammanahalli,412100,60580,351520,0.8529968454258675,-1
7718,7719,CV Raman Nagar,89550,88600,950,0.01060859854829704,1
7719,7720,Vasanth Nagar,139350,81300,58050,0.41657696447793324,1
7720,7721,Marathahalli,71900,106890,-34990,-0.4866481223922114,1
7721,7722,Rajajinagar,387950,53230,334720,0.8627915968552649,-1
7722,7723,Jalahalli,261550,64500,197050,0.7533932326515007,0
7723,7724,Mahadevapura,394350,28820,365530,0.9269177126917713,-1
7724,7725,Horamavu,250750,48350,202400,0.8071784646061815,0
7725,7726,Jalahalli,137200,107220,29980,0.2185131195335277,1
7726,7727,Mahadevapura,404950,22280,382670,0.9449808618347945,-1
7727,7728,Shivajinagar,66200,75100,-8900,-0.13444108761329304,1
7728,7729,Jalahalli,375900,35700,340200,0.9050279329608939,-1
7729,7730,Banaswadi,198600,84070,114530,0.576686807653575,0
7730,7731,Vasanth Nagar,421400,104370,317030,0.7523255813953489,-1
7731,7732,Banaswadi,307750,107650,200100,0.6502030869212023,0
7732,7733,Whitefield,321050,2630,318420,0.9918081295748326,-1
7733,7734,Banaswadi,113550,14370,99180,0.873447820343461,0
7734,7735,Rajajinagar,281750,97280,184470,0.6547293700088731,0
7735,7736,Hoodi,112900,84080,28820,0.2552701505757307,1
7736,7737,Mahadevapura,73450,55220,18230,0.24819605173587475,1
7737,7738,Kammanahalli,68550,11240,57310,0.8360320933625092,0
7738,7739,Jalahalli,180650,46830,133820,0.7407694436756158,0
7739,7740,Marathahalli,130650,49450,81200,0.6215078453884424,0
7740,7741,Kalyan Nagar,309250,40460,268790,0.8691673403395311,-1
7741,7742,Malleswaram,85300,60900,24400,0.28604923798358733,1
7742,7743,Jalahalli,275500,40770,234730,0.8520145190562614,-1
7743,7744,Varthur,434950,90940,344010,0.7909184963788941,0
7744,7745,Krishnarajapuram,143450,90480,52970,0.36925758103868944,1
7745,7746,Vasanth Nagar,63550,68840,-5290,-0.08324154209284028,1
7746,7747,HBR Layout,64500,39740,24760,0.3838759689922481,1
7747,7748,Marathahalli,69450,14470,54980,0.7916486681065514,0
7748,7749,Kalyan Nagar,375150,95540,279610,0.7453285352525656,-1
7749,7750,Hoodi,345550,26210,319340,0.9241499059470409,-1
7750,7751,Jalahalli,105200,22290,82910,0.7881178707224334,0
7751,7752,CV Raman Nagar,322450,20020,302430,0.937912854706156,-1
7752,7753,Shivajinagar,262850,57620,205230,0.780787521400038,-1
7753,7754,Mahadevapura,196400,71230,125170,0.6373217922606924,0
7754,7755,Horamavu,321400,17640,303760,0.9451151213441195,-1
7755,7756,Kalyan Nagar,327250,29430,297820,0.9100687547746371,-1
7756,7757,Marathahalli,139650,55030,84620,0.6059434300035804,0
7757,7758,Vasanth Nagar,438350,108640,329710,0.7521615147713014,0
7758,7759,Varthur,267100,48260,218840,0.8193186072631973,-1
7759,7760,Hoodi,131100,48590,82510,0.6293668954996187,0
7760,7761,Shivajinagar,267850,66280,201570,0.7525480679484786,-1
7761,7762,Shivajinagar,382350,61950,320400,0.8379756767359748,0
7762,7763,Hoodi,93200,76730,16470,0.1767167381974249,1
7763,7764,Banaswadi,379500,100120,279380,0.7361791831357049,0
7764,7765,Shivajinagar,373100,44810,328290,0.879898150629858,0
7765,7766,Vasanth Nagar,372200,58060,314140,0.8440085975282107,0
7766,7767,Jalahalli,129500,20370,109130,0.8427027027027028,-1
7767,7768,Hebbal,445950,28300,417650,0.9365399708487498,-1
7768,7769,Vasanth Nagar,244550,37770,206780,0.8455530566346351,0
7769,7770,Rajajinagar,180700,72220,108480,0.6003320420586608,0
7770,7771,HBR Layout,236800,12340,224460,0.9478885135135136,-1
7771,7772,Horamavu,210450,50870,159580,0.758279876455215,-1
7772,7773,Whitefield,269900,146210,123690,0.4582808447573175,1
7773,7774,Kammanahalli,407000,84190,322810,0.7931449631449632,0
7774,7775,Hoodi,163950,48430,115520,0.7046050625190607,-1
7775,7776,Mahadevapura,430100,25570,404530,0.940548709602418,-1
7776,7777,Indiranagar,159500,104630,54870,0.344012539184953,1
7777,7778,Banaswadi,79250,30240,49010,0.618422712933754,0
7778,7779,Varthur,187300,23160,164140,0.8763481046449546,-1
7779,7780,Banaswadi,131100,59180,71920,0.5485888634630054,0
7780,7781,Jalahalli,395950,75060,320890,0.8104306099254956,-1
7781,7782,Horamavu,51600,67810,-16210,-0.31414728682170545,1
7782,7783,HBR Layout,216200,47950,168250,0.7782146160962072,0
7783,7784,Rajajinagar,375100,91790,283310,0.7552919221540922,0
7784,7785,Whitefield,237200,80250,156950,0.6616779089376054,0
7785,7786,Vasanth Nagar,313300,64500,248800,0.7941270347909352,0
7786,7787,Mahadevapura,30050,54260,-24210,-0.805657237936772,1
7787,7788,Rajajinagar,102250,101600,650,0.006356968215158924,1
7788,7789,Jalahalli,401650,55870,345780,0.8608987924810159,-1
7789,7790,Shivajinagar,81650,34230,47420,0.580771586037967,0
7790,7791,Shivajinagar,288050,106960,181090,0.6286755771567436,0
7791,7792,Hoodi,173150,60570,112580,0.6501876985272885,0
7792,7793,Rajajinagar,85650,24390,61260,0.7152364273204904,0
7793,7794,Vasanth Nagar,269400,37090,232310,0.8623236822568671,0
7794,7795,CV Raman Nagar,95550,36870,58680,0.6141287284144427,0
7795,7796,Banaswadi,316500,114420,202080,0.6384834123222749,0
7796,7797,Horamavu,336900,67450,269450,0.7997922232116355,-1
7797,7798,Rajajinagar,135850,77110,58740,0.43238866396761133,1
7798,7799,HBR Layout,142250,25530,116720,0.8205272407732864,-1
7799,7800,Varthur,212150,55270,156880,0.7394767852934244,-1
7800,7801,Rajajinagar,396150,40460,355690,0.897866969582229,-1
7801,7802,Kalyan Nagar,353850,97810,256040,0.7235834393104422,0
7802,7803,CV Raman Nagar,206700,62940,143760,0.6955007256894049,0
7803,7804,Marathahalli,339000,91440,247560,0.7302654867256637,0
7804,7805,Whitefield,111550,24270,87280,0.7824294038547737,0
7805,7806,Indiranagar,208400,50060,158340,0.7597888675623801,-1
7806,7807,Banaswadi,339300,58050,281250,0.8289124668435013,0
7807,7808,Jalahalli,351900,59410,292490,0.8311736288718385,-1
7808,7809,Kammanahalli,156000,46240,109760,0.7035897435897436,0
7809,7810,Rajajinagar,198650,156350,42300,0.21293732695695947,1
7810,7811,Hebbal,316800,77140,239660,0.7565025252525253,-1
7811,7812,Marathahalli,129150,97750,31400,0.24312814556716997,1
7812,7813,Indiranagar,70950,58650,12300,0.1733615221987315,1
7813,7814,Banaswadi,27450,28980,-1530,-0.05573770491803279,1
7814,7815,Horamavu,230200,35320,194880,0.8465682015638575,-1
7815,7816,Banaswadi,128250,72520,55730,0.434541910331384,1
7816,7817,Horamavu,334650,49610,285040,0.851755565516211,0
7817,7818,Horamavu,34100,69010,-34910,-1.0237536656891495,1
7818,7819,Malleswaram,378450,38440,340010,0.8984277975954551,-1
7819,7820,Varthur,277900,28950,248950,0.895825836631882,0
7820,7821,Malleswaram,342150,55770,286380,0.837001315212626,-1
7821,7822,Horamavu,288200,109540,178660,0.6199167244968772,0
7822,7823,Banaswadi,388150,68880,319270,0.8225428313796213,-1
7823,7824,Indiranagar,151750,22630,129120,0.8508731466227347,-1
7824,7825,Varthur,41200,85240,-44040,-1.0689320388349515,1
7825,7826,Shivajinagar,419500,50930,368570,0.8785935637663885,0
7826,7827,Indiranagar,136250,66260,69990,0.5136880733944954,0
7827,7828,Hoodi,135800,95540,40260,0.29646539027982327,1
7828,7829,Mahadevapura,144750,46350,98400,0.6797927461139897,0
7829,7830,Marathahalli,444600,109850,334750,0.7529239766081871,0
7830,7831,Vasanth Nagar,175050,34270,140780,0.804227363610397,-1
7831,7832,CV Raman Nagar,349300,144260,205040,0.5870025765817349,0
7832,7833,Kalyan Nagar,273950,72010,201940,0.7371418141996715,0
7833,7834,Vasanth Nagar,245000,111920,133080,0.5431836734693878,0
7834,7835,Kalyan Nagar,129500,82040,47460,0.36648648648648646,1
7835,7836,Whitefield,28750,55400,-26650,-0.9269565217391305,1
7836,7837,Indiranagar,131000,91230,39770,0.30358778625954197,1
7837,7838,Banaswadi,405850,66610,339240,0.8358753233953431,-1
7838,7839,Malleswaram,147550,57480,90070,0.6104371399525584,0
7839,7840,Horamavu,448650,37540,411110,0.9163267580519335,-1
7840,7841,Whitefield,62350,26120,36230,0.5810745789895749,0
7841,7842,Hoodi,97250,53620,43630,0.4486375321336761,1
7842,7843,Whitefield,392450,133230,259220,0.6605172633456491,0
7843,7844,Vasanth Nagar,87600,78920,8680,0.09908675799086758,1
7844,7845,Whitefield,161950,24090,137860,0.8512503859215808,0
7845,7846,Vasanth Nagar,282900,67040,215860,0.7630258041710852,0
7846,7847,Mahadevapura,288800,25620,263180,0.9112880886426593,-1
7847,7848,Rajajinagar,344100,79610,264490,0.7686428363847718,-1
7848,7849,Hebbal,93800,91570,2230,0.023773987206823027,1
7849,7850,Marathahalli,244000,50130,193870,0.7945491803278688,-1
7850,7851,HBR Layout,374700,116010,258690,0.6903923138510809,0
7851,7852,Rajajinagar,125450,51220,74230,0.5917098445595855,0
7852,7853,Kalyan Nagar,85650,69740,15910,0.18575598365440749,1
7853,7854,Shivajinagar,77300,165770,-88470,-1.1445019404915913,1
7854,7855,Indiranagar,307750,45040,262710,0.8536474411047928,-1
7855,7856,CV Raman Nagar,158250,47800,110450,0.6979462875197472,0
7856,7857,Rajajinagar,317450,97780,219670,0.6919829894471571,0
7857,7858,Rajajinagar,248550,63170,185380,0.7458459062562864,0
7858,7859,Jalahalli,398450,53200,345250,0.8664826201530932,0
7859,7860,Varthur,76200,61100,15100,0.19816272965879264,1
7860,7861,Mahadevapura,439950,83430,356520,0.81036481418343,-1
7861,7862,Indiranagar,45500,23460,22040,0.4843956043956044,1
7862,7863,CV Raman Nagar,187700,33180,154520,0.8232285562067129,-1
7863,7864,Kalyan Nagar,82550,50430,32120,0.3890975166565718,1
7864,7865,Hoodi,111950,95180,16770,0.1497990174184904,1
7865,7866,Shivajinagar,139650,61310,78340,0.5609738632295024,1
7866,7867,Hoodi,183400,76070,107330,0.5852235550708833,0
7867,7868,Kammanahalli,362750,57380,305370,0.8418194348725018,0
7868,7869,Jalahalli,207950,79050,128900,0.6198605433998557,0
7869,7870,Horamavu,27050,112270,-85220,-3.1504621072088725,1
7870,7871,Whitefield,223500,83480,140020,0.6264876957494407,0
7871,7872,Marathahalli,379400,77520,301880,0.795677385345282,-1
7872,7873,Kalyan Nagar,444750,77560,367190,0.825609893198426,-1
7873,7874,Banaswadi,385600,78130,307470,0.7973807053941909,0
7874,7875,Indiranagar,396450,120190,276260,0.6968344053474587,0
7875,7876,Hoodi,200100,96670,103430,0.5168915542228886,0
7876,7877,Whitefield,282400,72690,209710,0.742599150141643,0
7877,7878,Shivajinagar,222450,67050,155400,0.698583951449764,0
7878,7879,Kalyan Nagar,395600,34650,360950,0.9124115267947421,-1
7879,7880,CV Raman Nagar,358300,39020,319280,0.8910968462182529,-1
7880,7881,Vasanth Nagar,297100,74250,222850,0.7500841467519354,-1
7881,7882,Malleswaram,379450,114090,265360,0.699327974700224,0
7882,7883,Shivajinagar,63450,34970,28480,0.44885736800630416,1
7883,7884,Marathahalli,417700,96030,321670,0.7700981565717022,-1
7884,7885,Krishnarajapuram,206950,100190,106760,0.515873399371829,0
7885,7886,Hebbal,59750,89940,-30190,-0.5052719665271966,1
7886,7887,Jalahalli,328950,26630,302320,0.9190454476364189,-1
7887,7888,Hoodi,412900,62600,350300,0.8483894405425042,-1
7888,7889,Rajajinagar,131400,65400,66000,0.502283105022831,0
7889,7890,Shivajinagar,168550,81520,87030,0.5163452981311184,0
7890,7891,Indiranagar,214900,62100,152800,0.7110283852954863,-1
7891,7892,Kammanahalli,180700,78180,102520,0.5673491975650249,0
7892,7893,Malleswaram,180300,30680,149620,0.8298391569606212,0
7893,7894,Hoodi,220850,99780,121070,0.5482001358388047,0
7894,7895,Whitefield,25300,3350,21950,0.8675889328063241,0
7895,7896,Marathahalli,265900,76760,189140,0.711320045129748,-1
7896,7897,Whitefield,42150,67940,-25790,-0.6118623962040333,1
7897,7898,Varthur,343550,132640,210910,0.6139135497016446,0
7898,7899,Hebbal,262900,54740,208160,0.7917839482693039,0
7899,7900,CV Raman Nagar,287800,94830,192970,0.6705003474635163,0
7900,7901,HBR Layout,303100,114970,188130,0.6206862421643022,0
7901,7902,Varthur,276400,42690,233710,0.8455499276410998,0
7902,7903,CV Raman Nagar,62850,32560,30290,0.4819411296738266,1
7903,7904,Jalahalli,448050,30290,417760,0.9323959379533534,-1
7904,7905,Rajajinagar,424850,85660,339190,0.7983758973755443,-1
7905,7906,Mahadevapura,287800,99320,188480,0.6548992355802641,0
7906,7907,Varthur,177400,57760,119640,0.6744081172491545,0
7907,7908,Mahadevapura,167400,13630,153770,0.9185782556750298,-1
7908,7909,Rajajinagar,152600,100070,52530,0.3442332896461337,1
7909,7910,Vasanth Nagar,230350,107740,122610,0.5322769698285218,0
7910,7911,Kammanahalli,128400,67420,60980,0.4749221183800623,1
7911,7912,Whitefield,414200,92380,321820,0.7769676484789957,0
7912,7913,CV Raman Nagar,449850,129590,320260,0.7119261976214294,0
7913,7914,Marathahalli,355000,39040,315960,0.8900281690140845,0
7914,7915,Varthur,157400,52180,105220,0.6684879288437103,0
7915,7916,Rajajinagar,112800,5420,107380,0.951950354609929,-1
7916,7917,Hebbal,43350,61410,-18060,-0.4166089965397924,1
7917,7918,Indiranagar,69250,15790,53460,0.771985559566787,-1
7918,7919,Marathahalli,133200,36110,97090,0.7289039039039039,0
7919,7920,Vasanth Nagar,228450,104320,124130,0.5433574086233312,0
7920,7921,HBR Layout,381500,36210,345290,0.9050851900393185,-1
7921,7922,Indiranagar,57150,28610,28540,0.49938757655293087,0
7922,7923,Kammanahalli,332350,46240,286110,0.8608695652173913,-1
7923,7924,Malleswaram,449200,38810,410390,0.9136019590382903,-1
7924,7925,Kammanahalli,282200,71330,210870,0.7472360028348689,0
7925,7926,Horamavu,49450,13340,36110,0.7302325581395349,0
7926,7927,Jalahalli,29700,90820,-61120,-2.0579124579124577,1
7927,7928,Whitefield,317650,63490,254160,0.8001259247599559,-1
7928,7929,Krishnarajapuram,50450,71840,-21390,-0.42398414271555995,1
7929,7930,Banaswadi,171000,84240,86760,0.5073684210526316,0
7930,7931,Malleswaram,185550,45620,139930,0.7541363513877661,0
7931,7932,Shivajinagar,329300,21910,307390,0.933464925599757,-1
7932,7933,Rajajinagar,63050,41760,21290,0.33766851704996037,1
7933,7934,Krishnarajapuram,358500,35310,323190,0.9015062761506276,-1
7934,7935,Shivajinagar,31300,64110,-32810,-1.0482428115015974,1
7935,7936,Hoodi,155800,26310,129490,0.8311296534017972,-1
7936,7937,Rajajinagar,276500,65680,210820,0.7624593128390597,0
7937,7938,Marathahalli,207150,46590,160560,0.7750905141202028,0
7938,7939,Varthur,60550,22080,38470,0.6353426919900909,0
7939,7940,Malleswaram,289400,69150,220250,0.7610573600552868,-1
7940,7941,Jalahalli,202650,63560,139090,0.6863557858376511,0
7941,7942,Horamavu,391850,0,391850,1.0,-1
7942,7943,Hoodi,55850,114440,-58590,-1.0490599820948971,1
7943,7944,HBR Layout,38650,49400,-10750,-0.278137128072445,1
7944,7945,CV Raman Nagar,431200,107820,323380,0.7499536178107606,-1
7945,7946,Indiranagar,250250,71860,178390,0.7128471528471528,0
7946,7947,Banaswadi,160850,69110,91740,0.5703450419645633,0
7947,7948,Kammanahalli,59300,93970,-34670,-0.5846543001686341,1
7948,7949,Malleswaram,162850,101470,61380,0.37691126803807184,1
7949,7950,Hebbal,44500,63870,-19370,-0.4352808988764045,1
7950,7951,Hebbal,288500,57320,231180,0.801317157712305,0
7951,7952,Horamavu,309250,68070,241180,0.7798868229587712,0
7952,7953,Varthur,171450,63030,108420,0.6323709536307961,0
7953,7954,Kalyan Nagar,439850,26970,412880,0.9386836421507332,-1
7954,7955,Krishnarajapuram,266000,45900,220100,0.8274436090225564,-1
7955,7956,Rajajinagar,233800,78910,154890,0.6624893071000856,0
7956,7957,Kammanahalli,151550,50080,101470,0.6695480039590894,0
7957,7958,Shivajinagar,112750,26050,86700,0.7689578713968958,0
7958,7959,Whitefield,253600,52430,201170,0.7932570977917981,0
7959,7960,Banaswadi,305050,80740,224310,0.7353220783478118,0
7960,7961,Indiranagar,144700,39800,104900,0.7249481686247409,-1
7961,7962,Indiranagar,178400,47470,130930,0.7339125560538117,0
7962,7963,CV Raman Nagar,72100,44630,27470,0.380998613037448,1
7963,7964,Horamavu,150200,40770,109430,0.7285619174434088,0
7964,7965,Krishnarajapuram,330300,48640,281660,0.8527399333938843,-1
7965,7966,Marathahalli,318600,47190,271410,0.8518832391713748,0
7966,7967,Kammanahalli,243650,17060,226590,0.9299815308844654,-1
7967,7968,Shivajinagar,96750,35300,61450,0.635142118863049,0
7968,7969,Indiranagar,407700,23320,384380,0.9428010792249203,-1
7969,7970,Banaswadi,56850,107190,-50340,-0.8854881266490765,1
7970,7971,Horamavu,136250,35090,101160,0.7424587155963303,-1
7971,7972,Horamavu,358050,71290,286760,0.800893729925988,-1
7972,7973,Hoodi,132200,76400,55800,0.42208774583963693,1
7973,7974,Kalyan Nagar,410200,36810,373390,0.9102632862018527,-1
7974,7975,HBR Layout,323250,23560,299690,0.9271152358855375,-1
7975,7976,Vasanth Nagar,388750,31870,356880,0.9180192926045017,-1
7976,7977,Marathahalli,346750,86590,260160,0.750281182408075,0
7977,7978,Whitefield,153850,63470,90380,0.5874553136171595,0
7978,7979,Hoodi,422250,84140,338110,0.8007341622261693,-1
7979,7980,Marathahalli,115100,82890,32210,0.2798436142484796,1
7980,7981,Shivajinagar,441900,35030,406870,0.9207286716451686,-1
7981,7982,Malleswaram,231650,85070,146580,0.6327649471184977,0
7982,7983,Varthur,352100,57240,294860,0.8374325475717126,-1
7983,7984,Varthur,407450,109440,298010,0.7314026260890907,0
7984,7985,Varthur,208250,82790,125460,0.6024489795918367,0
7985,7986,Vasanth Nagar,254450,34110,220340,0.8659461583808213,-1
7986,7987,Marathahalli,243650,52840,190810,0.7831315411450852,-1
7987,7988,Hebbal,99450,58730,40720,0.40945198592257415,1
7988,7989,Marathahalli,243050,7850,235200,0.967702118905575,-1
7989,7990,CV Raman Nagar,304350,21510,282840,0.9293247905372104,-1
7990,7991,Varthur,349050,53580,295470,0.8464976364417706,-1
7991,7992,Kalyan Nagar,249250,69310,179940,0.721925777331996,0
7992,7993,Malleswaram,330450,109710,220740,0.6679981842941444,0
7993,7994,HBR Layout,48900,89700,-40800,-0.8343558282208589,1
7994,7995,CV Raman Nagar,337400,43220,294180,0.8719027860106698,-1
7995,7996,Kammanahalli,105150,12960,92190,0.8767475035663338,-1
7996,7997,Jalahalli,175000,20980,154020,0.8801142857142857,-1
7997,7998,Kalyan Nagar,210400,56310,154090,0.7323669201520913,0
7998,7999,Jalahalli,122750,81310,41440,0.33759674134419554,1
7999,8000,Banaswadi,447500,60570,386930,0.8646480446927375,-1
8000,8001,Horamavu,128700,4170,124530,0.9675990675990676,-1
8001,8002,Banaswadi,213100,104100,109000,0.5114969497888315,1
8002,8003,Rajajinagar,289850,46560,243290,0.8393651888908056,-1
8003,8004,Mahadevapura,378750,122030,256720,0.6778085808580858,0
8004,8005,Shivajinagar,131900,33480,98420,0.7461713419257013,-1
8005,8006,Horamavu,299900,49560,250340,0.8347449149716573,0
8006,8007,Whitefield,322500,139750,182750,0.5666666666666667,0
8007,8008,Malleswaram,51900,42240,9660,0.1861271676300578,1
8008,8009,Indiranagar,430400,104290,326110,0.7576905204460966,-1
8009,8010,CV Raman Nagar,442050,113900,328150,0.7423368397240131,0
8010,8011,Horamavu,388750,72770,315980,0.8128102893890675,-1
8011,8012,Mahadevapura,390300,34730,355570,0.9110171662823469,-1
8012,8013,Whitefield,226050,39650,186400,0.8245963282459633,-1
8013,8014,Mahadevapura,39150,50360,-11210,-0.2863346104725415,1
8014,8015,Banaswadi,274150,91880,182270,0.6648550063833668,0
8015,8016,Hebbal,163300,37740,125560,0.7688916105327618,0
8016,8017,Malleswaram,390050,104170,285880,0.7329316754262274,0
8017,8018,HBR Layout,419150,106470,312680,0.7459859238935942,0
8018,8019,Shivajinagar,27100,41910,-14810,-0.5464944649446495,1
8019,8020,Vasanth Nagar,422400,27430,394970,0.935061553030303,-1
8020,8021,Varthur,348300,88890,259410,0.7447889750215332,0
8021,8022,Hoodi,352900,72760,280140,0.7938226126381411,0
8022,8023,Vasanth Nagar,400750,48150,352600,0.8798502807236431,0
8023,8024,Varthur,366950,38070,328880,0.8962528954898488,-1
8024,8025,HBR Layout,333800,101570,232230,0.6957159976033553,0
8025,8026,Hebbal,45600,35980,9620,0.21096491228070174,1
8026,8027,Hoodi,193050,80170,112880,0.5847189847189848,1
8027,8028,Jalahalli,83600,73680,9920,0.11866028708133972,1
8028,8029,HBR Layout,147800,73130,74670,0.5052097428958051,1
8029,8030,Kalyan Nagar,214300,106300,108000,0.5039664022398507,1
8030,8031,Rajajinagar,264800,61040,203760,0.7694864048338369,-1
8031,8032,Whitefield,447800,123060,324740,0.7251898168825368,-1
8032,8033,CV Raman Nagar,279100,89210,189890,0.6803654604084558,0
8033,8034,Malleswaram,112750,21430,91320,0.8099334811529934,-1
8034,8035,Horamavu,85900,39980,45920,0.5345750873108266,0
8035,8036,Kammanahalli,265650,64050,201600,0.758893280632411,0
8036,8037,Kalyan Nagar,113150,117290,-4140,-0.036588599204595666,1
8037,8038,Marathahalli,199550,57310,142240,0.7128038085692808,0
8038,8039,Kalyan Nagar,446700,73680,373020,0.8350570852921424,-1
8039,8040,Mahadevapura,250750,105390,145360,0.5797008973080757,1
8040,8041,Marathahalli,290450,32900,257550,0.8867274918230332,0
8041,8042,Hebbal,413500,34810,378690,0.9158162031438936,-1
8042,8043,Whitefield,76350,69560,6790,0.08893254747871644,1
8043,8044,CV Raman Nagar,76750,27260,49490,0.6448208469055374,0
8044,8045,Shivajinagar,447100,75070,372030,0.8320957280250503,-1
8045,8046,Varthur,315350,95190,220160,0.6981449183446964,0
8046,8047,HBR Layout,449600,58970,390630,0.8688389679715303,-1
8047,8048,Kalyan Nagar,224800,89230,135570,0.6030693950177936,0
8048,8049,Banaswadi,189000,27640,161360,0.8537566137566137,-1
8049,8050,Banaswadi,295300,39920,255380,0.8648154419234677,-1
8050,8051,Rajajinagar,37100,24510,12590,0.33935309973045824,1
8051,8052,Varthur,118100,121210,-3110,-0.026333615580016935,1
8052,8053,Banaswadi,26950,4250,22700,0.8423005565862709,-1
8053,8054,Shivajinagar,162000,70670,91330,0.5637654320987654,1
8054,8055,Vasanth Nagar,125750,14860,110890,0.8818290258449304,-1
8055,8056,Mahadevapura,332650,71800,260850,0.78415752292199,-1
8056,8057,Kammanahalli,307300,48970,258330,0.8406443215099252,-1
8057,8058,Mahadevapura,79400,124420,-45020,-0.5670025188916876,1
8058,8059,CV Raman Nagar,388250,41070,347180,0.8942176432710882,-1
8059,8060,Hoodi,114250,33200,81050,0.7094091903719912,0
8060,8061,Marathahalli,184600,55130,129470,0.7013542795232937,-1
8061,8062,Krishnarajapuram,287500,48790,238710,0.830295652173913,0
8062,8063,Krishnarajapuram,305300,3230,302070,0.9894202423845398,-1
8063,8064,Vasanth Nagar,56800,7220,49580,0.872887323943662,-1
8064,8065,Mahadevapura,93350,49350,44000,0.47134440278521694,0
8065,8066,Rajajinagar,434950,65380,369570,0.8496838717093919,-1
8066,8067,Indiranagar,171250,116880,54370,0.3174890510948905,1
8067,8068,CV Raman Nagar,40300,111240,-70940,-1.7602977667493795,1
8068,8069,Malleswaram,112650,60180,52470,0.4657789613848202,1
8069,8070,Whitefield,260750,74960,185790,0.7125215723873441,0
8070,8071,Rajajinagar,38050,39090,-1040,-0.02733245729303548,1
8071,8072,CV Raman Nagar,172500,107300,65200,0.3779710144927536,1
8072,8073,Vasanth Nagar,76650,144250,-67600,-0.8819308545335942,1
8073,8074,Marathahalli,345300,55840,289460,0.8382855487981465,0
8074,8075,Krishnarajapuram,291850,22560,269290,0.9227000171320884,-1
8075,8076,Banaswadi,323550,73150,250400,0.7739143872662648,-1
8076,8077,Hoodi,286800,111290,175510,0.6119595536959553,0
8077,8078,Jalahalli,205700,40450,165250,0.8033543996110841,0
8078,8079,Kalyan Nagar,36450,55300,-18850,-0.5171467764060357,1
8079,8080,CV Raman Nagar,415500,84110,331390,0.7975691937424789,0
8080,8081,Varthur,174150,44570,129580,0.7440712029859317,0
8081,8082,Varthur,73300,66150,7150,0.09754433833560709,1
8082,8083,HBR Layout,106850,57430,49420,0.4625175479644361,0
8083,8084,Malleswaram,244850,46650,198200,0.8094751888911579,0
8084,8085,Banaswadi,108900,47820,61080,0.5608815426997246,0
8085,8086,Vasanth Nagar,125150,31570,93580,0.7477427087495006,0
8086,8087,HBR Layout,141300,38210,103090,0.729582448690729,0
8087,8088,Whitefield,59500,71960,-12460,-0.20941176470588235,1
8088,8089,Varthur,82700,73970,8730,0.10556227327690447,1
8089,8090,Vasanth Nagar,114050,38150,75900,0.6654975887768523,0
8090,8091,Marathahalli,94950,17470,77480,0.8160084254870985,-1
8091,8092,HBR Layout,146050,57700,88350,0.6049298185552893,0
8092,8093,Indiranagar,61250,48350,12900,0.21061224489795918,1
8093,8094,Whitefield,333950,103130,230820,0.6911813145680491,0
8094,8095,CV Raman Nagar,344450,52720,291730,0.8469444041225141,-1
8095,8096,Whitefield,278200,74110,204090,0.733608914450036,-1
8096,8097,Hebbal,404900,84300,320600,0.791800444554211,-1
8097,8098,Indiranagar,354800,57960,296840,0.8366403607666291,-1
8098,8099,Jalahalli,81450,63220,18230,0.2238182934315531,1
8099,8100,Kammanahalli,358800,62980,295820,0.8244704570791528,-1
8100,8101,CV Raman Nagar,315050,67410,247640,0.7860339628630376,0
8101,8102,Banaswadi,130750,34800,95950,0.7338432122370937,-1
8102,8103,Jalahalli,265500,55330,210170,0.7916007532956686,0
8103,8104,Malleswaram,193950,138450,55500,0.2861562258313998,1
8104,8105,Jalahalli,214300,55150,159150,0.7426504899673355,0
8105,8106,Whitefield,39350,102800,-63450,-1.6124523506988564,1
8106,8107,Rajajinagar,84950,70670,14280,0.16809888169511478,1
8107,8108,Shivajinagar,165250,42570,122680,0.7423903177004538,-1
8108,8109,Malleswaram,280550,44120,236430,0.8427374799500981,-1
8109,8110,CV Raman Nagar,124000,77260,46740,0.37693548387096776,1
8110,8111,Mahadevapura,169400,59470,109930,0.6489374262101535,0
8111,8112,Kalyan Nagar,443950,134730,309220,0.6965198783646807,0
8112,8113,Marathahalli,108950,52130,56820,0.5215236346948141,0
8113,8114,Horamavu,133900,114530,19370,0.14466019417475728,1
8114,8115,Mahadevapura,175400,53570,121830,0.6945838084378563,0
8115,8116,Rajajinagar,425800,178750,247050,0.580201972757163,0
8116,8117,Hoodi,316400,58780,257620,0.8142225031605562,-1
8117,8118,Varthur,397550,144420,253130,0.6367249402590869,0
8118,8119,Varthur,119550,27180,92370,0.7726474278544542,-1
8119,8120,Horamavu,266650,99120,167530,0.6282767672979561,0
8120,8121,Jalahalli,404550,51650,352900,0.8723272772216043,-1
8121,8122,Indiranagar,198400,22010,176390,0.8890625,-1
8122,8123,Whitefield,185450,76610,108840,0.5868967376651388,0
8123,8124,Vasanth Nagar,61950,20350,41600,0.6715092816787732,0
8124,8125,Malleswaram,144900,39730,105170,0.7258109040717736,0
8125,8126,Horamavu,56200,27480,28720,0.5110320284697509,0
8126,8127,Hoodi,88950,85930,3020,0.03395165823496346,1
8127,8128,Marathahalli,159700,40990,118710,0.743331246086412,-1
8128,8129,HBR Layout,339650,38930,300720,0.8853820108935669,-1
8129,8130,Shivajinagar,274700,97100,177600,0.6465234801601747,0
8130,8131,Jalahalli,251150,65600,185550,0.738801513040016,0
8131,8132,Mahadevapura,320950,26130,294820,0.9185854494469543,-1
8132,8133,Shivajinagar,334450,53000,281450,0.8415308715802063,-1
8133,8134,Jalahalli,314050,67460,246590,0.7851934405349467,-1
8134,8135,Indiranagar,428400,78050,350350,0.8178104575163399,0
8135,8136,Banaswadi,366350,49500,316850,0.8648833083117238,0
8136,8137,Vasanth Nagar,403900,143610,260290,0.6444416934884872,0
8137,8138,Kammanahalli,343250,34990,308260,0.8980626365622724,0
8138,8139,Shivajinagar,40600,66480,-25880,-0.6374384236453202,1
8139,8140,Rajajinagar,93150,34440,58710,0.6302737520128825,0
8140,8141,Krishnarajapuram,218700,58020,160680,0.7347050754458162,0
8141,8142,CV Raman Nagar,41600,83030,-41430,-0.9959134615384615,1
8142,8143,Hebbal,345050,31360,313690,0.9091146210694102,-1
8143,8144,Marathahalli,94750,71120,23630,0.24939313984168865,1
8144,8145,Hebbal,212000,36510,175490,0.8277830188679245,0
8145,8146,Rajajinagar,311950,61240,250710,0.8036864882192659,-1
8146,8147,Jalahalli,380350,135510,244840,0.6437228868147759,0
8147,8148,Kammanahalli,360150,118020,242130,0.6723032069970846,0
8148,8149,Malleswaram,256750,88990,167760,0.653398247322298,0
8149,8150,Jalahalli,446700,71000,375700,0.8410566375643609,-1
8150,8151,Varthur,404650,135820,268830,0.66435190905721,0
8151,8152,Varthur,232900,65470,167430,0.7188922284242164,-1
8152,8153,Jalahalli,32200,133180,-100980,-3.136024844720497,1
8153,8154,Mahadevapura,49850,69540,-19690,-0.3949849548645938,1
8154,8155,Horamavu,273950,131250,142700,0.5208979740828619,0
8155,8156,Banaswadi,301800,70860,230940,0.7652087475149105,-1
8156,8157,Jalahalli,233650,118160,115490,0.4942863257008346,1
8157,8158,CV Raman Nagar,346750,61420,285330,0.8228695025234318,0
8158,8159,Jalahalli,360350,71900,288450,0.8004717635632025,-1
8159,8160,Jalahalli,139450,46210,93240,0.6686267479383291,0
8160,8161,Rajajinagar,356450,89280,267170,0.7495300883714406,0
8161,8162,Varthur,289900,90630,199270,0.6873749568816834,0
8162,8163,HBR Layout,234800,89770,145030,0.6176746166950596,0
8163,8164,Marathahalli,84100,119060,-34960,-0.41569560047562426,1
8164,8165,Shivajinagar,420200,49020,371180,0.8833412660637792,0
8165,8166,Horamavu,411900,55910,355990,0.8642631706724934,0
8166,8167,CV Raman Nagar,74950,178480,-103530,-1.381320880587058,1
8167,8168,Varthur,280250,87720,192530,0.6869937555753791,0
8168,8169,Kalyan Nagar,256550,146020,110530,0.43083219645293314,1
8169,8170,Hebbal,261700,35870,225830,0.8629346580053496,0
8170,8171,Kammanahalli,98850,34530,64320,0.6506828528072838,0
8171,8172,Hebbal,223150,24720,198430,0.8892224960788707,-1
8172,8173,CV Raman Nagar,220500,83790,136710,0.62,0
8173,8174,Shivajinagar,120800,14080,106720,0.8834437086092716,-1
8174,8175,Rajajinagar,41050,38140,2910,0.07088915956151036,1
8175,8176,Vasanth Nagar,115750,14540,101210,0.8743844492440604,-1
8176,8177,Kalyan Nagar,37750,70530,-32780,-0.8683443708609272,1
8177,8178,Marathahalli,293700,104530,189170,0.6440926115083419,0
8178,8179,Mahadevapura,300550,14070,286480,0.9531858259856929,-1
8179,8180,Indiranagar,269850,53530,216320,0.8016305354826756,-1
8180,8181,Rajajinagar,31300,48060,-16760,-0.5354632587859425,1
8181,8182,Shivajinagar,177350,87370,89980,0.5073583309839301,1
8182,8183,Hoodi,251850,98230,153620,0.6099662497518364,0
8183,8184,Whitefield,81050,58710,22340,0.2756323257248612,1
8184,8185,Hoodi,85750,77980,7770,0.09061224489795919,1
8185,8186,Marathahalli,358550,11330,347220,0.9684005020220332,-1
8186,8187,Vasanth Nagar,98700,15220,83480,0.8457953394123607,0
8187,8188,Krishnarajapuram,429450,116420,313030,0.7289090697403656,0
8188,8189,Hoodi,237550,52900,184650,0.7773100399915808,0
8189,8190,Whitefield,101700,51530,50170,0.4933136676499508,1
8190,8191,CV Raman Nagar,69050,64400,4650,0.06734250543084722,1
8191,8192,Banaswadi,414750,62700,352050,0.8488245931283906,-1
8192,8193,Kammanahalli,269250,41660,227590,0.8452739090064996,-1
8193,8194,Marathahalli,245700,89540,156160,0.6355718355718356,0
8194,8195,Kalyan Nagar,239950,80050,159900,0.6663888310064596,0
8195,8196,Krishnarajapuram,55350,49250,6100,0.1102077687443541,1
8196,8197,Banaswadi,266550,26170,240380,0.9018195460513975,-1
8197,8198,Whitefield,206700,17350,189350,0.9160619254958877,-1
8198,8199,Marathahalli,46050,126060,-80010,-1.7374592833876221,1
8199,8200,HBR Layout,114500,109120,5380,0.04698689956331878,1
8200,8201,Hoodi,198650,112520,86130,0.4335766423357664,1
8201,8202,Kalyan Nagar,137500,68580,68920,0.5012363636363636,0
8202,8203,Hebbal,52850,112130,-59280,-1.1216650898770104,1
8203,8204,Hoodi,57250,54500,2750,0.048034934497816595,1
8204,8205,Whitefield,273500,55600,217900,0.796709323583181,0
8205,8206,Rajajinagar,409950,17190,392760,0.9580680570801318,-1
8206,8207,Jalahalli,182250,53960,128290,0.7039231824417009,-1
8207,8208,Vasanth Nagar,181400,163800,17600,0.0970231532524807,1
8208,8209,Jalahalli,397050,79370,317680,0.8001007429794736,-1
8209,8210,Kammanahalli,63950,31340,32610,0.5099296325254105,0
8210,8211,Marathahalli,243800,76250,167550,0.6872436423297785,0
8211,8212,Krishnarajapuram,122350,38270,84080,0.6872088271352677,0
8212,8213,Rajajinagar,378750,50750,328000,0.866006600660066,-1
8213,8214,Kammanahalli,158250,69230,89020,0.5625276461295419,0
8214,8215,Kammanahalli,230850,52070,178780,0.7744422785358458,-1
8215,8216,Shivajinagar,437000,87400,349600,0.8,-1
8216,8217,Rajajinagar,281100,36250,244850,0.8710423336890786,-1
8217,8218,Vasanth Nagar,148500,0,148500,1.0,-1
8218,8219,Mahadevapura,327900,55740,272160,0.8300091491308326,-1
8219,8220,Jalahalli,416300,59760,356540,0.8564496757146288,-1
8220,8221,Marathahalli,392050,116060,275990,0.7039663308251498,0
8221,8222,Malleswaram,219550,40280,179270,0.8165338191755864,-1
8222,8223,Marathahalli,62600,95090,-32490,-0.5190095846645367,1
8223,8224,Horamavu,116650,79220,37430,0.32087441063009003,1
8224,8225,Kalyan Nagar,107600,127480,-19880,-0.18475836431226766,1
8225,8226,CV Raman Nagar,40850,56450,-15600,-0.3818849449204406,1
8226,8227,Hebbal,331050,42070,288980,0.8729194985651714,-1
8227,8228,Whitefield,112750,110360,2390,0.021197339246119735,1
8228,8229,Horamavu,384250,77910,306340,0.7972413793103448,0
8229,8230,Mahadevapura,76300,57690,18610,0.24390563564875492,1
8230,8231,Krishnarajapuram,367300,80550,286750,0.7806969779471822,0
8231,8232,Hebbal,163400,53670,109730,0.6715422276621787,0
8232,8233,Marathahalli,422850,47970,374880,0.8865555161404753,-1
8233,8234,Varthur,210000,71360,138640,0.6601904761904762,0
8234,8235,Hoodi,156850,35370,121480,0.7744979279566465,0
8235,8236,Hebbal,375200,99110,276090,0.7358475479744137,0
8236,8237,Indiranagar,343750,60830,282920,0.82304,-1
8237,8238,Hoodi,260050,102950,157100,0.6041145933474332,0
8238,8239,Hebbal,194550,61520,133030,0.6837830891801593,0
8239,8240,Hoodi,124400,66740,57660,0.4635048231511254,1
8240,8241,Banaswadi,381950,34130,347820,0.9106427542872104,-1
8241,8242,Varthur,96300,133030,-36730,-0.3814122533748702,1
8242,8243,Hebbal,319650,65470,254180,0.7951822305646801,-1
8243,8244,Varthur,385950,68780,317170,0.8217903873558751,-1
8244,8245,Shivajinagar,368350,23580,344770,0.935984797068006,-1
8245,8246,Jalahalli,364100,26240,337860,0.9279318868442735,-1
8246,8247,Jalahalli,39450,78360,-38910,-0.9863117870722433,1
8247,8248,Whitefield,60350,74040,-13690,-0.22684341342170672,1
8248,8249,Banaswadi,274050,85240,188810,0.6889618682722131,0
8249,8250,Horamavu,370550,80450,290100,0.7828902982053704,-1
8250,8251,Hoodi,159250,61380,97870,0.6145682888540032,0
8251,8252,Kalyan Nagar,244750,44500,200250,0.8181818181818182,0
8252,8253,Kalyan Nagar,362700,85950,276750,0.7630272952853598,0
8253,8254,Malleswaram,197750,36960,160790,0.8130973451327433,-1
8254,8255,Hoodi,58750,76310,-17560,-0.2988936170212766,1
8255,8256,Hebbal,357400,130850,226550,0.6338836038052602,0
8256,8257,Horamavu,354800,21430,333370,0.9395997745208569,-1
8257,8258,Marathahalli,380900,32230,348670,0.9153846153846154,-1
8258,8259,Hoodi,35350,55960,-20610,-0.583026874115983,1
8259,8260,Whitefield,86600,57260,29340,0.33879907621247113,1
8260,8261,Mahadevapura,436900,74180,362720,0.830212863355459,-1
8261,8262,Rajajinagar,352850,110320,242530,0.6873458976902367,0
8262,8263,Jalahalli,64600,74550,-9950,-0.1540247678018576,1
8263,8264,Mahadevapura,117850,39540,78310,0.6644887568943573,0
8264,8265,Shivajinagar,272900,15030,257870,0.9449248809087578,-1
8265,8266,Hoodi,348200,74790,273410,0.7852096496266513,0
8266,8267,Banaswadi,195800,74350,121450,0.6202757916241062,0
8267,8268,Vasanth Nagar,423600,61570,362030,0.8546506137865911,-1
8268,8269,Banaswadi,379900,52100,327800,0.8628586470123717,0
8269,8270,HBR Layout,26250,27150,-900,-0.03428571428571429,1
8270,8271,Shivajinagar,207000,46140,160860,0.7771014492753623,0
8271,8272,Shivajinagar,135000,69330,65670,0.48644444444444446,0
8272,8273,Kalyan Nagar,303150,68030,235120,0.7755896420913739,0
8273,8274,Horamavu,93100,54350,38750,0.416219119226638,1
8274,8275,Indiranagar,448650,37390,411260,0.916661094394294,-1
8275,8276,Mahadevapura,296100,106490,189610,0.6403579871664978,0
8276,8277,Banaswadi,313650,109450,204200,0.6510441575003986,0
8277,8278,HBR Layout,269750,147060,122690,0.45482854494902686,0
8278,8279,Malleswaram,377750,65070,312680,0.8277432164129715,0
8279,8280,Horamavu,310600,46990,263610,0.8487121699935608,-1
8280,8281,Shivajinagar,235400,50300,185100,0.786321155480034,0
8281,8282,Mahadevapura,179600,37050,142550,0.7937082405345212,0
8282,8283,Horamavu,192550,79630,112920,0.5864450792002077,0
8283,8284,Kammanahalli,332000,34590,297410,0.8958132530120482,-1
8284,8285,Indiranagar,233700,70670,163030,0.6976037655113393,0
8285,8286,Indiranagar,318700,44910,273790,0.8590837778475054,-1
8286,8287,Mahadevapura,345700,41690,304010,0.8794041076077523,-1
8287,8288,Hebbal,64400,64070,330,0.005124223602484472,1
8288,8289,Mahadevapura,360750,46420,314330,0.8713236313236313,-1
8289,8290,Horamavu,252550,106330,146220,0.5789744605028707,0
8290,8291,Shivajinagar,49250,30130,19120,0.3882233502538071,1
8291,8292,Rajajinagar,321150,36870,284280,0.8851938346567024,0
8292,8293,Vasanth Nagar,319500,56220,263280,0.824037558685446,0
8293,8294,Rajajinagar,445800,85120,360680,0.8090623598026021,0
8294,8295,Horamavu,200950,90120,110830,0.551530231400846,1
8295,8296,Jalahalli,129300,51170,78130,0.6042536736272235,0
8296,8297,Hoodi,110200,53500,56700,0.514519056261343,0
8297,8298,Marathahalli,163400,62650,100750,0.6165850673194615,0
8298,8299,CV Raman Nagar,180750,54940,125810,0.6960442600276625,0
8299,8300,Whitefield,369600,2940,366660,0.9920454545454546,-1
8300,8301,Malleswaram,175650,20670,154980,0.8823228010247651,-1
8301,8302,Banaswadi,34100,65100,-31000,-0.9090909090909091,1
8302,8303,Marathahalli,365800,96660,269140,0.7357572443958448,-1
8303,8304,HBR Layout,279100,52260,226840,0.8127552848441418,-1
8304,8305,Kalyan Nagar,134350,76820,57530,0.42820989951618904,0
8305,8306,Hebbal,75550,23120,52430,0.6939774983454666,0
8306,8307,Banaswadi,120900,86510,34390,0.28444995864350703,1
8307,8308,HBR Layout,111150,76230,34920,0.31417004048582997,1
8308,8309,CV Raman Nagar,182500,10590,171910,0.941972602739726,-1
8309,8310,Jalahalli,331750,50430,281320,0.8479879427279577,0
8310,8311,Varthur,110400,3940,106460,0.9643115942028986,-1
8311,8312,Hoodi,378850,101530,277320,0.7320047512207998,0
8312,8313,Banaswadi,338350,17950,320400,0.9469484261859021,-1
8313,8314,Hebbal,153250,26610,126640,0.8263621533442088,-1
8314,8315,Hoodi,170700,84290,86410,0.5062097246631517,1
8315,8316,Vasanth Nagar,117750,43480,74270,0.6307430997876857,0
8316,8317,Krishnarajapuram,72050,71590,460,0.006384455239417071,1
8317,8318,Jalahalli,301750,59090,242660,0.804175642087821,-1
8318,8319,Marathahalli,260250,146100,114150,0.4386167146974063,0
8319,8320,Kalyan Nagar,285100,70460,214640,0.7528586460890916,0
8320,8321,Whitefield,275450,66310,209140,0.7592666545652569,0
8321,8322,CV Raman Nagar,158450,45860,112590,0.7105711580940359,0
8322,8323,Hoodi,173950,89170,84780,0.48738143144581775,1
8323,8324,Banaswadi,335050,89760,245290,0.7320996866139382,0
8324,8325,Rajajinagar,330200,55020,275180,0.8333737129012719,-1
8325,8326,CV Raman Nagar,414450,36360,378090,0.9122692725298589,-1
8326,8327,Banaswadi,246000,25750,220250,0.8953252032520326,-1
8327,8328,Mahadevapura,93350,39650,53700,0.5752544188537762,0
8328,8329,Horamavu,54600,30300,24300,0.44505494505494503,1
8329,8330,Kalyan Nagar,403500,46280,357220,0.8853035935563817,-1
8330,8331,Whitefield,285450,77260,208190,0.7293396391662288,0
8331,8332,Marathahalli,131750,78860,52890,0.40144212523719164,1
8332,8333,CV Raman Nagar,324050,53170,270880,0.8359203826569974,-1
8333,8334,Krishnarajapuram,88450,75490,12960,0.14652345958168456,1
8334,8335,Jalahalli,434100,90930,343170,0.7905321354526607,-1
8335,8336,Kammanahalli,68700,28350,40350,0.5873362445414847,0
8336,8337,Whitefield,164900,73370,91530,0.5550636749545179,1
8337,8338,Hebbal,341150,126880,214270,0.6280814890810494,0
8338,8339,Kammanahalli,363050,102410,260640,0.7179176421980443,-1
8339,8340,Indiranagar,328850,48620,280230,0.8521514368253003,-1
8340,8341,Malleswaram,191300,68080,123220,0.6441191845269211,0
8341,8342,Kalyan Nagar,311100,69820,241280,0.775570556091289,0
8342,8343,Hoodi,89300,84110,5190,0.058118701007838745,1
8343,8344,Banaswadi,26200,12100,14100,0.5381679389312977,0
8344,8345,Mahadevapura,424550,72060,352490,0.8302673418914145,0
8345,8346,Rajajinagar,261400,47060,214340,0.8199693955623566,0
8346,8347,CV Raman Nagar,228750,74550,154200,0.6740983606557377,0
8347,8348,Kalyan Nagar,72400,12540,59860,0.8267955801104973,-1
8348,8349,HBR Layout,303100,129670,173430,0.5721873968987133,1
8349,8350,Indiranagar,329050,67440,261610,0.7950463455401915,0
8350,8351,Whitefield,219000,35460,183540,0.8380821917808219,0
8351,8352,Horamavu,224750,33740,191010,0.8498776418242492,0
8352,8353,Krishnarajapuram,213700,61360,152340,0.7128685072531586,-1
8353,8354,Shivajinagar,173250,60140,113110,0.6528715728715728,0
8354,8355,Rajajinagar,42750,49020,-6270,-0.14666666666666667,1
8355,8356,Hoodi,51100,66940,-15840,-0.30998043052837576,1
8356,8357,Krishnarajapuram,398950,86670,312280,0.7827547311693195,0
8357,8358,Kammanahalli,59500,67430,-7930,-0.13327731092436976,1
8358,8359,Vasanth Nagar,358750,80620,278130,0.7752752613240418,0
8359,8360,Hoodi,339550,61440,278110,0.819054631129436,-1
8360,8361,Kalyan Nagar,318900,85940,232960,0.730511132016306,0
8361,8362,Whitefield,53250,85860,-32610,-0.6123943661971831,1
8362,8363,Kalyan Nagar,252700,20260,232440,0.9198258804907005,-1
8363,8364,Kalyan Nagar,274200,79410,194790,0.7103938730853392,0
8364,8365,Kammanahalli,84350,20580,63770,0.7560165975103734,-1
8365,8366,Rajajinagar,333950,71160,262790,0.7869142087138793,0
8366,8367,Shivajinagar,353700,34580,319120,0.9022335312411648,-1
8367,8368,Indiranagar,384500,74550,309950,0.806111833550065,-1
8368,8369,Malleswaram,143500,64130,79370,0.5531010452961672,0
8369,8370,Hoodi,211100,83410,127690,0.6048792041686405,0
8370,8371,Hebbal,249200,76980,172220,0.6910914927768861,0
8371,8372,Whitefield,334900,45300,289600,0.8647357420125411,0
8372,8373,Indiranagar,256900,52750,204150,0.7946671856753601,0
8373,8374,Rajajinagar,204950,78570,126380,0.6166382044401073,0
8374,8375,Kammanahalli,374500,29630,344870,0.9208811748998665,-1
8375,8376,Rajajinagar,127150,31500,95650,0.7522611089264648,0
8376,8377,Hebbal,197000,33710,163290,0.8288832487309644,0
8377,8378,Horamavu,110750,173740,-62990,-0.5687584650112867,1
8378,8379,Hoodi,194300,106730,87570,0.4506948018528049,0
8379,8380,Varthur,276650,78850,197800,0.7149828302909814,-1
8380,8381,Hoodi,351850,26340,325510,0.9251385533608072,-1
8381,8382,HBR Layout,168850,69450,99400,0.58868818477939,0
8382,8383,Whitefield,336400,66650,269750,0.8018727705112961,-1
8383,8384,Kammanahalli,269450,75890,193560,0.7183521989237335,0
8384,8385,Jalahalli,99750,28840,70910,0.7108771929824561,0
8385,8386,Jalahalli,300150,64610,235540,0.7847409628519074,0
8386,8387,Krishnarajapuram,68600,83390,-14790,-0.21559766763848395,1
8387,8388,Malleswaram,184200,9450,174750,0.9486970684039088,-1
8388,8389,Varthur,245950,65620,180330,0.733197804431795,0
8389,8390,Mahadevapura,321900,90870,231030,0.7177073625349487,0
8390,8391,Marathahalli,279850,74410,205440,0.7341075576201537,0
8391,8392,Whitefield,216100,89760,126340,0.5846367422489588,1
8392,8393,Mahadevapura,100050,82910,17140,0.1713143428285857,1
8393,8394,Kammanahalli,377300,28220,349080,0.9252054068380599,-1
8394,8395,Kammanahalli,186950,15270,171680,0.918320406525809,-1
8395,8396,Marathahalli,440200,56610,383590,0.8713993639254884,-1
8396,8397,Shivajinagar,263250,147720,115530,0.43886039886039885,1
8397,8398,Hoodi,258700,38450,220250,0.8513722458446077,0
8398,8399,Mahadevapura,50350,19800,30550,0.6067527308838133,0
8399,8400,Varthur,221900,109330,112570,0.5073005858494818,0
8400,8401,Malleswaram,159350,61660,97690,0.6130530279259492,0
8401,8402,Mahadevapura,358750,96550,262200,0.7308710801393729,0
8402,8403,Marathahalli,378750,55170,323580,0.8543366336633663,-1
8403,8404,Shivajinagar,331800,27240,304560,0.9179023508137433,-1
8404,8405,HBR Layout,340650,73100,267550,0.7854102451196242,0
8405,8406,Hebbal,151750,54160,97590,0.6430971993410214,0
8406,8407,Kammanahalli,162550,50910,111640,0.6868040602891418,0
8407,8408,Whitefield,444600,75000,369600,0.8313090418353576,-1
8408,8409,Horamavu,225400,132890,92510,0.41042590949423247,1
8409,8410,Banaswadi,111400,17150,94250,0.8460502692998204,-1
8410,8411,Kalyan Nagar,247800,48750,199050,0.8032687651331719,0
8411,8412,Varthur,338000,34480,303520,0.8979881656804733,-1
8412,8413,Rajajinagar,338250,75370,262880,0.7771766444937177,0
8413,8414,Indiranagar,157900,57640,100260,0.6349588347055098,0
8414,8415,HBR Layout,64300,90430,-26130,-0.4063763608087092,1
8415,8416,Jalahalli,84200,74690,9510,0.11294536817102138,1
8416,8417,Marathahalli,445200,74870,370330,0.8318283917340521,-1
8417,8418,Hoodi,426700,30160,396540,0.929318022029529,-1
8418,8419,Horamavu,69750,88830,-19080,-0.2735483870967742,1
8419,8420,Mahadevapura,311050,71970,239080,0.7686224079729947,0
8420,8421,Kalyan Nagar,301450,78420,223030,0.7398573561121248,0
8421,8422,Whitefield,240600,60150,180450,0.75,0
8422,8423,Rajajinagar,38300,75030,-36730,-0.9590078328981724,1
8423,8424,Mahadevapura,119150,26360,92790,0.7787662610155266,0
8424,8425,Kammanahalli,337600,80810,256790,0.7606338862559242,0
8425,8426,Indiranagar,340900,42590,298310,0.8750660017600469,-1
8426,8427,Shivajinagar,104350,39240,65110,0.6239578342117873,0
8427,8428,Kammanahalli,75050,82020,-6970,-0.09287141905396402,1
8428,8429,CV Raman Nagar,437050,55290,381760,0.8734927353849674,-1
8429,8430,Krishnarajapuram,375350,137740,237610,0.6330358332223258,0
8430,8431,Mahadevapura,37100,94850,-57750,-1.5566037735849056,1
8431,8432,Hoodi,213300,76840,136460,0.6397562119081106,0
8432,8433,Malleswaram,116600,35520,81080,0.695368782161235,0
8433,8434,Mahadevapura,334500,48890,285610,0.8538415545590433,-1
8434,8435,Krishnarajapuram,204950,52610,152340,0.7433032446938278,0
8435,8436,Kammanahalli,185300,81330,103970,0.5610901241230437,1
8436,8437,Indiranagar,245800,29320,216480,0.8807160292921073,-1
8437,8438,Horamavu,224800,26490,198310,0.8821619217081851,-1
8438,8439,Shivajinagar,258250,68270,189980,0.7356437560503388,-1
8439,8440,Marathahalli,447150,70120,377030,0.8431846136643185,0
8440,8441,CV Raman Nagar,204800,74050,130750,0.638427734375,0
8441,8442,Mahadevapura,270100,68000,202100,0.7482413920770085,0
8442,8443,Banaswadi,341300,54330,286970,0.840814532669206,-1
8443,8444,Shivajinagar,364150,65150,299000,0.8210902100782644,-1
8444,8445,Shivajinagar,424150,20770,403380,0.9510314747141342,-1
8445,8446,Hoodi,87200,28380,58820,0.6745412844036697,0
8446,8447,Banaswadi,332000,97930,234070,0.7050301204819277,-1
8447,8448,Vasanth Nagar,207650,83060,124590,0.6,0
8448,8449,Indiranagar,65900,73150,-7250,-0.11001517450682853,1
8449,8450,Hebbal,391700,30330,361370,0.9225682920602502,-1
8450,8451,Krishnarajapuram,150100,82750,67350,0.44870086608927384,0
8451,8452,Kalyan Nagar,86350,37940,48410,0.5606253618992473,0
8452,8453,Indiranagar,77800,12080,65720,0.8447300771208226,-1
8453,8454,Vasanth Nagar,92800,55760,37040,0.39913793103448275,1
8454,8455,Banaswadi,391750,18370,373380,0.953107849393746,-1
8455,8456,Vasanth Nagar,211250,65880,145370,0.6881420118343196,0
8456,8457,Shivajinagar,220050,46250,173800,0.7898204953419677,0
8457,8458,Hoodi,306500,53090,253410,0.8267862969004894,-1
8458,8459,Hebbal,225450,93550,131900,0.5850521179862497,0
8459,8460,Kammanahalli,342100,29850,312250,0.9127448114586378,-1
8460,8461,Horamavu,343450,44230,299220,0.8712185179793274,0
8461,8462,Horamavu,236400,20420,215980,0.9136209813874788,-1
8462,8463,Jalahalli,209950,98310,111640,0.5317456537270778,0
8463,8464,Kalyan Nagar,384400,84380,300020,0.7804890738813736,0
8464,8465,Rajajinagar,68400,56840,11560,0.16900584795321638,1
8465,8466,Whitefield,334200,97160,237040,0.7092758827049671,0
8466,8467,Vasanth Nagar,233100,81560,151540,0.6501072501072501,0
8467,8468,Banaswadi,168350,1370,166980,0.9918621918621918,-1
8468,8469,HBR Layout,115550,0,115550,1.0,-1
8469,8470,Rajajinagar,426800,142170,284630,0.6668931583880038,0
8470,8471,Marathahalli,180450,97550,82900,0.4594070379606539,0
8471,8472,Mahadevapura,310450,40040,270410,0.8710259301014656,-1
8472,8473,Vasanth Nagar,182450,89170,93280,0.5112633598246095,1
8473,8474,HBR Layout,367150,108990,258160,0.7031458531935176,0
8474,8475,Jalahalli,255500,104850,150650,0.589628180039139,0
8475,8476,Malleswaram,190800,35950,154850,0.8115828092243187,-1
8476,8477,Indiranagar,349050,88790,260260,0.7456238361266294,0
8477,8478,Banaswadi,422850,94470,328380,0.7765874423554452,-1
8478,8479,Banaswadi,206650,47010,159640,0.7725139124122913,-1
8479,8480,Hoodi,387300,39880,347420,0.8970307255357604,0
8480,8481,Shivajinagar,62300,60360,1940,0.03113964686998395,1
8481,8482,Kammanahalli,184850,29000,155850,0.8431160400324588,0
8482,8483,Jalahalli,230850,32680,198170,0.8584362139917695,-1
8483,8484,Kalyan Nagar,84800,19410,65390,0.7711084905660377,-1
8484,8485,Vasanth Nagar,39600,32370,7230,0.18257575757575759,1
8485,8486,Malleswaram,439450,68520,370930,0.8440778245534191,-1
8486,8487,Jalahalli,85150,46610,38540,0.4526130358191427,1
8487,8488,Whitefield,350650,83530,267120,0.7617852559532298,0
8488,8489,Vasanth Nagar,222000,92730,129270,0.5822972972972973,1
8489,8490,Kammanahalli,443750,33810,409940,0.9238084507042253,-1
8490,8491,HBR Layout,57100,44820,12280,0.21506129597197898,1
8491,8492,Kalyan Nagar,378500,54440,324060,0.8561690885072655,-1
8492,8493,Kalyan Nagar,165250,117970,47280,0.2861119515885023,1
8493,8494,HBR Layout,201450,61490,139960,0.6947629684785307,0
8494,8495,Varthur,205800,81530,124270,0.6038386783284743,0
8495,8496,Vasanth Nagar,424350,76150,348200,0.820549075055968,0
8496,8497,Banaswadi,351450,107070,244380,0.6953478446436193,0
8497,8498,Banaswadi,187800,5910,181890,0.9685303514376997,-1
8498,8499,Banaswadi,31550,51650,-20100,-0.6370839936608558,1
8499,8500,Indiranagar,76100,60450,15650,0.20565045992115638,1
8500,8501,Malleswaram,127200,72330,54870,0.43136792452830186,1
8501,8502,Banaswadi,407450,18590,388860,0.9543747699104185,-1
8502,8503,Banaswadi,414150,28690,385460,0.9307255825184112,-1
8503,8504,Banaswadi,82700,60770,21930,0.26517533252720676,1
8504,8505,Hebbal,135550,68820,66730,0.49229066765031354,0
8505,8506,Malleswaram,55550,87420,-31870,-0.5737173717371737,1
8506,8507,Vasanth Nagar,89550,41990,47560,0.5310999441652708,1
8507,8508,Whitefield,276100,54830,221270,0.8014125316914161,-1
8508,8509,Krishnarajapuram,425850,89660,336190,0.7894563813549372,0
8509,8510,Kalyan Nagar,51200,55650,-4450,-0.0869140625,1
8510,8511,Jalahalli,142250,37950,104300,0.7332161687170474,0
8511,8512,CV Raman Nagar,371350,43170,328180,0.8837484852564965,0
8512,8513,Banaswadi,286800,32500,254300,0.8866806136680614,-1
8513,8514,Vasanth Nagar,399950,185830,214120,0.5353669208651082,0
8514,8515,Indiranagar,204600,20740,183860,0.8986314760508309,0
8515,8516,Marathahalli,36550,44400,-7850,-0.21477428180574556,1
8516,8517,Varthur,359500,69480,290020,0.8067315716272601,0
8517,8518,Whitefield,281950,46610,235340,0.8346870012413549,-1
8518,8519,CV Raman Nagar,260850,64570,196280,0.7524631013992716,0
8519,8520,Horamavu,379850,77440,302410,0.7961300513360537,-1
8520,8521,HBR Layout,407250,57580,349670,0.8586126457949662,-1
8521,8522,Mahadevapura,307100,41730,265370,0.8641159231520678,0
8522,8523,Kalyan Nagar,220200,57770,162430,0.7376475930971844,0
8523,8524,Hebbal,349400,65250,284150,0.8132512879221523,-1
8524,8525,Shivajinagar,404050,22710,381340,0.9437940848904839,-1
8525,8526,Vasanth Nagar,282700,112780,169920,0.6010611956137248,0
8526,8527,Marathahalli,68000,15560,52440,0.7711764705882352,-1
8527,8528,Vasanth Nagar,450000,137920,312080,0.6935111111111111,0
8528,8529,Whitefield,158800,48410,110390,0.6951511335012595,0
8529,8530,Varthur,169750,22170,147580,0.8693961708394699,0
8530,8531,Rajajinagar,319300,30380,288920,0.9048543689320389,-1
8531,8532,Whitefield,229150,37910,191240,0.8345625136373555,0
8532,8533,Varthur,401700,53660,348040,0.8664177246701519,-1
8533,8534,Whitefield,43100,75360,-32260,-0.748491879350348,1
8534,8535,Indiranagar,82950,90770,-7820,-0.09427365883062086,1
8535,8536,Kalyan Nagar,290950,19950,271000,0.9314315174428596,-1
8536,8537,Whitefield,116650,110650,6000,0.05143591941705958,1
8537,8538,Banaswadi,368350,42690,325660,0.8841047916383874,-1
8538,8539,Varthur,58150,68970,-10820,-0.18607050730868444,1
8539,8540,Mahadevapura,448700,112480,336220,0.7493202585246267,0
8540,8541,Rajajinagar,238900,19060,219840,0.920217664294684,-1
8541,8542,Krishnarajapuram,33500,134620,-101120,-3.0185074626865673,1
8542,8543,Vasanth Nagar,284850,64120,220730,0.7748990696857996,-1
8543,8544,Whitefield,139800,101740,38060,0.2722460658082976,1
8544,8545,Hoodi,374200,104790,269410,0.7199625868519508,0
8545,8546,Kammanahalli,142250,101750,40500,0.28471001757469244,1
8546,8547,Shivajinagar,421250,55630,365620,0.8679406528189911,-1
8547,8548,Mahadevapura,196100,50730,145370,0.7413054563997961,-1
8548,8549,Banaswadi,297600,10780,286820,0.9637768817204301,-1
8549,8550,Rajajinagar,286550,20410,266140,0.9287733379863898,-1
8550,8551,Malleswaram,79700,24050,55650,0.6982434127979925,0
8551,8552,Shivajinagar,72750,46880,25870,0.3556013745704467,1
8552,8553,CV Raman Nagar,353900,54610,299290,0.8456908731280023,-1
8553,8554,HBR Layout,387350,65370,321980,0.8312378985413709,0
8554,8555,Rajajinagar,247400,128360,119040,0.4811641067097817,1
8555,8556,Horamavu,279100,100470,178630,0.6400214976710856,0
8556,8557,Hebbal,150150,51190,98960,0.6590742590742591,0
8557,8558,Banaswadi,237600,61280,176320,0.7420875420875421,0
8558,8559,Hebbal,276250,111660,164590,0.5958009049773756,1
8559,8560,Indiranagar,190700,45020,145680,0.7639223911903513,-1
8560,8561,Banaswadi,285900,79140,206760,0.7231899265477439,-1
8561,8562,Hebbal,123050,41680,81370,0.6612759041040227,0
8562,8563,Krishnarajapuram,282350,20620,261730,0.9269700726049229,-1
8563,8564,Indiranagar,444300,89390,354910,0.7988071123115013,0
8564,8565,Hoodi,411200,145260,265940,0.6467412451361868,0
8565,8566,Hebbal,329400,22510,306890,0.9316636308439588,-1
8566,8567,Whitefield,143500,88980,54520,0.37993031358885015,1
8567,8568,Malleswaram,230400,84200,146200,0.6345486111111112,0
8568,8569,Malleswaram,43150,58430,-15280,-0.3541135573580533,1
8569,8570,Shivajinagar,48600,64080,-15480,-0.31851851851851853,1
8570,8571,CV Raman Nagar,381250,27110,354140,0.9288918032786885,-1
8571,8572,Marathahalli,89550,38640,50910,0.5685092127303183,0
8572,8573,CV Raman Nagar,226350,69010,157340,0.6951181798100288,0
8573,8574,CV Raman Nagar,75350,109850,-34500,-0.45786330457863306,1
8574,8575,Horamavu,439700,41610,398090,0.905367295883557,-1
8575,8576,Jalahalli,424350,48710,375640,0.8852126782137386,-1
8576,8577,Hebbal,345700,87360,258340,0.7472953427827597,-1
8577,8578,Vasanth Nagar,31650,23810,7840,0.24770932069510268,1
8578,8579,Indiranagar,380700,65770,314930,0.8272392960336222,-1
8579,8580,Horamavu,412300,103480,308820,0.7490177055542081,0
8580,8581,Horamavu,227750,48490,179260,0.7870911086717892,0
8581,8582,Kammanahalli,306750,74070,232680,0.7585330073349633,0
8582,8583,Mahadevapura,427900,45400,382500,0.8939004440289787,-1
8583,8584,Malleswaram,142150,75320,66830,0.4701371790362293,0
8584,8585,Marathahalli,187850,131380,56470,0.3006121905775885,1
8585,8586,Jalahalli,258000,42230,215770,0.8363178294573643,-1
8586,8587,Vasanth Nagar,370400,57420,312980,0.8449784017278618,0
8587,8588,Hoodi,93600,51230,42370,0.4526709401709402,0
8588,8589,Kalyan Nagar,198600,100070,98530,0.496122860020141,1
8589,8590,HBR Layout,293500,38570,254930,0.8685860306643952,0
8590,8591,Krishnarajapuram,304300,64500,239800,0.7880381202760434,0
8591,8592,Hebbal,102950,45520,57430,0.5578436134045653,0
8592,8593,Vasanth Nagar,33150,71030,-37880,-1.142684766214178,1
8593,8594,CV Raman Nagar,255500,72520,182980,0.7161643835616438,0
8594,8595,Kammanahalli,334450,104080,230370,0.6888025115861863,0
8595,8596,Kalyan Nagar,412250,24490,387760,0.9405942995755003,-1
8596,8597,Shivajinagar,169200,71560,97640,0.5770685579196217,1
8597,8598,Hebbal,31800,70880,-39080,-1.2289308176100628,1
8598,8599,Whitefield,239850,28640,211210,0.8805920366895976,-1
8599,8600,Vasanth Nagar,59350,41950,17400,0.2931760741364785,1
8600,8601,Jalahalli,370250,32900,337350,0.9111411208642809,-1
8601,8602,Hebbal,145100,146600,-1500,-0.010337698139214336,1
8602,8603,Rajajinagar,317900,18280,299620,0.942497640767537,-1
8603,8604,Krishnarajapuram,92600,28270,64330,0.6947084233261339,0
8604,8605,Banaswadi,350250,100910,249340,0.711891506067095,0
8605,8606,Vasanth Nagar,344250,79710,264540,0.7684531590413943,0
8606,8607,Vasanth Nagar,90550,115660,-25110,-0.27730535615681945,1
8607,8608,Rajajinagar,80600,75830,4770,0.059181141439205956,1
8608,8609,Krishnarajapuram,354200,38370,315830,0.8916713721061548,-1
8609,8610,Malleswaram,395850,30300,365550,0.9234558544903373,-1
8610,8611,HBR Layout,55050,59820,-4770,-0.08664850136239782,1
8611,8612,HBR Layout,292200,69270,222930,0.7629363449691992,0
8612,8613,Mahadevapura,30500,34270,-3770,-0.12360655737704918,1
8613,8614,Varthur,353250,66860,286390,0.8107289455060156,-1
8614,8615,Marathahalli,202150,120720,81430,0.40281968835023496,0
8615,8616,Mahadevapura,100650,53210,47440,0.4713363139592648,1
8616,8617,Hoodi,197400,44090,153310,0.776646403242148,-1
8617,8618,Jalahalli,290700,74950,215750,0.7421740626074992,0
8618,8619,Mahadevapura,119150,81360,37790,0.317163239613932,1
8619,8620,Varthur,332250,24930,307320,0.9249661399548533,-1
8620,8621,Shivajinagar,135200,50990,84210,0.6228550295857989,0
8621,8622,Hoodi,322450,15410,307040,0.952209644906187,-1
8622,8623,Hebbal,348550,36110,312440,0.8963993688136566,-1
8623,8624,Kammanahalli,423250,64640,358610,0.8472770230360307,0
8624,8625,Kalyan Nagar,303500,53270,250230,0.8244810543657332,-1
8625,8626,Hoodi,242150,14150,228000,0.9415651455709271,-1
8626,8627,Whitefield,155800,70960,84840,0.5445442875481387,0
8627,8628,Hebbal,222000,88720,133280,0.6003603603603603,0
8628,8629,Malleswaram,46800,52710,-5910,-0.12628205128205128,1
8629,8630,Hebbal,131250,31050,100200,0.7634285714285715,0
8630,8631,Rajajinagar,442300,102640,339660,0.7679403120054262,0
8631,8632,Hoodi,303250,65160,238090,0.7851277823577906,0
8632,8633,Hoodi,48600,24240,24360,0.5012345679012346,0
8633,8634,Rajajinagar,49650,79100,-29450,-0.5931520644511581,1
8634,8635,Banaswadi,320800,13850,306950,0.9568266832917706,-1
8635,8636,Krishnarajapuram,131450,120850,10600,0.08063902624572081,1
8636,8637,Krishnarajapuram,403900,53800,350100,0.866798712552612,-1
8637,8638,Vasanth Nagar,153300,125620,27680,0.18056099151989563,1
8638,8639,Mahadevapura,300950,68870,232080,0.7711579996677189,0
8639,8640,Indiranagar,391500,62010,329490,0.8416091954022988,0
8640,8641,Hebbal,447350,74000,373350,0.8345814239409858,-1
8641,8642,Hoodi,181250,64160,117090,0.6460137931034483,0
8642,8643,Marathahalli,250450,36590,213860,0.8539029746456378,-1
8643,8644,Krishnarajapuram,287800,62860,224940,0.7815844336344684,-1
8644,8645,Marathahalli,29050,54510,-25460,-0.8764199655765921,1
8645,8646,Jalahalli,51100,70140,-19040,-0.3726027397260274,1
8646,8647,HBR Layout,331550,0,331550,1.0,-1
8647,8648,Vasanth Nagar,304150,33060,271090,0.891303633075785,0
8648,8649,Mahadevapura,348550,62370,286180,0.82105867163965,0
8649,8650,Kammanahalli,67200,53860,13340,0.19851190476190475,1
8650,8651,Marathahalli,358150,90540,267610,0.7472008934803853,0
8651,8652,Marathahalli,416200,84760,331440,0.7963479096588179,0
8652,8653,Jalahalli,83900,42920,40980,0.48843861740166866,1
8653,8654,Hoodi,194950,6370,188580,0.9673249551166966,-1
8654,8655,Malleswaram,424750,40570,384180,0.9044849911712772,-1
8655,8656,Kalyan Nagar,288950,47380,241570,0.8360269942896695,0
8656,8657,Marathahalli,441200,133120,308080,0.6982774252039892,0
8657,8658,Malleswaram,173600,52290,121310,0.6987903225806451,0
8658,8659,CV Raman Nagar,38350,41120,-2770,-0.07222946544980444,1
8659,8660,Rajajinagar,295950,25850,270100,0.9126541645548234,-1
8660,8661,Marathahalli,442350,99080,343270,0.7760144681813044,0
8661,8662,Horamavu,33100,13690,19410,0.586404833836858,1
8662,8663,Hebbal,361700,93110,268590,0.7425767210395355,-1
8663,8664,Vasanth Nagar,306850,64570,242280,0.7895714518494379,0
8664,8665,Shivajinagar,40200,74650,-34450,-0.8569651741293532,1
8665,8666,Shivajinagar,289800,76450,213350,0.7361973775017253,0
8666,8667,Hebbal,87500,68090,19410,0.22182857142857143,1
8667,8668,Indiranagar,403950,101250,302700,0.7493501670998886,-1
8668,8669,Shivajinagar,79800,36030,43770,0.5484962406015037,0
8669,8670,Hebbal,445900,92440,353460,0.7926889437093518,0
8670,8671,Indiranagar,273200,25970,247230,0.9049414348462664,-1
8671,8672,Shivajinagar,121150,107970,13180,0.10879075526207181,1
8672,8673,Varthur,52650,55630,-2980,-0.05660018993352327,1
8673,8674,Rajajinagar,128900,71860,57040,0.4425135764158262,1
8674,8675,Hoodi,286300,66590,219710,0.7674118057981139,0
8675,8676,Varthur,194150,16020,178130,0.9174864795261396,-1
8676,8677,Banaswadi,249850,106940,142910,0.5719831899139484,0
8677,8678,Malleswaram,248100,44230,203870,0.8217251108424023,-1
8678,8679,Whitefield,396250,97300,298950,0.7544479495268139,-1
8679,8680,Kammanahalli,138950,41940,97010,0.6981648074847068,0
8680,8681,Kalyan Nagar,82700,97880,-15180,-0.18355501813784764,1
8681,8682,Krishnarajapuram,170650,21610,149040,0.8733665397011426,-1
8682,8683,Varthur,102050,46170,55880,0.5475747182753552,1
8683,8684,Marathahalli,318600,65540,253060,0.7942875078468299,0
8684,8685,HBR Layout,77900,47620,30280,0.38870346598202826,1
8685,8686,CV Raman Nagar,196400,58140,138260,0.7039714867617108,0
8686,8687,Marathahalli,55050,32410,22640,0.41126248864668485,0
8687,8688,Whitefield,290950,55920,235030,0.807802027839835,0
8688,8689,Hebbal,302800,11190,291610,0.9630449141347424,-1
8689,8690,Mahadevapura,317350,79060,238290,0.7508744288640302,-1
8690,8691,Shivajinagar,319350,63160,256190,0.8022232660090809,0
8691,8692,Vasanth Nagar,63050,72150,-9100,-0.14432989690721648,1
8692,8693,Malleswaram,165050,71330,93720,0.5678279309300212,0
8693,8694,Mahadevapura,130450,80930,49520,0.37960904561134534,1
8694,8695,Vasanth Nagar,64400,40560,23840,0.3701863354037267,1
8695,8696,Kammanahalli,120250,36300,83950,0.6981288981288981,0
8696,8697,Horamavu,365900,120240,245660,0.6713856244875649,0
8697,8698,Hebbal,66450,75180,-8730,-0.13137697516930022,1
8698,8699,Marathahalli,447650,31320,416330,0.9300346252652743,-1
8699,8700,CV Raman Nagar,277100,37200,239900,0.8657524359437027,0
8700,8701,Rajajinagar,75500,112550,-37050,-0.49072847682119203,1
8701,8702,Hebbal,420050,128480,291570,0.6941316509939293,0
8702,8703,Krishnarajapuram,389050,25020,364030,0.9356895000642591,-1
8703,8704,CV Raman Nagar,315700,53830,261870,0.829490022172949,0
8704,8705,Jalahalli,129000,32640,96360,0.7469767441860465,-1
8705,8706,Banaswadi,168500,74560,93940,0.5575074183976261,0
8706,8707,Varthur,193050,51520,141530,0.7331261331261332,0
8707,8708,HBR Layout,84500,4310,80190,0.9489940828402367,-1
8708,8709,Varthur,444200,19670,424530,0.9557181449797388,-1
8709,8710,Banaswadi,378850,76080,302770,0.7991817341955919,0
8710,8711,Vasanth Nagar,75800,75940,-140,-0.0018469656992084432,1
8711,8712,Horamavu,195250,47860,147390,0.7548783610755442,0
8712,8713,Indiranagar,124600,35080,89520,0.7184590690208668,0
8713,8714,Marathahalli,86650,21520,65130,0.7516445470282747,-1
8714,8715,Indiranagar,183950,114260,69690,0.3788529491709704,1
8715,8716,Rajajinagar,74700,188710,-114010,-1.5262382864792503,1
8716,8717,Malleswaram,335950,8910,327040,0.9734781961601429,-1
8717,8718,Varthur,403450,71290,332160,0.8232990457305738,-1
8718,8719,Vasanth Nagar,318950,108540,210410,0.6596958770967236,0
8719,8720,Whitefield,334450,22700,311750,0.9321273732994468,-1
8720,8721,Krishnarajapuram,107300,160960,-53660,-0.5000931966449208,1
8721,8722,Rajajinagar,271950,62870,209080,0.768817797389226,0
8722,8723,Indiranagar,394950,60910,334040,0.8457779465755159,-1
8723,8724,Whitefield,76700,159240,-82540,-1.0761408083441981,1
8724,8725,Indiranagar,243550,50560,192990,0.7924040238144118,-1
8725,8726,Malleswaram,343500,63820,279680,0.8142066957787482,-1
8726,8727,CV Raman Nagar,390750,10020,380730,0.9743570057581574,-1
8727,8728,Krishnarajapuram,310150,112310,197840,0.6378848944059327,0
8728,8729,Indiranagar,253150,40670,212480,0.839344262295082,0
8729,8730,Rajajinagar,351200,40580,310620,0.8844533029612757,0
8730,8731,Hoodi,395700,40850,354850,0.8967652261814506,-1
8731,8732,Indiranagar,267500,50630,216870,0.8107289719626168,-1
8732,8733,Jalahalli,447800,59620,388180,0.8668602054488611,-1
8733,8734,Varthur,62600,56330,6270,0.10015974440894569,1
8734,8735,Varthur,156000,51350,104650,0.6708333333333333,0
8735,8736,Whitefield,242350,49460,192890,0.7959149989684341,0
8736,8737,Mahadevapura,245350,121600,123750,0.5043814958222946,0
8737,8738,Banaswadi,54100,58910,-4810,-0.088909426987061,1
8738,8739,Hebbal,422150,38840,383310,0.9079947885822575,-1
8739,8740,Shivajinagar,122350,46120,76230,0.6230486309767062,0
8740,8741,CV Raman Nagar,297950,108370,189580,0.6362812552441685,0
8741,8742,Rajajinagar,74450,77880,-3430,-0.0460711887172599,1
8742,8743,Hoodi,126850,79900,46950,0.3701221915648404,1
8743,8744,Indiranagar,205200,27830,177370,0.8643762183235868,-1
8744,8745,Krishnarajapuram,201450,73820,127630,0.6335567138247704,0
8745,8746,Jalahalli,305200,115700,189500,0.6209043250327654,0
8746,8747,Vasanth Nagar,72400,37240,35160,0.4856353591160221,0
8747,8748,Hoodi,241550,16620,224930,0.9311943696957151,-1
8748,8749,Marathahalli,94400,62310,32090,0.3399364406779661,1
8749,8750,Jalahalli,253050,68290,184760,0.7301323849041691,0
8750,8751,Hebbal,153050,78620,74430,0.48631166285527605,1
8751,8752,CV Raman Nagar,391000,89510,301490,0.771074168797954,-1
8752,8753,Kalyan Nagar,353950,67660,286290,0.8088430569289448,-1
8753,8754,Hoodi,139600,31530,108070,0.7741404011461318,-1
8754,8755,Krishnarajapuram,116400,124670,-8270,-0.07104810996563574,1
8755,8756,Shivajinagar,192700,25210,167490,0.869174883238194,-1
8756,8757,Jalahalli,425400,35130,390270,0.9174188998589563,-1
8757,8758,Shivajinagar,353350,95860,257490,0.7287109098627423,0
8758,8759,HBR Layout,123100,27860,95240,0.7736799350121852,0
8759,8760,Hoodi,66500,54120,12380,0.1861654135338346,1
8760,8761,Kammanahalli,323700,23890,299810,0.9261970960766142,-1
8761,8762,Varthur,241200,15360,225840,0.936318407960199,-1
8762,8763,Shivajinagar,199600,113360,86240,0.432064128256513,0
8763,8764,Kalyan Nagar,255450,37180,218270,0.8544529262086514,-1
8764,8765,Indiranagar,92900,59270,33630,0.3620021528525296,1
8765,8766,Hoodi,304100,18600,285500,0.9388359092403814,-1
8766,8767,Hebbal,250000,58320,191680,0.76672,0
8767,8768,Mahadevapura,337050,131060,205990,0.6111556148939327,0
8768,8769,Horamavu,105500,60790,44710,0.4237914691943128,0
8769,8770,Banaswadi,229400,102350,127050,0.5538360941586749,0
8770,8771,CV Raman Nagar,392850,119400,273450,0.6960672012218404,0
8771,8772,Hoodi,395750,57980,337770,0.8534933670246367,-1
8772,8773,Hebbal,349800,64450,285350,0.8157518582046884,-1
8773,8774,Vasanth Nagar,337350,79870,257480,0.763242922780495,0
8774,8775,Hebbal,56150,43300,12850,0.2288512911843277,1
8775,8776,Malleswaram,410350,68920,341430,0.8320458145485561,-1
8776,8777,Kammanahalli,77200,66740,10460,0.1354922279792746,1
8777,8778,Malleswaram,185800,34240,151560,0.8157158234660926,-1
8778,8779,Indiranagar,64850,38340,26510,0.4087895142636854,0
8779,8780,Horamavu,184700,231380,-46680,-0.252734163508392,1
8780,8781,Vasanth Nagar,186300,49760,136540,0.7329039184111648,-1
8781,8782,Marathahalli,281500,37050,244450,0.8683836589698046,-1
8782,8783,Jalahalli,103500,40020,63480,0.6133333333333333,0
8783,8784,HBR Layout,38650,72870,-34220,-0.8853816300129366,1
8784,8785,Kammanahalli,403100,22400,380700,0.9444306623666584,-1
8785,8786,Malleswaram,200650,111130,89520,0.4461500124595066,1
8786,8787,Whitefield,430000,53740,376260,0.8750232558139535,-1
8787,8788,Malleswaram,436500,52890,383610,0.878831615120275,-1
8788,8789,Vasanth Nagar,119750,165480,-45730,-0.38187891440501043,1
8789,8790,Banaswadi,378050,43810,334240,0.8841158576907816,-1
8790,8791,Varthur,342250,106990,235260,0.6873922571219868,0
8791,8792,Shivajinagar,145300,51310,93990,0.6468685478320716,0
8792,8793,Hoodi,125650,88070,37580,0.29908475925189015,1
8793,8794,CV Raman Nagar,315150,43320,271830,0.8625416468348406,-1
8794,8795,Hoodi,401000,78080,322920,0.805286783042394,-1
8795,8796,Varthur,166950,116550,50400,0.3018867924528302,1
8796,8797,Kammanahalli,66450,106390,-39940,-0.601053423626787,1
8797,8798,Rajajinagar,179000,49530,129470,0.7232960893854748,0
8798,8799,Whitefield,321000,42770,278230,0.8667601246105919,-1
8799,8800,Indiranagar,389700,75510,314190,0.8062355658198614,-1
8800,8801,Varthur,163300,43860,119440,0.7314145744029393,0
8801,8802,Indiranagar,353800,39950,313850,0.8870830977953647,-1
8802,8803,Kammanahalli,432300,98700,333600,0.7716863289382373,-1
8803,8804,Mahadevapura,162700,53230,109470,0.6728334357713583,0
8804,8805,Shivajinagar,233400,46820,186580,0.7994001713796058,-1
8805,8806,Banaswadi,327550,85590,241960,0.7386963822317203,-1
8806,8807,Whitefield,351800,39700,312100,0.8871517907902217,0
8807,8808,Malleswaram,60950,8320,52630,0.8634946677604594,-1
8808,8809,Hoodi,447550,69660,377890,0.8443525863032063,-1
8809,8810,Hebbal,388700,61520,327180,0.8417288397221507,-1
8810,8811,Horamavu,395350,53520,341830,0.8646262805109397,-1
8811,8812,Whitefield,377100,60530,316570,0.8394855476001061,-1
8812,8813,Rajajinagar,167950,120310,47640,0.2836558499553439,1
8813,8814,Vasanth Nagar,161950,125880,36070,0.2227230626736647,1
8814,8815,Malleswaram,174150,28820,145330,0.8345104794717197,-1
8815,8816,Mahadevapura,167700,42650,125050,0.7456768038163387,0
8816,8817,Marathahalli,441450,79160,362290,0.8206818439234341,-1
8817,8818,Varthur,172900,110520,62380,0.3607865818392134,1
8818,8819,Horamavu,375000,112530,262470,0.69992,0
8819,8820,Malleswaram,64450,24470,39980,0.6203258339798293,0
8820,8821,Hebbal,302000,99470,202530,0.6706291390728477,0
8821,8822,Hoodi,233400,64060,169340,0.7255355612682091,-1
8822,8823,Shivajinagar,70750,48680,22070,0.3119434628975265,1
8823,8824,Horamavu,310750,99390,211360,0.6801609010458568,0
8824,8825,Banaswadi,228800,72530,156270,0.6829982517482518,0
8825,8826,Mahadevapura,186600,61280,125320,0.6715969989281887,0
8826,8827,Kalyan Nagar,54850,36650,18200,0.3318140382862352,1
8827,8828,Banaswadi,327700,56490,271210,0.8276167226121453,-1
8828,8829,CV Raman Nagar,84150,97460,-13310,-0.15816993464052287,1
8829,8830,Indiranagar,388000,43540,344460,0.8877835051546392,-1
8830,8831,Kammanahalli,84800,100540,-15740,-0.1856132075471698,1
8831,8832,Hebbal,244050,38140,205910,0.843720549067814,-1
8832,8833,Hebbal,63700,127090,-63390,-0.9951334379905808,1
8833,8834,Vasanth Nagar,161000,64820,96180,0.5973913043478261,0
8834,8835,Mahadevapura,360450,87680,272770,0.7567485088084339,0
8835,8836,Jalahalli,303700,90230,213470,0.7028975963121501,0
8836,8837,Banaswadi,172350,55610,116740,0.6773426167682043,0
8837,8838,Krishnarajapuram,432400,70910,361490,0.8360083256244218,-1
8838,8839,Varthur,150000,52920,97080,0.6472,0
8839,8840,Marathahalli,199100,78240,120860,0.6070316423907585,0
8840,8841,Varthur,400900,124600,276300,0.6891993015714643,0
8841,8842,Vasanth Nagar,184700,50690,134010,0.725554953979426,-1
8842,8843,Kalyan Nagar,277350,44460,232890,0.8396971335857221,-1
8843,8844,Varthur,232950,63100,169850,0.7291264219789655,0
8844,8845,Marathahalli,404100,38170,365930,0.9055431823805988,-1
8845,8846,Rajajinagar,414250,57870,356380,0.8603017501508751,0
8846,8847,Krishnarajapuram,86550,35900,50650,0.585210860774119,0
8847,8848,Whitefield,146500,89860,56640,0.3866211604095563,1
8848,8849,Indiranagar,268000,61940,206060,0.7688805970149254,-1
8849,8850,Vasanth Nagar,103950,51780,52170,0.5018759018759019,0
8850,8851,Whitefield,126750,106960,19790,0.15613412228796844,1
8851,8852,Varthur,398050,0,398050,1.0,-1
8852,8853,HBR Layout,260150,34540,225610,0.86723044397463,-1
8853,8854,Banaswadi,390400,48740,341660,0.8751536885245902,0
8854,8855,Krishnarajapuram,95450,20250,75200,0.7878470403352541,0
8855,8856,Krishnarajapuram,244600,50550,194050,0.7933360588716272,0
8856,8857,Vasanth Nagar,94650,56120,38530,0.40707871104067617,1
8857,8858,Jalahalli,314000,59630,254370,0.8100955414012739,0
8858,8859,Whitefield,160500,51990,108510,0.6760747663551402,0
8859,8860,Marathahalli,30150,60650,-30500,-1.0116086235489221,1
8860,8861,Horamavu,25850,30610,-4760,-0.18413926499032882,1
8861,8862,Jalahalli,60400,85510,-25110,-0.41572847682119207,1
8862,8863,Horamavu,434800,31140,403660,0.9283808647654094,-1
8863,8864,Horamavu,96000,185070,-89070,-0.9278125,1
8864,8865,HBR Layout,111800,70790,41010,0.36681574239713777,1
8865,8866,Shivajinagar,57550,3990,53560,0.9306689834926151,-1
8866,8867,Kalyan Nagar,285750,33860,251890,0.8815048118985127,-1
8867,8868,HBR Layout,220700,29970,190730,0.8642048028998641,0
8868,8869,Kammanahalli,348000,31250,316750,0.9102011494252874,-1
8869,8870,Kalyan Nagar,193400,13620,179780,0.9295760082730093,-1
8870,8871,Mahadevapura,232900,16110,216790,0.9308286818376986,-1
8871,8872,Shivajinagar,425300,30040,395260,0.9293675052903833,-1
8872,8873,Malleswaram,318000,55080,262920,0.8267924528301887,-1
8873,8874,Indiranagar,306800,43290,263510,0.8588983050847457,-1
8874,8875,Indiranagar,123350,43500,79850,0.6473449533846778,0
8875,8876,Malleswaram,158900,49330,109570,0.6895531780994336,0
8876,8877,Banaswadi,57500,26690,30810,0.5358260869565218,0
8877,8878,Marathahalli,429400,107780,321620,0.7489986027014439,0
8878,8879,Malleswaram,318000,133630,184370,0.5797798742138365,0
8879,8880,Krishnarajapuram,438950,55040,383910,0.8746098644492539,-1
8880,8881,Varthur,397300,79620,317680,0.7995972816511452,0
8881,8882,Whitefield,257600,67720,189880,0.7371118012422361,0
8882,8883,Rajajinagar,387050,49670,337380,0.8716703268311587,0
8883,8884,Malleswaram,108250,52650,55600,0.5136258660508083,1
8884,8885,Indiranagar,82900,53350,29550,0.35645355850422195,1
8885,8886,Horamavu,323050,69880,253170,0.7836867357994118,0
8886,8887,Krishnarajapuram,259150,38010,221140,0.8533281883079298,-1
8887,8888,Krishnarajapuram,153500,8560,144940,0.9442345276872964,-1
8888,8889,Marathahalli,184600,35390,149210,0.8082881906825569,-1
8889,8890,Marathahalli,174750,16060,158690,0.9080972818311874,-1
8890,8891,Hoodi,393700,72400,321300,0.8161036322072645,-1
8891,8892,Kalyan Nagar,278400,16370,262030,0.9411997126436782,-1
8892,8893,Mahadevapura,295850,60260,235590,0.7963157005239141,0
8893,8894,Hebbal,356650,74610,282040,0.7908033085658208,0
8894,8895,Marathahalli,221850,71760,150090,0.6765382014874916,0
8895,8896,Varthur,116850,23580,93270,0.7982028241335045,-1
8896,8897,Kammanahalli,148550,78690,69860,0.47027936721642544,1
8897,8898,Varthur,38200,84840,-46640,-1.2209424083769633,1
8898,8899,Kalyan Nagar,243700,66560,177140,0.7268773081657776,0
8899,8900,Jalahalli,137850,43580,94270,0.6838592673195503,0
8900,8901,Mahadevapura,226300,57620,168680,0.7453822359699513,0
8901,8902,Krishnarajapuram,258050,41200,216850,0.840341019182329,0
8902,8903,Kalyan Nagar,434550,39310,395240,0.9095386031526866,-1
8903,8904,Indiranagar,246750,51750,195000,0.790273556231003,0
8904,8905,Malleswaram,85600,76360,9240,0.10794392523364486,1
8905,8906,Hoodi,325250,102590,222660,0.6845810914681014,0
8906,8907,Rajajinagar,449400,29780,419620,0.9337338673787272,-1
8907,8908,Jalahalli,135800,128230,7570,0.05574374079528719,1
8908,8909,Whitefield,425650,54980,370670,0.8708328438858217,-1
8909,8910,Hoodi,181750,25690,156060,0.8586519944979367,-1
8910,8911,Whitefield,142000,59100,82900,0.5838028169014085,1
8911,8912,Kalyan Nagar,107950,53840,54110,0.5012505789717462,1
8912,8913,Jalahalli,372350,16600,355750,0.9554182892439909,-1
8913,8914,Horamavu,218100,72910,145190,0.6657038055937643,0
8914,8915,Malleswaram,135700,61850,73850,0.5442151805453206,0
8915,8916,Marathahalli,82450,55490,26960,0.3269860521528199,1
8916,8917,Krishnarajapuram,97800,50700,47100,0.4815950920245399,0
8917,8918,HBR Layout,295800,34770,261030,0.8824543610547667,-1
8918,8919,Horamavu,309400,52490,256910,0.8303490627020039,-1
8919,8920,Indiranagar,174550,97250,77300,0.44285305070180464,1
8920,8921,Rajajinagar,40950,81170,-40220,-0.9821733821733821,1
8921,8922,Whitefield,32950,40100,-7150,-0.21699544764795145,1
8922,8923,Jalahalli,97300,52260,45040,0.46289825282631036,1
8923,8924,Marathahalli,300450,87960,212490,0.7072391412880679,0
8924,8925,Hebbal,229900,90060,139840,0.6082644628099173,0
8925,8926,Kammanahalli,258000,65310,192690,0.746860465116279,0
8926,8927,Marathahalli,270500,43850,226650,0.8378927911275416,-1
8927,8928,Krishnarajapuram,107650,101750,5900,0.0548072457036693,1
8928,8929,CV Raman Nagar,144400,55030,89370,0.6189058171745152,0
8929,8930,Kammanahalli,258250,32030,226220,0.875972894482091,-1
8930,8931,Kammanahalli,122250,58930,63320,0.5179550102249488,0
8931,8932,Krishnarajapuram,145300,68550,76750,0.5282174810736407,0
8932,8933,Banaswadi,61100,121020,-59920,-0.9806873977086743,1
8933,8934,Vasanth Nagar,141750,49560,92190,0.6503703703703704,0
8934,8935,HBR Layout,266050,42180,223870,0.8414583724863748,-1
8935,8936,Marathahalli,146050,0,146050,1.0,-1
8936,8937,Krishnarajapuram,188600,30580,158020,0.8378579003181336,-1
8937,8938,Jalahalli,299950,59800,240150,0.8006334389064844,-1
8938,8939,Vasanth Nagar,81800,50280,31520,0.38533007334963326,1
8939,8940,Jalahalli,142750,31540,111210,0.7790542907180386,-1
8940,8941,Marathahalli,95600,50000,45600,0.4769874476987448,0
8941,8942,Krishnarajapuram,116650,77930,38720,0.3319331333047578,1
8942,8943,Shivajinagar,261100,61440,199660,0.7646878590578322,0
8943,8944,Indiranagar,363100,51620,311480,0.85783530707794,0
8944,8945,Horamavu,258300,67790,190510,0.7375532326751839,0
8945,8946,Banaswadi,215300,51540,163760,0.7606130980027868,0
8946,8947,Kalyan Nagar,415600,67680,347920,0.8371511068334937,-1
8947,8948,HBR Layout,383900,40790,343110,0.8937483719718676,-1
8948,8949,CV Raman Nagar,327250,32970,294280,0.8992513368983958,0
8949,8950,Kammanahalli,313800,77970,235830,0.751529636711281,-1
8950,8951,Shivajinagar,370850,71580,299270,0.8069839557772684,-1
8951,8952,Jalahalli,176550,119680,56870,0.3221183800623053,1
8952,8953,Varthur,258700,92330,166370,0.6431001159644376,0
8953,8954,Marathahalli,61550,54860,6690,0.10869212022745735,1
8954,8955,Banaswadi,203000,84560,118440,0.5834482758620689,0
8955,8956,Jalahalli,267150,68290,198860,0.7443758188283736,0
8956,8957,Malleswaram,140700,104250,36450,0.25906183368869934,1
8957,8958,Kalyan Nagar,293650,49950,243700,0.8298995402690278,-1
8958,8959,Horamavu,314800,92720,222080,0.7054637865311308,-1
8959,8960,CV Raman Nagar,135950,67140,68810,0.5061419639573372,0
8960,8961,Marathahalli,432550,38880,393670,0.9101144376372674,-1
8961,8962,Varthur,42550,45340,-2790,-0.0655699177438308,1
8962,8963,Marathahalli,130600,37240,93360,0.714854517611026,-1
8963,8964,Horamavu,169350,50400,118950,0.7023914968999114,-1
8964,8965,Hebbal,126650,89660,36990,0.2920647453612317,1
8965,8966,CV Raman Nagar,355350,116830,238520,0.6712255522724074,0
8966,8967,Kammanahalli,58800,38920,19880,0.3380952380952381,1
8967,8968,Horamavu,407800,158260,249540,0.6119176066699362,0
8968,8969,Mahadevapura,148800,130690,18110,0.12170698924731183,1
8969,8970,CV Raman Nagar,30400,124200,-93800,-3.085526315789474,1
8970,8971,Mahadevapura,246450,82670,163780,0.6645567052140393,0
8971,8972,Hebbal,335550,59900,275650,0.8214871107137536,-1
8972,8973,CV Raman Nagar,26850,77690,-50840,-1.8934823091247672,1
8973,8974,Mahadevapura,236850,57610,179240,0.7567658855815917,-1
8974,8975,Krishnarajapuram,120100,73850,46250,0.3850957535387177,1
8975,8976,Malleswaram,51900,11740,40160,0.7737957610789981,0
8976,8977,Banaswadi,172650,56310,116340,0.6738488271068636,0
8977,8978,Whitefield,133200,113940,19260,0.1445945945945946,1
8978,8979,Rajajinagar,285600,15520,270080,0.9456582633053221,-1
8979,8980,Krishnarajapuram,98600,89920,8680,0.08803245436105477,1
8980,8981,Mahadevapura,245600,19780,225820,0.9194625407166124,-1
8981,8982,Varthur,213500,41840,171660,0.8040281030444965,-1
8982,8983,Horamavu,447350,128210,319140,0.7134011400469431,0
8983,8984,Krishnarajapuram,284700,56410,228290,0.8018616087109238,-1
8984,8985,HBR Layout,275750,36340,239410,0.8682139619220308,0
8985,8986,Malleswaram,209350,60630,148720,0.7103893002149511,0
8986,8987,Mahadevapura,257600,26830,230770,0.8958462732919255,-1
8987,8988,Shivajinagar,386450,73390,313060,0.8100918618191227,0
8988,8989,Jalahalli,29600,69620,-40020,-1.352027027027027,1
8989,8990,Kalyan Nagar,39100,66420,-27320,-0.6987212276214834,1
8990,8991,Banaswadi,242850,92460,150390,0.6192711550339716,0
8991,8992,Rajajinagar,182750,132560,50190,0.2746374829001368,1
8992,8993,Indiranagar,197500,101190,96310,0.4876455696202532,1
8993,8994,Vasanth Nagar,40750,73320,-32570,-0.7992638036809816,1
8994,8995,Jalahalli,414650,49260,365390,0.8812010129024479,-1
8995,8996,Kammanahalli,243850,103770,140080,0.5744515070740209,0
8996,8997,Whitefield,251250,59220,192030,0.7642985074626866,-1
8997,8998,Indiranagar,308700,47880,260820,0.8448979591836735,-1
8998,8999,Horamavu,299150,15680,283470,0.9475848236670567,-1
8999,9000,Hoodi,404150,74070,330080,0.8167264629469256,0
9000,9001,CV Raman Nagar,312850,80160,232690,0.7437749720313249,-1
9001,9002,Malleswaram,324850,0,324850,1.0,-1
9002,9003,HBR Layout,330950,38810,292140,0.8827315304426651,-1
9003,9004,Vasanth Nagar,99900,72320,27580,0.2760760760760761,1
9004,9005,Horamavu,53150,36720,16430,0.30912511759172157,1
9005,9006,Malleswaram,387300,79190,308110,0.7955331784146656,-1
9006,9007,Indiranagar,242550,27250,215300,0.8876520305091734,-1
9007,9008,Malleswaram,85600,70260,15340,0.17920560747663553,1
9008,9009,HBR Layout,65000,2420,62580,0.9627692307692308,-1
9009,9010,HBR Layout,337150,87310,249840,0.7410351475604331,0
9010,9011,Mahadevapura,130200,81490,48710,0.3741167434715822,1
9011,9012,Krishnarajapuram,199900,59560,140340,0.7020510255127563,-1
9012,9013,Vasanth Nagar,80100,59300,20800,0.2596754057428215,1
9013,9014,Krishnarajapuram,149650,49920,99730,0.666421650517875,0
9014,9015,Rajajinagar,121850,32350,89500,0.734509643003693,-1
9015,9016,Indiranagar,166750,47030,119720,0.7179610194902549,-1
9016,9017,Mahadevapura,345850,95190,250660,0.7247650715628162,0
9017,9018,Kammanahalli,394800,45530,349270,0.8846757852077001,0
9018,9019,Mahadevapura,51500,5810,45690,0.8871844660194175,-1
9019,9020,Jalahalli,187350,74700,112650,0.6012810248198559,0
9020,9021,Shivajinagar,395550,40060,355490,0.8987232966755151,-1
9021,9022,HBR Layout,125350,63060,62290,0.49692859992022337,1
9022,9023,Hoodi,139200,91540,47660,0.34238505747126435,1
9023,9024,Hoodi,328750,10610,318140,0.9677262357414449,-1
9024,9025,Indiranagar,416350,51620,364730,0.876017773507866,-1
9025,9026,Whitefield,251350,51390,199960,0.7955440620648498,0
9026,9027,Horamavu,402250,23450,378800,0.9417029210689869,-1
9027,9028,Malleswaram,38150,56340,-18190,-0.47680209698558323,1
9028,9029,Hebbal,90250,81330,8920,0.0988365650969529,1
9029,9030,HBR Layout,282850,68610,214240,0.7574332685168818,-1
9030,9031,Banaswadi,308750,51690,257060,0.832582995951417,0
9031,9032,Horamavu,321300,5870,315430,0.9817304699657641,-1
9032,9033,Krishnarajapuram,145550,83520,62030,0.42617657162487116,1
9033,9034,Rajajinagar,337000,78740,258260,0.7663501483679526,0
9034,9035,Varthur,423250,90290,332960,0.7866745422327229,0
9035,9036,CV Raman Nagar,248150,31450,216700,0.8732621398347774,-1
9036,9037,Shivajinagar,191850,39760,152090,0.7927547563200417,-1
9037,9038,Horamavu,218050,62210,155840,0.714698463655125,0
9038,9039,Rajajinagar,371950,50400,321550,0.8644979163866111,-1
9039,9040,Vasanth Nagar,389500,49710,339790,0.8723748395378691,-1
9040,9041,Kalyan Nagar,433000,111710,321290,0.7420092378752887,-1
9041,9042,Rajajinagar,333700,26030,307670,0.9219958046149236,-1
9042,9043,Malleswaram,225200,9340,215860,0.958525754884547,-1
9043,9044,CV Raman Nagar,282050,101410,180640,0.6404538202446375,0
9044,9045,HBR Layout,288850,74310,214540,0.7427384455599793,0
9045,9046,Whitefield,288500,83330,205170,0.7111611785095321,-1
9046,9047,Whitefield,63800,63030,770,0.01206896551724138,1
9047,9048,Whitefield,78450,115370,-36920,-0.47061822817080945,1
9048,9049,Marathahalli,280950,46650,234300,0.8339562199679659,0
9049,9050,Mahadevapura,86900,53530,33370,0.3840046029919448,1
9050,9051,Malleswaram,131100,56270,74830,0.5707856598016781,0
9051,9052,Hebbal,303300,25650,277650,0.9154302670623146,-1
9052,9053,Shivajinagar,422350,65530,356820,0.8448443234284362,-1
9053,9054,Varthur,406800,67240,339560,0.8347099311701082,-1
9054,9055,Kalyan Nagar,118150,162320,-44170,-0.37384680490901395,1
9055,9056,Varthur,165100,9890,155210,0.9400969109630527,-1
9056,9057,Hebbal,183600,50340,133260,0.7258169934640523,0
9057,9058,Mahadevapura,242500,72950,169550,0.6991752577319588,0
9058,9059,Whitefield,132450,34960,97490,0.7360513401283503,0
9059,9060,Whitefield,279250,78020,201230,0.7206087735004476,0
9060,9061,Indiranagar,224750,108320,116430,0.5180422691879867,0
9061,9062,Kammanahalli,136150,62810,73340,0.5386705839147998,0
9062,9063,Kalyan Nagar,150750,87600,63150,0.41890547263681593,1
9063,9064,Hoodi,103450,29640,73810,0.7134847752537458,0
9064,9065,Shivajinagar,174500,48150,126350,0.7240687679083094,0
9065,9066,Malleswaram,130300,63060,67240,0.516039907904835,1
9066,9067,CV Raman Nagar,150650,58340,92310,0.612744772651842,0
9067,9068,Vasanth Nagar,273950,61310,212640,0.7762000365030115,0
9068,9069,HBR Layout,411050,44820,366230,0.890962170052305,0
9069,9070,Kammanahalli,316450,177860,138590,0.4379522831410965,1
9070,9071,Banaswadi,322800,128420,194380,0.6021685254027261,0
9071,9072,Shivajinagar,295700,64550,231150,0.7817044301657085,0
9072,9073,Malleswaram,317050,101810,215240,0.6788834568680019,0
9073,9074,Whitefield,108800,40630,68170,0.6265625,0
9074,9075,Horamavu,422300,12450,409850,0.9705185886810325,-1
9075,9076,Hebbal,289150,29750,259400,0.8971122254885008,-1
9076,9077,Varthur,233650,62680,170970,0.73173550181896,-1
9077,9078,Kalyan Nagar,372750,17020,355730,0.9543393695506371,-1
9078,9079,Mahadevapura,239650,27340,212310,0.885916962236595,-1
9079,9080,Hoodi,406250,79280,326970,0.8048492307692308,-1
9080,9081,Kammanahalli,209200,30290,178910,0.8552103250478011,0
9081,9082,Indiranagar,286150,76260,209890,0.733496417962607,0
9082,9083,Jalahalli,443050,30010,413040,0.9322649813790769,-1
9083,9084,Jalahalli,97350,70100,27250,0.27991782229070367,1
9084,9085,Banaswadi,106400,115020,-8620,-0.08101503759398496,1
9085,9086,Kammanahalli,251000,57780,193220,0.769800796812749,-1
9086,9087,Malleswaram,391000,142240,248760,0.6362148337595908,0
9087,9088,CV Raman Nagar,234400,33060,201340,0.8589590443686007,0
9088,9089,Rajajinagar,75750,93390,-17640,-0.23287128712871288,1
9089,9090,HBR Layout,51500,36000,15500,0.30097087378640774,1
9090,9091,Horamavu,410700,84090,326610,0.7952520087655223,-1
9091,9092,Horamavu,447050,90630,356420,0.7972709987697125,0
9092,9093,Banaswadi,349550,61940,287610,0.8228007438134745,0
9093,9094,Mahadevapura,414200,95610,318590,0.769169483341381,0
9094,9095,Krishnarajapuram,232250,35350,196900,0.8477933261571582,0
9095,9096,Hebbal,310600,47690,262910,0.8464584674822924,-1
9096,9097,Malleswaram,158200,88380,69820,0.44134007585335017,0
9097,9098,Indiranagar,103250,59060,44190,0.4279903147699758,1
9098,9099,HBR Layout,330800,60020,270780,0.8185610640870616,0
9099,9100,Whitefield,209400,125810,83590,0.3991881566380134,1
9100,9101,Banaswadi,180450,91050,89400,0.49542809642560265,0
9101,9102,Jalahalli,179600,115180,64420,0.35868596881959913,1
9102,9103,Varthur,226650,11200,215450,0.9505846018089565,-1
9103,9104,Mahadevapura,417000,100240,316760,0.7596163069544365,0
9104,9105,Indiranagar,127800,40080,87720,0.6863849765258216,0
9105,9106,Malleswaram,218750,71650,147100,0.6724571428571429,0
9106,9107,Kalyan Nagar,330350,78600,251750,0.7620705312547298,0
9107,9108,Vasanth Nagar,200350,65550,134800,0.6728225605190916,0
9108,9109,Rajajinagar,250350,71620,178730,0.7139205112842021,-1
9109,9110,Whitefield,97900,36450,61450,0.6276813074565883,0
9110,9111,Hoodi,415400,52370,363030,0.8739287433798748,0
9111,9112,Banaswadi,104150,45690,58460,0.5613058089294287,1
9112,9113,Hoodi,71850,69190,2660,0.037021572720946416,1
9113,9114,CV Raman Nagar,151800,72600,79200,0.5217391304347826,0
9114,9115,Jalahalli,72550,55490,17060,0.23514817367332874,1
9115,9116,Marathahalli,423700,61310,362390,0.8552985603021005,-1
9116,9117,Krishnarajapuram,274100,53070,221030,0.8063845311929952,-1
9117,9118,Krishnarajapuram,340250,68600,271650,0.7983835415135929,0
9118,9119,Varthur,227850,88040,139810,0.6136054421768707,0
9119,9120,Krishnarajapuram,66450,52880,13570,0.20421369450714824,1
9120,9121,Marathahalli,383800,43230,340570,0.887363210005211,0
9121,9122,Varthur,270900,34110,236790,0.8740863787375416,0
9122,9123,Kammanahalli,407850,42850,365000,0.8949368640431531,-1
9123,9124,Kalyan Nagar,168850,18740,150110,0.8890139176784128,-1
9124,9125,Kalyan Nagar,349100,99610,249490,0.7146662847321684,0
9125,9126,Vasanth Nagar,150550,83440,67110,0.4457655264031883,1
9126,9127,Malleswaram,442550,74000,368550,0.8327872556773246,-1
9127,9128,Rajajinagar,157450,58030,99420,0.6314385519212449,0
9128,9129,Hebbal,100650,116700,-16050,-0.15946348733233978,1
9129,9130,Whitefield,303000,44030,258970,0.8546864686468647,-1
9130,9131,Krishnarajapuram,403700,108360,295340,0.7315828585583354,0
9131,9132,Indiranagar,343550,82840,260710,0.7588706156309125,-1
9132,9133,HBR Layout,420400,55690,364710,0.8675309229305423,0
9133,9134,Hebbal,214400,98400,116000,0.5410447761194029,0
9134,9135,CV Raman Nagar,339950,55420,284530,0.8369760258861597,-1
9135,9136,Rajajinagar,430100,70110,359990,0.8369913973494536,-1
9136,9137,Hoodi,154350,2780,151570,0.9819889860706187,-1
9137,9138,HBR Layout,394100,56410,337690,0.8568637401674701,-1
9138,9139,HBR Layout,47450,70350,-22900,-0.48261327713382507,1
9139,9140,CV Raman Nagar,358450,84380,274070,0.7645975728832474,0
9140,9141,Varthur,86900,23830,63070,0.7257767548906789,0
9141,9142,Krishnarajapuram,252250,79580,172670,0.6845193260654113,0
9142,9143,Malleswaram,122000,52390,69610,0.5705737704918032,0
9143,9144,Shivajinagar,208400,57950,150450,0.7219289827255279,0
9144,9145,Hebbal,312050,79390,232660,0.74558564332639,-1
9145,9146,Kalyan Nagar,180100,65760,114340,0.6348695169350361,0
9146,9147,Marathahalli,120250,91140,29110,0.24207900207900207,1
9147,9148,Malleswaram,391800,102190,289610,0.7391781521184277,0
9148,9149,Shivajinagar,126550,42310,84240,0.665665744764915,0
9149,9150,Vasanth Nagar,46200,86360,-40160,-0.8692640692640693,1
9150,9151,Indiranagar,188200,71880,116320,0.6180658873538789,0
9151,9152,Mahadevapura,412750,21290,391460,0.9484191399152029,-1
9152,9153,Varthur,90200,104510,-14310,-0.15864745011086476,1
9153,9154,Kalyan Nagar,362450,114420,248030,0.684315077941785,0
9154,9155,Shivajinagar,31900,28790,3110,0.09749216300940439,1
9155,9156,Whitefield,202300,83800,118500,0.5857637172516065,0
9156,9157,Banaswadi,304450,85710,218740,0.718475940220069,-1
9157,9158,Krishnarajapuram,287450,65580,221870,0.7718559749521656,0
9158,9159,Hebbal,142650,35210,107440,0.7531720995443393,0
9159,9160,Marathahalli,408100,90460,317640,0.7783386424895858,-1
9160,9161,Shivajinagar,330400,46130,284270,0.8603813559322034,-1
9161,9162,Krishnarajapuram,403600,63860,339740,0.8417740336967294,-1
9162,9163,HBR Layout,361400,78320,283080,0.7832872163807416,-1
9163,9164,Marathahalli,154350,40160,114190,0.7398121153223194,-1
9164,9165,Varthur,99750,47440,52310,0.5244110275689223,0
9165,9166,Krishnarajapuram,59250,32970,26280,0.44354430379746834,1
9166,9167,Hebbal,293650,104180,189470,0.6452239060105568,0
9167,9168,Indiranagar,424000,9700,414300,0.977122641509434,-1
9168,9169,Rajajinagar,322900,119590,203310,0.6296376587178694,0
9169,9170,Malleswaram,352800,60830,291970,0.827579365079365,-1
9170,9171,CV Raman Nagar,302800,49360,253440,0.8369881109643329,-1
9171,9172,CV Raman Nagar,32650,26790,5860,0.17947932618683002,1
9172,9173,Shivajinagar,426550,141890,284660,0.6673543547063651,0
9173,9174,Horamavu,331000,55350,275650,0.8327794561933535,0
9174,9175,CV Raman Nagar,393400,28390,365010,0.9278342653787494,-1
9175,9176,Vasanth Nagar,188800,8270,180530,0.9561970338983051,-1
9176,9177,Mahadevapura,176300,77600,98700,0.5598411798071469,1
9177,9178,Hebbal,185950,65780,120170,0.646248991664426,0
9178,9179,Indiranagar,229000,51300,177700,0.7759825327510917,0
9179,9180,Rajajinagar,60750,58550,2200,0.03621399176954732,1
9180,9181,Marathahalli,335350,64050,271300,0.8090055166244222,-1
9181,9182,Kalyan Nagar,396850,56020,340830,0.8588383520221746,-1
9182,9183,Hoodi,382150,82750,299400,0.7834619913646473,0
9183,9184,Vasanth Nagar,307000,51390,255610,0.8326058631921824,-1
9184,9185,Hebbal,204450,93160,111290,0.5443384690633407,0
9185,9186,Krishnarajapuram,37700,53750,-16050,-0.42572944297082227,1
9186,9187,Rajajinagar,300950,100080,200870,0.6674530652932381,0
9187,9188,Krishnarajapuram,44150,58780,-14630,-0.33137032842582104,1
9188,9189,HBR Layout,270050,740,269310,0.9972597667098685,-1
9189,9190,Horamavu,201450,52640,148810,0.7386944651278233,0
9190,9191,Jalahalli,337050,42630,294420,0.8735202492211838,0
9191,9192,Whitefield,431050,99040,332010,0.7702354715230252,-1
9192,9193,Mahadevapura,290650,92420,198230,0.682023051780492,0
9193,9194,CV Raman Nagar,382500,60110,322390,0.8428496732026144,-1
9194,9195,Krishnarajapuram,71250,86430,-15180,-0.21305263157894735,1
9195,9196,Rajajinagar,352600,52400,300200,0.8513896766874646,-1
9196,9197,Hebbal,128750,107380,21370,0.16598058252427184,1
9197,9198,Whitefield,215500,122240,93260,0.4327610208816705,0
9198,9199,Whitefield,238000,182490,55510,0.23323529411764707,1
9199,9200,Banaswadi,167600,87390,80210,0.4785799522673031,1
9200,9201,Shivajinagar,248050,86770,161280,0.6501914936504737,0
9201,9202,Jalahalli,405400,61440,343960,0.8484459792797238,-1
9202,9203,Whitefield,175150,78660,96490,0.5508992292320868,1
9203,9204,Malleswaram,64900,80030,-15130,-0.23312788906009246,1
9204,9205,Rajajinagar,385300,93750,291550,0.7566831040747469,-1
9205,9206,Malleswaram,301050,30590,270460,0.8983889719315729,-1
9206,9207,Vasanth Nagar,45300,39280,6020,0.13289183222958056,1
9207,9208,Varthur,192450,8570,183880,0.9554689529747986,-1
9208,9209,Jalahalli,286050,38690,247360,0.8647439258870827,0
9209,9210,Malleswaram,102450,76670,25780,0.251634943875061,1
9210,9211,Jalahalli,382650,133510,249140,0.6510910753952698,0
9211,9212,Varthur,182450,39140,143310,0.7854754727322554,-1
9212,9213,Kalyan Nagar,128750,145360,-16610,-0.12900970873786408,1
9213,9214,Shivajinagar,362050,34080,327970,0.9058693550614556,-1
9214,9215,Horamavu,388900,104270,284630,0.7318848032913345,0
9215,9216,Whitefield,163950,48290,115660,0.7054589813967673,0
9216,9217,Malleswaram,436850,82750,354100,0.8105757124871237,-1
9217,9218,Hoodi,357100,83990,273110,0.7647997759731168,-1
9218,9219,Kalyan Nagar,329700,46710,282990,0.8583257506824385,-1
9219,9220,CV Raman Nagar,91800,66810,24990,0.2722222222222222,1
9220,9221,Kalyan Nagar,113450,57130,56320,0.49643014543851915,1
9221,9222,Malleswaram,234950,1470,233480,0.9937433496488615,-1
9222,9223,Kammanahalli,129950,40540,89410,0.6880338591766064,0
9223,9224,Indiranagar,157050,52370,104680,0.6665393186883158,0
9224,9225,CV Raman Nagar,356500,105220,251280,0.7048527349228612,0
9225,9226,Varthur,200600,50780,149820,0.7468594217347956,0
9226,9227,Vasanth Nagar,132850,85390,47460,0.3572450131727512,1
9227,9228,Kalyan Nagar,39100,70290,-31190,-0.7976982097186701,1
9228,9229,CV Raman Nagar,60950,39670,21280,0.3491386382280558,1
9229,9230,Kalyan Nagar,434750,110350,324400,0.7461759631972398,0
9230,9231,Marathahalli,163750,109660,54090,0.3303206106870229,1
9231,9232,HBR Layout,389100,43120,345980,0.8891801593420714,-1
9232,9233,Varthur,110200,71970,38230,0.3469147005444646,1
9233,9234,Jalahalli,249350,43630,205720,0.8250250651694405,-1
9234,9235,Jalahalli,322650,15970,306680,0.9505036417170308,-1
9235,9236,Hoodi,166950,89080,77870,0.46642707397424377,0
9236,9237,Krishnarajapuram,293950,132440,161510,0.5494471848953904,0
9237,9238,CV Raman Nagar,324600,81850,242750,0.7478434996919285,-1
9238,9239,Krishnarajapuram,153600,53390,100210,0.6524088541666667,0
9239,9240,Varthur,309700,49010,260690,0.8417500807232806,-1
9240,9241,Vasanth Nagar,448650,59480,389170,0.8674244957093503,0
9241,9242,Malleswaram,437250,88330,348920,0.7979874213836478,-1
9242,9243,Rajajinagar,439700,43070,396630,0.9020468501250852,-1
9243,9244,Marathahalli,192850,36060,156790,0.8130152968628468,-1
9244,9245,Kalyan Nagar,186900,110840,76060,0.40695559122525415,1
9245,9246,Vasanth Nagar,184350,109200,75150,0.4076484947111473,1
9246,9247,Mahadevapura,422950,35270,387680,0.9166095283130393,-1
9247,9248,Hebbal,265300,52140,213160,0.8034677723332077,-1
9248,9249,Banaswadi,446300,115850,330450,0.7404212413174994,0
9249,9250,Vasanth Nagar,75250,44260,30990,0.4118272425249169,1
9250,9251,Kalyan Nagar,403400,52770,350630,0.8691869112543381,-1
9251,9252,Rajajinagar,448900,43460,405440,0.9031855647137447,-1
9252,9253,Vasanth Nagar,236350,58780,177570,0.7513010365982653,-1
9253,9254,Indiranagar,359150,73360,285790,0.7957399415286092,0
9254,9255,Malleswaram,55900,80350,-24450,-0.43738819320214667,1
9255,9256,CV Raman Nagar,335600,74040,261560,0.7793802145411204,0
9256,9257,Krishnarajapuram,404550,55580,348970,0.8626127796316896,-1
9257,9258,Jalahalli,372100,59960,312140,0.8388605213652244,-1
9258,9259,Mahadevapura,58750,16830,41920,0.713531914893617,0
9259,9260,CV Raman Nagar,217300,33590,183710,0.845421076852278,0
9260,9261,Marathahalli,307750,43660,264090,0.8581316003249391,-1
9261,9262,Whitefield,39000,61320,-22320,-0.5723076923076923,1
9262,9263,Vasanth Nagar,348950,118410,230540,0.6606677174380283,0
9263,9264,Horamavu,187700,119460,68240,0.3635588705380927,1
9264,9265,Vasanth Nagar,60100,14520,45580,0.7584026622296173,0
9265,9266,Hoodi,281650,60330,221320,0.7857979762116102,0
9266,9267,Jalahalli,174700,81830,92870,0.5315970234688037,1
9267,9268,Varthur,297850,88500,209350,0.7028705724357899,-1
9268,9269,Rajajinagar,417950,74400,343550,0.8219882761095825,-1
9269,9270,Krishnarajapuram,25350,25880,-530,-0.020907297830374753,1
9270,9271,Hebbal,296800,115200,181600,0.6118598382749326,0
9271,9272,Whitefield,314700,53930,260770,0.8286304416904989,0
9272,9273,Shivajinagar,415200,102320,312880,0.7535645472061657,-1
9273,9274,Whitefield,336150,30340,305810,0.909742674401309,-1
9274,9275,Kalyan Nagar,165400,38810,126590,0.7653567110036276,-1
9275,9276,Mahadevapura,337350,30910,306440,0.9083740921891211,-1
9276,9277,Whitefield,185700,126980,58720,0.3162089391491653,1
9277,9278,Rajajinagar,270550,0,270550,1.0,-1
9278,9279,Horamavu,110550,22980,87570,0.7921302578018996,0
9279,9280,Banaswadi,439400,46650,392750,0.8938324988620847,-1
9280,9281,Malleswaram,424850,39330,385520,0.9074261504060257,-1
9281,9282,Horamavu,281250,45550,235700,0.8380444444444445,0
9282,9283,Rajajinagar,160100,136130,23970,0.14971892567145534,1
9283,9284,Krishnarajapuram,327850,52890,274960,0.8386762238828732,0
9284,9285,Vasanth Nagar,198350,10970,187380,0.9446937232165364,-1
9285,9286,Mahadevapura,256600,20240,236360,0.9211223694466095,-1
9286,9287,Kammanahalli,217700,28300,189400,0.8700045934772623,-1
9287,9288,Indiranagar,262150,51990,210160,0.801678428380698,-1
9288,9289,Jalahalli,67400,66940,460,0.006824925816023739,1
9289,9290,Mahadevapura,322300,44080,278220,0.8632330127210673,-1
9290,9291,Rajajinagar,321950,36680,285270,0.8860692654138841,0
9291,9292,Jalahalli,259200,101390,157810,0.6088348765432099,0
9292,9293,Horamavu,329400,21700,307700,0.9341226472374013,-1
9293,9294,HBR Layout,144500,29020,115480,0.7991695501730104,-1
9294,9295,Shivajinagar,183450,31650,151800,0.8274734260016353,-1
9295,9296,Horamavu,431350,56470,374880,0.8690854294656312,-1
9296,9297,Vasanth Nagar,392000,35220,356780,0.9101530612244898,-1
9297,9298,Malleswaram,96300,88290,8010,0.08317757009345794,1
9298,9299,Malleswaram,407300,91710,315590,0.7748342744905475,0
9299,9300,Shivajinagar,208950,102310,106640,0.510361330461833,1
9300,9301,Rajajinagar,237600,69860,167740,0.7059764309764309,-1
9301,9302,Kalyan Nagar,444850,44350,400500,0.9003034730808137,-1
9302,9303,HBR Layout,321000,115400,205600,0.6404984423676012,0
9303,9304,Malleswaram,256850,55170,201680,0.7852053727856726,0
9304,9305,Hoodi,126900,20360,106540,0.839558707643814,-1
9305,9306,Kalyan Nagar,282650,74770,207880,0.7354678931540775,0
9306,9307,Indiranagar,287750,60910,226840,0.7883231972198088,0
9307,9308,Varthur,129050,103140,25910,0.20077489345215033,1
9308,9309,Varthur,279350,103910,175440,0.6280293538571684,0
9309,9310,Jalahalli,175850,48010,127840,0.7269832243389253,0
9310,9311,Krishnarajapuram,340200,116150,224050,0.6585831863609641,0
9311,9312,Shivajinagar,34100,115690,-81590,-2.3926686217008797,1
9312,9313,Rajajinagar,370000,125500,244500,0.6608108108108108,0
9313,9314,Varthur,318800,14650,304150,0.9540464240903388,-1
9314,9315,Vasanth Nagar,321500,80930,240570,0.7482737169517885,-1
9315,9316,Marathahalli,250050,149930,100120,0.4003999200159968,1
9316,9317,Jalahalli,236750,36300,200450,0.8466737064413938,0
9317,9318,Jalahalli,411750,123750,288000,0.6994535519125683,0
9318,9319,Vasanth Nagar,141800,114980,26820,0.18913963328631875,1
9319,9320,Krishnarajapuram,297950,50150,247800,0.8316831683168316,0
9320,9321,Kammanahalli,322400,54540,267860,0.8308312655086849,-1
9321,9322,Mahadevapura,105500,63580,41920,0.39734597156398105,1
9322,9323,CV Raman Nagar,236300,27710,208590,0.8827338129496403,0
9323,9324,Kalyan Nagar,274400,74160,200240,0.7297376093294461,0
9324,9325,Malleswaram,101600,80640,20960,0.2062992125984252,1
9325,9326,Indiranagar,428100,15420,412680,0.9639803784162578,-1
9326,9327,Kammanahalli,440000,11040,428960,0.974909090909091,-1
9327,9328,Vasanth Nagar,308150,58680,249470,0.8095732597760831,-1
9328,9329,Jalahalli,307500,80890,226610,0.7369430894308943,0
9329,9330,Mahadevapura,441950,84140,357810,0.8096164724516348,-1
9330,9331,Banaswadi,337000,82430,254570,0.7554005934718101,0
9331,9332,Horamavu,169550,22070,147480,0.8698319079917428,0
9332,9333,Horamavu,305000,94520,210480,0.6900983606557377,0
9333,9334,HBR Layout,426600,4730,421870,0.9889123300515705,-1
9334,9335,Vasanth Nagar,126450,72040,54410,0.4302886516409648,1
9335,9336,Jalahalli,141000,129580,11420,0.08099290780141843,1
9336,9337,Kalyan Nagar,191550,63200,128350,0.6700600365439833,0
9337,9338,Hebbal,179450,6410,173040,0.964279743661187,-1
9338,9339,Whitefield,42600,43890,-1290,-0.03028169014084507,1
9339,9340,Whitefield,105300,47870,57430,0.5453941120607787,0
9340,9341,Horamavu,219000,71460,147540,0.6736986301369863,0
9341,9342,Kammanahalli,44950,21040,23910,0.5319243604004449,1
9342,9343,Hebbal,52500,57320,-4820,-0.09180952380952381,1
9343,9344,Rajajinagar,127900,52910,74990,0.5863174354964816,0
9344,9345,Shivajinagar,365100,37630,327470,0.896932347302109,-1
9345,9346,Mahadevapura,375500,30790,344710,0.9180026631158456,-1
9346,9347,Krishnarajapuram,317100,71940,245160,0.7731315042573321,-1
9347,9348,Kalyan Nagar,237450,90570,146880,0.6185723310170562,0
9348,9349,Vasanth Nagar,233500,118430,115070,0.4928051391862955,1
9349,9350,Rajajinagar,246550,66690,179860,0.7295071993510445,0
9350,9351,Malleswaram,146100,87460,58640,0.40136892539356606,0
9351,9352,Vasanth Nagar,96300,36240,60060,0.6236760124610592,0
9352,9353,CV Raman Nagar,257100,35520,221580,0.8618436406067678,-1
9353,9354,Kammanahalli,413850,72460,341390,0.8249124078772502,0
9354,9355,Vasanth Nagar,242550,76760,165790,0.683529169243455,0
9355,9356,Kammanahalli,72750,40950,31800,0.43711340206185567,1
9356,9357,Whitefield,315800,68610,247190,0.7827422419252692,0
9357,9358,HBR Layout,243100,41890,201210,0.8276840806252571,-1
9358,9359,Vasanth Nagar,232900,116010,116890,0.5018892228424217,0
9359,9360,Vasanth Nagar,449900,16940,432960,0.9623471882640586,-1
9360,9361,HBR Layout,407700,60070,347630,0.8526612705420652,-1
9361,9362,Kammanahalli,225400,46980,178420,0.7915705412599823,0
9362,9363,HBR Layout,393400,77100,316300,0.8040162684290798,-1
9363,9364,Malleswaram,78650,56120,22530,0.2864589955499046,1
9364,9365,Mahadevapura,418600,49890,368710,0.8808170090778786,-1
9365,9366,Horamavu,304250,90330,213920,0.7031059983566146,0
9366,9367,Hoodi,74250,111650,-37400,-0.5037037037037037,1
9367,9368,Vasanth Nagar,56850,72830,-15980,-0.2810905892700088,1
9368,9369,Banaswadi,298100,131320,166780,0.5594766856759477,1
9369,9370,Marathahalli,200550,22100,178450,0.8898030416355024,-1
9370,9371,Indiranagar,411000,102800,308200,0.7498783454987834,0
9371,9372,Kalyan Nagar,351000,45330,305670,0.8708547008547008,-1
9372,9373,Kalyan Nagar,407100,64590,342510,0.8413411938098747,0
9373,9374,Mahadevapura,149650,92770,56880,0.3800868693618443,1
9374,9375,Jalahalli,123000,60870,62130,0.5051219512195122,0
9375,9376,Hebbal,384350,68960,315390,0.8205802003382334,-1
9376,9377,Marathahalli,167900,90280,77620,0.4622989874925551,0
9377,9378,Marathahalli,118550,54400,64150,0.541121889498102,1
9378,9379,Whitefield,229500,51140,178360,0.7771677559912854,0
9379,9380,Mahadevapura,425550,94800,330750,0.7772294677476207,-1
9380,9381,HBR Layout,367300,28920,338380,0.9212632725292677,-1
9381,9382,Kammanahalli,325450,64610,260840,0.8014748809340912,0
9382,9383,Horamavu,246300,71780,174520,0.7085667884693463,0
9383,9384,Banaswadi,284200,34260,249940,0.87945109078114,-1
9384,9385,Varthur,349650,68700,280950,0.8035178035178036,0
9385,9386,Marathahalli,166550,10860,155690,0.9347943560492344,-1
9386,9387,Malleswaram,218850,65240,153610,0.7018962759881198,0
9387,9388,Varthur,336750,28880,307870,0.9142390497401633,-1
9388,9389,Kammanahalli,335700,57250,278450,0.8294608281203455,-1
9389,9390,Marathahalli,192950,19090,173860,0.901062451412283,-1
9390,9391,Hebbal,391900,47290,344610,0.8793314621076805,0
9391,9392,Shivajinagar,398450,88150,310300,0.7787677249341197,-1
9392,9393,Marathahalli,271750,134800,136950,0.5039558417663293,0
9393,9394,Kalyan Nagar,181150,99890,81260,0.44857852608335635,0
9394,9395,Jalahalli,370250,34180,336070,0.9076839972991222,-1
9395,9396,Krishnarajapuram,252450,36240,216210,0.8564468211527035,-1
9396,9397,CV Raman Nagar,325550,69800,255750,0.7855936108124713,-1
9397,9398,Kammanahalli,421150,43660,377490,0.8963314733467885,-1
9398,9399,Whitefield,40600,56590,-15990,-0.3938423645320197,1
9399,9400,Whitefield,404300,78300,326000,0.806331931733861,-1
9400,9401,Jalahalli,308850,36310,272540,0.8824348389185689,-1
9401,9402,Jalahalli,71350,45180,26170,0.36678346180798876,1
9402,9403,Whitefield,351050,17670,333380,0.9496652898447515,-1
9403,9404,CV Raman Nagar,407450,47240,360210,0.8840593937906491,-1
9404,9405,Horamavu,151350,61290,90060,0.5950445986124876,0
9405,9406,Varthur,328700,66160,262540,0.7987222391238211,0
9406,9407,Shivajinagar,250600,59390,191210,0.7630087789305666,0
9407,9408,Rajajinagar,192500,151360,41140,0.21371428571428572,1
9408,9409,Horamavu,351300,28770,322530,0.9181041844577285,-1
9409,9410,Hebbal,310250,44620,265630,0.8561804995970991,-1
9410,9411,Vasanth Nagar,257150,42660,214490,0.8341046082053276,-1
9411,9412,Hebbal,388750,65970,322780,0.8303022508038586,-1
9412,9413,Horamavu,408100,28740,379360,0.9295760842930654,-1
9413,9414,CV Raman Nagar,76500,158060,-81560,-1.0661437908496731,1
9414,9415,Hoodi,198550,32210,166340,0.837773860488542,-1
9415,9416,Shivajinagar,214150,77800,136350,0.6367032453887462,0
9416,9417,Varthur,363800,58630,305170,0.8388400219901044,-1
9417,9418,Shivajinagar,233950,68160,165790,0.7086556956614661,-1
9418,9419,Marathahalli,134500,90360,44140,0.32817843866171004,1
9419,9420,Jalahalli,430800,124510,306290,0.7109795728876509,-1
9420,9421,CV Raman Nagar,176400,73080,103320,0.5857142857142857,1
9421,9422,Marathahalli,208900,21820,187080,0.8955481091431307,-1
9422,9423,Indiranagar,268850,71010,197840,0.7358750232471638,0
9423,9424,Varthur,247950,102500,145450,0.5866102036700948,0
9424,9425,Rajajinagar,242100,34790,207310,0.8562990499793474,0
9425,9426,CV Raman Nagar,142850,83790,59060,0.4134406720336017,1
9426,9427,Rajajinagar,192000,84960,107040,0.5575,0
9427,9428,Banaswadi,85800,61060,24740,0.28834498834498834,1
9428,9429,Whitefield,337150,22280,314870,0.9339166543081714,-1
9429,9430,Varthur,345800,97870,247930,0.7169751301330248,-1
9430,9431,Jalahalli,404250,60300,343950,0.850834879406308,-1
9431,9432,Rajajinagar,221300,84290,137010,0.6191143244464528,0
9432,9433,Indiranagar,229200,67080,162120,0.7073298429319371,0
9433,9434,Jalahalli,314700,53870,260830,0.828821099459803,0
9434,9435,Mahadevapura,366150,18950,347200,0.9482452546770449,-1
9435,9436,Hebbal,279450,34660,244790,0.8759706566469851,-1
9436,9437,Hoodi,289800,44890,244910,0.8451000690131125,-1
9437,9438,Kalyan Nagar,140750,48830,91920,0.6530728241563055,0
9438,9439,Hoodi,366600,66530,300070,0.8185215493726132,0
9439,9440,CV Raman Nagar,319150,10670,308480,0.9665674447751841,-1
9440,9441,Rajajinagar,327700,60480,267220,0.8154409520903265,0
9441,9442,Hoodi,105800,31050,74750,0.7065217391304348,0
9442,9443,Indiranagar,376850,48710,328140,0.8707443279819557,-1
9443,9444,Horamavu,383650,62260,321390,0.8377166688387854,-1
9444,9445,Indiranagar,340650,50820,289830,0.850814619110524,-1
9445,9446,Horamavu,320900,73770,247130,0.7701153007167342,0
9446,9447,HBR Layout,330100,69230,260870,0.7902756740381702,0
9447,9448,Rajajinagar,414750,103520,311230,0.7504038577456299,-1
9448,9449,Whitefield,331850,91400,240450,0.7245743558836824,0
9449,9450,Malleswaram,36200,123990,-87790,-2.4251381215469614,1
9450,9451,Rajajinagar,380050,84790,295260,0.776897776608341,-1
9451,9452,Jalahalli,262600,81800,180800,0.6884996191926885,0
9452,9453,Shivajinagar,270100,143800,126300,0.46760459089226214,1
9453,9454,CV Raman Nagar,44100,65750,-21650,-0.4909297052154195,1
9454,9455,Shivajinagar,152600,81260,71340,0.4674967234600262,1
9455,9456,Jalahalli,37150,45150,-8000,-0.21534320323014805,1
9456,9457,Whitefield,243300,53530,189770,0.7799835593916975,0
9457,9458,Horamavu,394850,78810,316040,0.8004052171710776,-1
9458,9459,Whitefield,175650,41070,134580,0.7661827497865072,0
9459,9460,HBR Layout,163400,83680,79720,0.4878824969400245,1
9460,9461,Varthur,347600,61980,285620,0.8216915995397008,-1
9461,9462,Kalyan Nagar,328200,49660,278540,0.8486898232784887,-1
9462,9463,Hoodi,145400,134890,10510,0.07228335625859697,1
9463,9464,Whitefield,341750,56920,284830,0.8334455010972933,-1
9464,9465,Malleswaram,313400,87190,226210,0.7217932354818124,-1
9465,9466,Mahadevapura,33250,54920,-21670,-0.6517293233082707,1
9466,9467,Horamavu,283600,33820,249780,0.8807475317348378,-1
9467,9468,Varthur,188050,118950,69100,0.3674554639723478,1
9468,9469,Indiranagar,444300,65530,378770,0.8525095656088229,-1
9469,9470,Marathahalli,288150,61560,226590,0.7863612701717855,0
9470,9471,Horamavu,37600,49640,-12040,-0.3202127659574468,1
9471,9472,Kalyan Nagar,312950,89020,223930,0.7155456143153859,-1
9472,9473,Varthur,184900,64930,119970,0.6488372093023256,0
9473,9474,Vasanth Nagar,26800,145410,-118610,-4.425746268656717,1
9474,9475,Krishnarajapuram,337400,72710,264690,0.7844991108476586,-1
9475,9476,Hoodi,157450,137850,19600,0.12448396316290886,1
9476,9477,Shivajinagar,396350,34690,361660,0.9124763466633027,-1
9477,9478,Kammanahalli,291850,70690,221160,0.7577865341785164,0
9478,9479,Kammanahalli,219950,124930,95020,0.43200727438054104,1
9479,9480,Hebbal,262550,100180,162370,0.6184345838887831,0
9480,9481,Hoodi,171900,31240,140660,0.8182664339732403,-1
9481,9482,Whitefield,412650,97590,315060,0.7635041802980734,0
9482,9483,Varthur,247500,16030,231470,0.9352323232323232,-1
9483,9484,Krishnarajapuram,121800,59800,62000,0.5090311986863711,1
9484,9485,Vasanth Nagar,150650,124100,26550,0.1762363093262529,1
9485,9486,Horamavu,421000,37340,383660,0.9113064133016627,-1
9486,9487,Malleswaram,273150,41930,231220,0.8464946000366099,-1
9487,9488,HBR Layout,97850,43080,54770,0.5597342871742463,0
9488,9489,Horamavu,280300,87240,193060,0.68876204067071,0
9489,9490,Hebbal,172100,50330,121770,0.7075537478210343,0
9490,9491,Banaswadi,349500,64640,284860,0.8150500715307583,0
9491,9492,Kalyan Nagar,328100,70130,257970,0.7862541907954892,-1
9492,9493,Mahadevapura,219600,92660,126940,0.5780510018214936,0
9493,9494,Kammanahalli,85050,35790,49260,0.5791887125220458,0
9494,9495,Jalahalli,347750,58740,289010,0.8310855499640546,-1
9495,9496,Vasanth Nagar,190450,113440,77010,0.4043580992386453,1
9496,9497,Krishnarajapuram,37300,86880,-49580,-1.3292225201072385,1
9497,9498,Vasanth Nagar,153550,65850,87700,0.5711494627157278,0
9498,9499,Marathahalli,143100,79740,63360,0.4427672955974843,0
9499,9500,Hoodi,373750,39250,334500,0.8949832775919733,0
9500,9501,Varthur,113200,90700,22500,0.19876325088339222,1
9501,9502,CV Raman Nagar,152750,105130,47620,0.31175122749590833,1
9502,9503,CV Raman Nagar,146200,68680,77520,0.5302325581395348,0
9503,9504,Hoodi,148850,128680,20170,0.13550554249244207,1
9504,9505,Malleswaram,328750,43950,284800,0.8663117870722433,-1
9505,9506,Kammanahalli,347950,103250,244700,0.7032619629257078,0
9506,9507,HBR Layout,86200,30780,55420,0.64292343387471,0
9507,9508,Horamavu,259000,113080,145920,0.5633976833976834,1
9508,9509,Kalyan Nagar,329950,51630,278320,0.8435217457190484,0
9509,9510,Banaswadi,380050,14640,365410,0.9614787527956847,-1
9510,9511,Indiranagar,265100,77240,187860,0.7086382497170879,-1
9511,9512,Vasanth Nagar,203950,110190,93760,0.4597205197352292,1
9512,9513,Krishnarajapuram,194050,48730,145320,0.7488791548569956,-1
9513,9514,Banaswadi,421650,33150,388500,0.9213802917111348,-1
9514,9515,Banaswadi,223550,36000,187550,0.8389622008499217,0
9515,9516,Vasanth Nagar,123400,66030,57370,0.4649108589951378,1
9516,9517,Kammanahalli,39200,64620,-25420,-0.648469387755102,1
9517,9518,Marathahalli,351650,48150,303500,0.863074079340253,0
9518,9519,Marathahalli,233650,40230,193420,0.8278193879734645,-1
9519,9520,Hebbal,156200,92760,63440,0.406145966709347,0
9520,9521,Indiranagar,149900,50510,99390,0.6630420280186792,0
9521,9522,Banaswadi,370750,27450,343300,0.9259608900876601,-1
9522,9523,Indiranagar,310500,65600,244900,0.7887278582930757,0
9523,9524,HBR Layout,314450,106310,208140,0.6619176339640642,0
9524,9525,HBR Layout,107800,120330,-12530,-0.11623376623376623,1
9525,9526,HBR Layout,168850,42080,126770,0.7507847201658276,0
9526,9527,Varthur,313700,36240,277460,0.8844756136436085,-1
9527,9528,Vasanth Nagar,286850,103820,183030,0.6380686770088897,0
9528,9529,Whitefield,379450,132360,247090,0.6511793385162735,0
9529,9530,Kammanahalli,317050,56710,260340,0.8211323135152184,0
9530,9531,Mahadevapura,92450,44730,47720,0.516170903190914,0
9531,9532,Banaswadi,304850,42770,262080,0.8597014925373134,-1
9532,9533,Horamavu,391500,96800,294700,0.7527458492975735,0
9533,9534,Shivajinagar,197300,65660,131640,0.6672072985301571,0
9534,9535,Indiranagar,90750,93580,-2830,-0.03118457300275482,1
9535,9536,Malleswaram,419550,90100,329450,0.7852460970086999,0
9536,9537,Varthur,382650,76950,305700,0.7989023912191298,-1
9537,9538,Hoodi,144900,25460,119440,0.8242926155969634,-1
9538,9539,CV Raman Nagar,302850,76230,226620,0.7482912332838039,-1
9539,9540,Jalahalli,297600,79020,218580,0.7344758064516129,0
9540,9541,Mahadevapura,347500,81910,265590,0.7642877697841727,0
9541,9542,Kammanahalli,147650,27090,120560,0.8165255672197765,-1
9542,9543,Hebbal,349950,106430,243520,0.6958708386912416,0
9543,9544,Kammanahalli,112250,15590,96660,0.8611135857461024,-1
9544,9545,Mahadevapura,102550,46040,56510,0.5510482691370063,1
9545,9546,Kammanahalli,376250,50170,326080,0.8666578073089701,-1
9546,9547,Jalahalli,38850,76630,-37780,-0.9724581724581725,1
9547,9548,Horamavu,277000,80650,196350,0.7088447653429603,-1
9548,9549,Horamavu,256500,114470,142030,0.5537231968810916,0
9549,9550,Vasanth Nagar,351350,36520,314830,0.896058061761776,-1
9550,9551,Banaswadi,331050,24740,306310,0.9252680863917837,-1
9551,9552,Malleswaram,111600,13130,98470,0.8823476702508961,-1
9552,9553,Whitefield,142050,74610,67440,0.4747624076029567,1
9553,9554,Vasanth Nagar,191150,0,191150,1.0,-1
9554,9555,Shivajinagar,390650,170520,220130,0.5634967362088826,0
9555,9556,Kammanahalli,199450,113370,86080,0.43158686387565803,1
9556,9557,Rajajinagar,382950,84810,298140,0.7785350567959264,0
9557,9558,Jalahalli,299950,52220,247730,0.825904317386231,0
9558,9559,Jalahalli,230350,17220,213130,0.9252441936184068,-1
9559,9560,Mahadevapura,251750,75880,175870,0.6985898709036743,0
9560,9561,Hoodi,309950,80920,229030,0.7389256331666397,0
9561,9562,Rajajinagar,298200,73260,224940,0.7543259557344064,0
9562,9563,HBR Layout,352650,102950,249700,0.7080674890117681,0
9563,9564,Hebbal,424600,40640,383960,0.9042863871879416,-1
9564,9565,Vasanth Nagar,222150,77700,144450,0.650236326806212,0
9565,9566,Krishnarajapuram,284350,35260,249090,0.875997889924389,-1
9566,9567,HBR Layout,287250,19300,267950,0.9328111401218451,-1
9567,9568,Mahadevapura,333500,74490,259010,0.7766416791604198,0
9568,9569,Jalahalli,397200,20610,376590,0.9481117824773414,-1
9569,9570,HBR Layout,277850,47210,230640,0.8300881770739608,-1
9570,9571,Rajajinagar,384250,38920,345330,0.898711776187378,0
9571,9572,Kalyan Nagar,34800,92830,-58030,-1.667528735632184,1
9572,9573,Hoodi,199050,44080,154970,0.778548103491585,0
9573,9574,Indiranagar,100400,77890,22510,0.22420318725099603,1
9574,9575,Marathahalli,270000,54480,215520,0.7982222222222223,0
9575,9576,Jalahalli,76250,88750,-12500,-0.16393442622950818,1
9576,9577,Shivajinagar,395550,16880,378670,0.9573252433320693,-1
9577,9578,Shivajinagar,60700,59210,1490,0.024546952224052718,1
9578,9579,Indiranagar,101400,66500,34900,0.34418145956607493,1
9579,9580,Varthur,207150,73760,133390,0.6439295196717355,0
9580,9581,Banaswadi,228100,36460,191640,0.840157825515125,0
9581,9582,Horamavu,103400,75120,28280,0.2735009671179884,1
9582,9583,Varthur,26150,10260,15890,0.6076481835564054,0
9583,9584,Shivajinagar,268650,46840,221810,0.8256467522799181,0
9584,9585,Indiranagar,171200,4470,166730,0.9738901869158878,-1
9585,9586,CV Raman Nagar,393350,76080,317270,0.806584466759883,0
9586,9587,Kalyan Nagar,295050,55730,239320,0.8111167598712082,-1
9587,9588,Krishnarajapuram,101900,66330,35570,0.3490677134445535,1
9588,9589,Marathahalli,344450,92650,251800,0.7310204674118159,0
9589,9590,Shivajinagar,94150,50490,43660,0.4637280934678704,1
9590,9591,Hoodi,353350,139070,214280,0.6064242252723928,0
9591,9592,Horamavu,207650,120320,87330,0.4205634481098001,1
9592,9593,Indiranagar,380850,16530,364320,0.9565970854667192,-1
9593,9594,Kammanahalli,340400,64450,275950,0.8106639247943596,-1
9594,9595,Rajajinagar,38500,56090,-17590,-0.4568831168831169,1
9595,9596,HBR Layout,198350,29740,168610,0.8500630199142929,-1
9596,9597,Horamavu,262700,3920,258780,0.9850780357822612,-1
9597,9598,Hoodi,286250,96860,189390,0.6616244541484716,0
9598,9599,Hebbal,371300,149150,222150,0.5983032588203608,0
9599,9600,Malleswaram,91400,52980,38420,0.4203501094091904,1
9600,9601,Whitefield,137200,31680,105520,0.7690962099125365,0
9601,9602,Jalahalli,125400,37770,87630,0.6988038277511962,0
9602,9603,CV Raman Nagar,282700,112660,170040,0.6014856738592147,0
9603,9604,Whitefield,432700,22500,410200,0.9480009244280102,-1
9604,9605,Malleswaram,118350,119740,-1390,-0.011744824672581327,1
9605,9606,Mahadevapura,430800,88870,341930,0.7937093779015785,-1
9606,9607,Rajajinagar,219600,51540,168060,0.7653005464480874,0
9607,9608,Malleswaram,272050,7480,264570,0.9725050542179746,-1
9608,9609,Kalyan Nagar,87750,49590,38160,0.4348717948717949,1
9609,9610,Kammanahalli,437100,44500,392600,0.8981926332646991,-1
9610,9611,Kammanahalli,332250,110290,221960,0.6680511662904439,0
9611,9612,Kalyan Nagar,277700,13470,264230,0.9514944184371624,-1
9612,9613,Indiranagar,295500,42060,253440,0.8576649746192894,-1
9613,9614,Krishnarajapuram,247900,37220,210680,0.8498588140379185,0
9614,9615,Varthur,448800,71980,376820,0.8396167557932264,-1
9615,9616,Varthur,75950,83870,-7920,-0.10427913100724161,1
9616,9617,CV Raman Nagar,43350,82820,-39470,-0.9104959630911188,1
9617,9618,Shivajinagar,190550,60830,129720,0.6807662030963002,0
9618,9619,CV Raman Nagar,236250,67130,169120,0.7158518518518519,0
9619,9620,Kammanahalli,92500,81480,11020,0.11913513513513513,1
9620,9621,Marathahalli,316300,39120,277180,0.8763199494151123,-1
9621,9622,Hoodi,122000,51780,70220,0.5755737704918032,1
9622,9623,Kammanahalli,290000,60090,229910,0.7927931034482759,-1
9623,9624,CV Raman Nagar,28150,166210,-138060,-4.904440497335702,1
9624,9625,Kalyan Nagar,208000,59590,148410,0.7135096153846154,0
9625,9626,Hoodi,207450,87310,120140,0.5791275006025548,0
9626,9627,CV Raman Nagar,54050,146380,-92330,-1.7082331174838112,1
9627,9628,Hoodi,110350,5860,104490,0.9468962392387856,-1
9628,9629,Kalyan Nagar,37100,99560,-62460,-1.6835579514824799,1
9629,9630,Kammanahalli,419000,56820,362180,0.8643914081145585,-1
9630,9631,Marathahalli,421600,43240,378360,0.897438330170778,0
9631,9632,HBR Layout,250150,68340,181810,0.7268039176494103,-1
9632,9633,Indiranagar,80100,41270,38830,0.48476903870162297,0
9633,9634,Horamavu,275050,105680,169370,0.6157789492819488,0
9634,9635,Shivajinagar,395450,51770,343680,0.8690858515615122,-1
9635,9636,Vasanth Nagar,399100,88930,310170,0.777173640691556,0
9636,9637,Mahadevapura,232200,39760,192440,0.8287683031869079,-1
9637,9638,Mahadevapura,112100,68320,43780,0.3905441570026762,1
9638,9639,Horamavu,121150,45740,75410,0.6224515063970285,0
9639,9640,Kalyan Nagar,233600,24410,209190,0.8955051369863014,-1
9640,9641,Indiranagar,396850,57010,339840,0.8563437066901852,-1
9641,9642,CV Raman Nagar,215450,142070,73380,0.34058946391274075,1
9642,9643,Malleswaram,135000,3170,131830,0.9765185185185186,-1
9643,9644,Mahadevapura,192800,84500,108300,0.5617219917012448,0
9644,9645,Krishnarajapuram,331050,60560,270490,0.8170669083220058,-1
9645,9646,Shivajinagar,194350,6660,187690,0.9657319269359403,-1
9646,9647,Jalahalli,129800,123190,6610,0.050924499229583975,1
9647,9648,Varthur,55950,103130,-47180,-0.8432529043789098,1
9648,9649,Shivajinagar,107500,39840,67660,0.6293953488372093,0
9649,9650,Hoodi,441950,51740,390210,0.8829279330240978,-1
9650,9651,HBR Layout,65350,16860,48490,0.7420045906656465,-1
9651,9652,Shivajinagar,33450,40300,-6850,-0.20478325859491778,1
9652,9653,Jalahalli,118850,39150,79700,0.6705931846865797,0
9653,9654,Vasanth Nagar,28850,110320,-81470,-2.823916811091854,1
9654,9655,Shivajinagar,236550,79330,157220,0.6646374973578525,0
9655,9656,Hoodi,225000,90250,134750,0.5988888888888889,0
9656,9657,Vasanth Nagar,83900,63380,20520,0.24457687723480334,1
9657,9658,Horamavu,192350,84320,108030,0.5616324408630101,0
9658,9659,HBR Layout,50600,29020,21580,0.42648221343873516,1
9659,9660,Kammanahalli,447850,137640,310210,0.6926649547839678,0
9660,9661,Horamavu,180750,46400,134350,0.7432918395573997,-1
9661,9662,Vasanth Nagar,347900,17790,330110,0.9488646162690428,-1
9662,9663,Mahadevapura,224850,117140,107710,0.4790304647542806,0
9663,9664,CV Raman Nagar,424350,72690,351660,0.8287027218098268,-1
9664,9665,Banaswadi,148250,173960,-25710,-0.17342327150084316,1
9665,9666,Whitefield,279950,79850,200100,0.714770494731202,0
9666,9667,HBR Layout,382000,76180,305820,0.8005759162303665,-1
9667,9668,Varthur,321400,86470,234930,0.7309583074051027,-1
9668,9669,Shivajinagar,217950,62910,155040,0.7113558155540262,0
9669,9670,Hoodi,206750,48920,157830,0.7633857315598549,0
9670,9671,Rajajinagar,194450,20350,174100,0.8953458472615068,-1
9671,9672,Vasanth Nagar,292450,100770,191680,0.6554282783381775,0
9672,9673,Vasanth Nagar,136650,55850,80800,0.5912916209293816,0
9673,9674,Whitefield,419300,45370,373930,0.891795850226568,0
9674,9675,HBR Layout,232700,55330,177370,0.7622260421143102,0
9675,9676,Whitefield,231750,20050,211700,0.9134843581445523,-1
9676,9677,Malleswaram,240700,76800,163900,0.6809306190278355,0
9677,9678,Krishnarajapuram,285700,56040,229660,0.8038501925096255,-1
9678,9679,HBR Layout,67250,54980,12270,0.18245353159851302,1
9679,9680,Jalahalli,223750,77160,146590,0.6551508379888268,0
9680,9681,Kalyan Nagar,405550,51610,353940,0.8727407224756504,-1
9681,9682,HBR Layout,403500,42110,361390,0.895638166047088,0
9682,9683,Malleswaram,55150,101680,-46530,-0.843699002719855,1
9683,9684,Indiranagar,54500,68890,-14390,-0.2640366972477064,1
9684,9685,Hebbal,105550,47000,58550,0.5547134059687352,1
9685,9686,Malleswaram,58550,84210,-25660,-0.4382578992314261,1
9686,9687,Hebbal,321500,141120,180380,0.5610575427682737,0
9687,9688,CV Raman Nagar,205850,94700,111150,0.5399562788438184,1
9688,9689,Hoodi,432000,88650,343350,0.7947916666666667,0
9689,9690,Malleswaram,413200,40730,372470,0.9014278799612778,-1
9690,9691,Shivajinagar,291300,51200,240100,0.8242361826295915,-1
9691,9692,Kalyan Nagar,232850,75980,156870,0.673695512132274,0
9692,9693,Banaswadi,111300,136630,-25330,-0.2275831087151842,1
9693,9694,Whitefield,130900,29710,101190,0.7730328495034378,0
9694,9695,CV Raman Nagar,150950,124700,26250,0.17389864193441537,1
9695,9696,Horamavu,131850,26360,105490,0.8000758437618506,-1
9696,9697,HBR Layout,171450,96240,75210,0.43867016622922134,0
9697,9698,Hebbal,421350,84140,337210,0.8003085320992049,-1
9698,9699,Jalahalli,323600,104300,219300,0.6776885043263288,0
9699,9700,Jalahalli,253300,55930,197370,0.7791946308724832,0
9700,9701,Malleswaram,229750,27120,202630,0.8819586507072905,-1
9701,9702,Kalyan Nagar,65100,35800,29300,0.4500768049155146,0
9702,9703,Hebbal,445250,106780,338470,0.7601796743402582,0
9703,9704,Indiranagar,122050,110100,11950,0.09791069233920524,1
9704,9705,Kammanahalli,292400,1900,290500,0.9935020519835841,-1
9705,9706,Banaswadi,271250,66840,204410,0.7535852534562212,0
9706,9707,Indiranagar,82500,54120,28380,0.344,1
9707,9708,Kalyan Nagar,136300,58600,77700,0.57006603081438,0
9708,9709,Rajajinagar,428550,44200,384350,0.8968615097421537,-1
9709,9710,HBR Layout,411400,18050,393350,0.9561254253767623,-1
9710,9711,Rajajinagar,32650,23480,9170,0.28085758039816233,1
9711,9712,Hebbal,385550,25700,359850,0.9333419789910518,-1
9712,9713,Mahadevapura,378050,68360,309690,0.8191773574923952,-1
9713,9714,Mahadevapura,403150,49410,353740,0.8774401587498449,-1
9714,9715,Indiranagar,159200,35040,124160,0.7798994974874371,-1
9715,9716,Jalahalli,184150,13370,170780,0.9273961444474613,-1
9716,9717,Kalyan Nagar,402650,40880,361770,0.8984726188997889,0
9717,9718,Indiranagar,253600,30410,223190,0.8800867507886435,0
9718,9719,Shivajinagar,423550,82510,341040,0.8051941919490024,-1
9719,9720,Marathahalli,382150,47580,334570,0.8754939160015701,-1
9720,9721,Mahadevapura,54850,37680,17170,0.3130355515041021,1
9721,9722,Whitefield,211250,55280,155970,0.7383195266272189,0
9722,9723,Kalyan Nagar,131350,81310,50040,0.3809668823753331,1
9723,9724,Rajajinagar,230400,74730,155670,0.6756510416666667,0
9724,9725,Kalyan Nagar,315200,48940,266260,0.8447335025380711,-1
9725,9726,Mahadevapura,87800,46350,41450,0.47209567198177677,1
9726,9727,Shivajinagar,426350,37690,388660,0.911598451976076,-1
9727,9728,Vasanth Nagar,425600,96760,328840,0.7726503759398496,0
9728,9729,Kalyan Nagar,79150,61580,17570,0.22198357548957676,1
9729,9730,Indiranagar,398900,23890,375010,0.940110303334169,-1
9730,9731,Hebbal,193800,102130,91670,0.4730134158926729,0
9731,9732,Indiranagar,26800,0,26800,1.0,-1
9732,9733,Shivajinagar,116350,78220,38130,0.327718091963902,1
9733,9734,Banaswadi,244300,95120,149180,0.6106426524764633,0
9734,9735,Jalahalli,383950,69740,314210,0.818361765854929,0
9735,9736,Horamavu,246850,36150,210700,0.8535547903585173,-1
9736,9737,Marathahalli,59400,97430,-38030,-0.6402356902356903,1
9737,9738,Marathahalli,314050,43440,270610,0.8616780767393727,-1
9738,9739,Krishnarajapuram,40750,91430,-50680,-1.243680981595092,1
9739,9740,Mahadevapura,108250,68320,39930,0.36886836027713626,1
9740,9741,Vasanth Nagar,175150,50670,124480,0.710705109905795,0
9741,9742,Kammanahalli,195950,28680,167270,0.8536361316662414,-1
9742,9743,Malleswaram,205550,79100,126450,0.6151787886159086,0
9743,9744,Indiranagar,316150,116200,199950,0.6324529495492646,0
9744,9745,Kammanahalli,436850,37020,399830,0.915256953187593,-1
9745,9746,Hebbal,263900,62220,201680,0.7642288745737021,0
9746,9747,Varthur,141400,101140,40260,0.2847241867043847,1
9747,9748,Rajajinagar,151900,77210,74690,0.49170506912442397,0
9748,9749,Horamavu,60800,65250,-4450,-0.07319078947368421,1
9749,9750,Kammanahalli,58950,14790,44160,0.7491094147582698,0
9750,9751,Indiranagar,175350,39140,136210,0.7767892785856858,-1
9751,9752,Shivajinagar,446950,44470,402480,0.9005034120147668,-1
9752,9753,Rajajinagar,181600,89970,91630,0.5045704845814978,1
9753,9754,Rajajinagar,324950,114330,210620,0.6481612555777811,0
9754,9755,Kammanahalli,437650,55690,381960,0.8727521992459728,0
9755,9756,Rajajinagar,74700,93930,-19230,-0.25742971887550203,1
9756,9757,CV Raman Nagar,325700,59680,266020,0.8167638931532085,-1
9757,9758,Vasanth Nagar,266200,110400,155800,0.585274229902329,1
9758,9759,Varthur,273000,96400,176600,0.6468864468864469,0
9759,9760,Marathahalli,340950,52570,288380,0.8458131690863763,0
9760,9761,Indiranagar,258450,87160,171290,0.6627587541110467,0
9761,9762,Marathahalli,216300,48570,167730,0.7754507628294036,-1
9762,9763,Banaswadi,412700,114440,298260,0.7227041434456022,0
9763,9764,Marathahalli,28150,97300,-69150,-2.4564831261101245,1
9764,9765,Jalahalli,111450,100320,11130,0.09986541049798116,1
9765,9766,Indiranagar,143200,24410,118790,0.8295391061452514,-1
9766,9767,Varthur,155250,52260,102990,0.6633816425120773,0
9767,9768,Shivajinagar,42600,80740,-38140,-0.8953051643192488,1
9768,9769,Shivajinagar,331200,106510,224690,0.6784118357487923,0
9769,9770,Hoodi,376950,43770,333180,0.883883804218066,-1
9770,9771,Hebbal,95950,71410,24540,0.25575820739968735,1
9771,9772,Krishnarajapuram,219550,33300,186250,0.848326121612389,0
9772,9773,CV Raman Nagar,419450,19170,400280,0.9542972940755752,-1
9773,9774,Jalahalli,178600,12460,166140,0.9302351623740202,-1
9774,9775,Shivajinagar,257750,86870,170880,0.6629679922405431,0
9775,9776,Krishnarajapuram,95650,43490,52160,0.5453214845791949,0
9776,9777,Kalyan Nagar,257000,109380,147620,0.5743968871595331,0
9777,9778,Krishnarajapuram,319150,33900,285250,0.8937803540654864,0
9778,9779,CV Raman Nagar,151150,59890,91260,0.6037710883228581,0
9779,9780,Jalahalli,221900,67720,154180,0.694817485353763,0
9780,9781,Whitefield,151850,93350,58500,0.38524860059269017,1
9781,9782,Hoodi,300450,96260,204190,0.6796139124646364,0
9782,9783,Mahadevapura,420000,59140,360860,0.8591904761904762,0
9783,9784,Shivajinagar,45000,66180,-21180,-0.4706666666666667,1
9784,9785,Indiranagar,323300,78870,244430,0.7560470151562017,0
9785,9786,Rajajinagar,265800,100730,165070,0.6210308502633559,0
9786,9787,Marathahalli,341350,28270,313080,0.9171817782334847,-1
9787,9788,Indiranagar,89250,58880,30370,0.34028011204481795,1
9788,9789,Shivajinagar,330750,31790,298960,0.9038851095993953,-1
9789,9790,Kalyan Nagar,293950,80030,213920,0.7277428134036401,-1
9790,9791,Whitefield,389200,66990,322210,0.8278776978417266,0
9791,9792,Rajajinagar,351750,72420,279330,0.7941151385927505,0
9792,9793,Banaswadi,427900,121590,306310,0.7158448235569058,-1
9793,9794,Krishnarajapuram,419250,129330,289920,0.691520572450805,0
9794,9795,Malleswaram,238600,80910,157690,0.660896898575021,0
9795,9796,CV Raman Nagar,354450,30570,323880,0.9137537029200169,-1
9796,9797,Krishnarajapuram,87200,23450,63750,0.7310779816513762,0
9797,9798,Hebbal,390650,43020,347630,0.8898758479457315,0
9798,9799,Malleswaram,251000,49230,201770,0.8038645418326693,-1
9799,9800,Rajajinagar,366150,3940,362210,0.9892393827666257,-1
9800,9801,Hebbal,315600,109700,205900,0.6524081115335868,0
9801,9802,Rajajinagar,268250,28630,239620,0.8932712022367195,-1
9802,9803,Varthur,262400,99960,162440,0.6190548780487805,0
9803,9804,Mahadevapura,107550,103380,4170,0.03877266387726639,1
9804,9805,Varthur,441700,57480,384220,0.8698664251754584,0
9805,9806,HBR Layout,182950,29500,153450,0.8387537578573381,-1
9806,9807,Hoodi,438450,64350,374100,0.8532329798152583,0
9807,9808,Malleswaram,218850,56360,162490,0.7424720127941512,0
9808,9809,Rajajinagar,307150,10870,296280,0.9646101253459222,-1
9809,9810,Shivajinagar,123800,48840,74960,0.6054927302100162,0
9810,9811,HBR Layout,390100,24160,365940,0.9380671622660857,-1
9811,9812,Krishnarajapuram,39100,49960,-10860,-0.2777493606138107,1
9812,9813,Banaswadi,173900,40950,132950,0.7645198389879241,0
9813,9814,Jalahalli,141400,66950,74450,0.5265205091937766,1
9814,9815,Jalahalli,363100,29960,333140,0.9174882952354724,-1
9815,9816,Whitefield,385300,71170,314130,0.8152867895146639,-1
9816,9817,Varthur,189500,140740,48760,0.25730870712401055,1
9817,9818,Kammanahalli,438650,35320,403330,0.9194802234127436,-1
9818,9819,Indiranagar,413800,51940,361860,0.8744804253262446,-1
9819,9820,Whitefield,262850,32420,230430,0.8766596918394521,0
9820,9821,Horamavu,226650,104980,121670,0.5368188837414516,0
9821,9822,Whitefield,119150,40690,78460,0.6584976919848929,0
9822,9823,Varthur,229550,115440,114110,0.49710302766281855,1
9823,9824,Kalyan Nagar,134450,55710,78740,0.5856452212718483,1
9824,9825,Rajajinagar,168050,45430,122620,0.7296637905385303,0
9825,9826,Marathahalli,363350,34890,328460,0.903976881794413,-1
9826,9827,Malleswaram,66450,87180,-20730,-0.31196388261851016,1
9827,9828,Kammanahalli,40950,99330,-58380,-1.4256410256410257,1
9828,9829,Vasanth Nagar,62750,61510,1240,0.019760956175298806,1
9829,9830,CV Raman Nagar,325650,47080,278570,0.8554276063258099,0
9830,9831,Varthur,443700,45990,397710,0.8963488843813388,0
9831,9832,Vasanth Nagar,199050,6180,192870,0.9689525244913338,-1
9832,9833,Varthur,98900,36150,62750,0.634479271991911,0
9833,9834,Whitefield,190900,12410,178490,0.9349921424829754,-1
9834,9835,HBR Layout,86650,24400,62250,0.7184073860357761,0
9835,9836,Banaswadi,116000,38140,77860,0.6712068965517242,0
9836,9837,Horamavu,151700,149340,2360,0.015557020435069216,1
9837,9838,Marathahalli,147100,13340,133760,0.9093133922501699,-1
9838,9839,Kalyan Nagar,354000,33470,320530,0.9054519774011299,-1
9839,9840,Kalyan Nagar,113500,57190,56310,0.49612334801762115,1
9840,9841,CV Raman Nagar,450000,42880,407120,0.9047111111111111,-1
9841,9842,Hoodi,194600,78730,115870,0.5954265159301131,0
9842,9843,HBR Layout,194600,139200,55400,0.2846865364850976,1
9843,9844,Kammanahalli,178900,21680,157220,0.8788149804359978,-1
9844,9845,Krishnarajapuram,422100,36450,385650,0.9136460554371002,-1
9845,9846,Vasanth Nagar,327650,47410,280240,0.8553029146955593,-1
9846,9847,Krishnarajapuram,187100,25870,161230,0.861731694281133,-1
9847,9848,Horamavu,180200,39850,140350,0.7788568257491676,-1
9848,9849,HBR Layout,302250,55410,246840,0.8166749379652606,-1
9849,9850,Mahadevapura,226400,132860,93540,0.4131625441696113,1
9850,9851,Malleswaram,307650,93500,214150,0.6960832114415733,0
9851,9852,Whitefield,355350,81120,274230,0.7717180244829042,0
9852,9853,Horamavu,44000,86630,-42630,-0.9688636363636364,1
9853,9854,Indiranagar,223650,65740,157910,0.7060585736642074,-1
9854,9855,Hoodi,311900,36260,275640,0.8837447899967938,-1
9855,9856,Hebbal,428100,62070,366030,0.855010511562719,0
9856,9857,Whitefield,319600,72050,247550,0.7745619524405507,0
9857,9858,Hebbal,320250,23420,296830,0.9268696330991413,-1
9858,9859,Rajajinagar,350150,88810,261340,0.7463658432100528,0
9859,9860,Whitefield,25900,45580,-19680,-0.7598455598455598,1
9860,9861,Krishnarajapuram,300850,89470,211380,0.7026092737244474,-1
9861,9862,HBR Layout,114350,51770,62580,0.5472671622212505,0
9862,9863,Indiranagar,220800,58410,162390,0.7354619565217392,0
9863,9864,CV Raman Nagar,410000,40610,369390,0.9009512195121951,-1
9864,9865,Indiranagar,131450,17430,114020,0.8674020540129327,-1
9865,9866,Banaswadi,447000,58300,388700,0.8695749440715884,-1
9866,9867,Vasanth Nagar,173900,47930,125970,0.7243818286371478,-1
9867,9868,Hebbal,268400,54670,213730,0.796311475409836,0
9868,9869,Mahadevapura,307450,96170,211280,0.6872011709221012,0
9869,9870,Whitefield,241450,31770,209680,0.8684199627252019,0
9870,9871,CV Raman Nagar,111950,37990,73960,0.6606520768200089,0
9871,9872,Kammanahalli,157750,69310,88440,0.5606339144215531,1
9872,9873,Hebbal,202750,70710,132040,0.651245376078915,0
9873,9874,Jalahalli,187450,74910,112540,0.6003734329154441,0
9874,9875,Marathahalli,388000,76750,311250,0.8021907216494846,0
9875,9876,Jalahalli,200450,124470,75980,0.3790471439261661,1
9876,9877,Kammanahalli,352300,73060,279240,0.792619926199262,-1
9877,9878,Kalyan Nagar,134600,82610,51990,0.3862555720653789,1
9878,9879,Shivajinagar,387200,33930,353270,0.912370867768595,-1
9879,9880,Hebbal,181850,36550,145300,0.7990101732196866,-1
9880,9881,Hebbal,69100,77370,-8270,-0.11968162083936325,1
9881,9882,Shivajinagar,251300,92070,159230,0.633625149224035,0
9882,9883,Mahadevapura,318650,99310,219340,0.6883414404519065,0
9883,9884,Mahadevapura,342200,49990,292210,0.8539158386908241,-1
9884,9885,Marathahalli,142750,27470,115280,0.8075656742556918,0
9885,9886,Vasanth Nagar,338650,34300,304350,0.8987154879669275,0
9886,9887,CV Raman Nagar,288150,53040,235110,0.815929203539823,-1
9887,9888,Varthur,357600,57970,299630,0.8378914988814318,-1
9888,9889,Krishnarajapuram,180250,68010,112240,0.6226907073509015,0
9889,9890,HBR Layout,172350,45060,127290,0.7385552654482158,-1
9890,9891,Banaswadi,173950,70520,103430,0.5945961483184823,0
9891,9892,Hebbal,326050,36950,289100,0.8866738230332771,0
9892,9893,Krishnarajapuram,174550,75420,99130,0.5679175021483815,0
9893,9894,Horamavu,188550,36340,152210,0.8072659771943782,0
9894,9895,CV Raman Nagar,425300,94890,330410,0.7768869033623325,0
9895,9896,Rajajinagar,219200,67690,151510,0.6911952554744526,0
9896,9897,Mahadevapura,233250,87140,146110,0.6264094319399786,0
9897,9898,Mahadevapura,335950,23580,312370,0.9298109837773478,-1
9898,9899,Kalyan Nagar,154200,22850,131350,0.8518158236057068,-1
9899,9900,HBR Layout,420450,28490,391960,0.9322392674515401,-1
9900,9901,Marathahalli,285450,83050,202400,0.7090558766859345,0
9901,9902,Mahadevapura,101100,75790,25310,0.2503461918892186,1
9902,9903,Jalahalli,418200,69640,348560,0.8334768053562889,-1
9903,9904,Rajajinagar,173700,16790,156910,0.9033390903857225,-1
9904,9905,Varthur,293750,51110,242640,0.8260085106382978,-1
9905,9906,CV Raman Nagar,112300,52790,59510,0.529919857524488,1
9906,9907,Marathahalli,141250,78220,63030,0.4462300884955752,1
9907,9908,Hoodi,406100,100610,305490,0.7522531396207831,0
9908,9909,CV Raman Nagar,45200,82050,-36850,-0.8152654867256637,1
9909,9910,Shivajinagar,93150,68320,24830,0.2665593129361245,1
9910,9911,Horamavu,26900,53570,-26670,-0.9914498141263941,1
9911,9912,Shivajinagar,441950,173450,268500,0.607534789003281,0
9912,9913,Horamavu,63500,14790,48710,0.7670866141732283,0
9913,9914,Vasanth Nagar,316400,71540,244860,0.7738938053097345,0
9914,9915,Kammanahalli,334150,87750,246400,0.7373933862038007,0
9915,9916,Horamavu,71400,76220,-4820,-0.06750700280112044,1
9916,9917,Vasanth Nagar,299250,61200,238050,0.7954887218045112,-1
9917,9918,Whitefield,347200,69940,277260,0.7985599078341014,0
9918,9919,Rajajinagar,324700,126390,198310,0.6107483831228827,0
9919,9920,Banaswadi,128300,86980,41320,0.3220576773187841,1
9920,9921,Varthur,446950,35990,410960,0.9194764515046425,-1
9921,9922,Shivajinagar,31100,56600,-25500,-0.819935691318328,1
9922,9923,Vasanth Nagar,338150,16480,321670,0.9512642318497708,-1
9923,9924,Vasanth Nagar,160400,49850,110550,0.689214463840399,0
9924,9925,CV Raman Nagar,102750,46420,56330,0.5482238442822385,1
9925,9926,Marathahalli,344750,63710,281040,0.8151994198694706,-1
9926,9927,Whitefield,38200,6520,31680,0.8293193717277487,-1
9927,9928,Vasanth Nagar,38450,38100,350,0.009102730819245773,1
9928,9929,Malleswaram,254300,21680,232620,0.9147463625639008,-1
9929,9930,Marathahalli,262900,85340,177560,0.6753898820844427,0
9930,9931,Marathahalli,170350,85250,85100,0.49955972996771353,1
9931,9932,Krishnarajapuram,40400,80340,-39940,-0.9886138613861386,1
9932,9933,Indiranagar,250600,83020,167580,0.6687150837988827,0
9933,9934,Jalahalli,267850,41020,226830,0.8468545827888744,-1
9934,9935,CV Raman Nagar,413200,36760,376440,0.9110358180058084,-1
9935,9936,Banaswadi,116500,87150,29350,0.251931330472103,1
9936,9937,Marathahalli,265050,42440,222610,0.8398792680626297,0
9937,9938,Banaswadi,365000,51910,313090,0.8577808219178082,0
9938,9939,Mahadevapura,364200,42710,321490,0.8827292696320703,0
9939,9940,Malleswaram,68650,42450,26200,0.381646030589949,1
9940,9941,Whitefield,432300,29350,402950,0.9321073328706917,-1
9941,9942,HBR Layout,370750,71590,299160,0.8069049224544842,-1
9942,9943,Kammanahalli,90350,75710,14640,0.16203652462645268,1
9943,9944,Marathahalli,184600,86160,98440,0.533261105092091,0
9944,9945,HBR Layout,276800,77540,199260,0.7198699421965318,-1
9945,9946,Horamavu,353200,31980,321220,0.9094563986409966,-1
9946,9947,Hoodi,185850,86380,99470,0.5352165725047081,1
9947,9948,CV Raman Nagar,351000,19620,331380,0.9441025641025641,-1
9948,9949,Hoodi,73600,97250,-23650,-0.32133152173913043,1
9949,9950,Horamavu,210950,64910,146040,0.6922967527850201,0
9950,9951,HBR Layout,334350,56400,277950,0.8313144908030506,0
9951,9952,Hebbal,122000,29650,92350,0.7569672131147541,0
9952,9953,Indiranagar,254050,15440,238610,0.939224562094076,-1
9953,9954,Rajajinagar,222250,59270,162980,0.733318335208099,-1
9954,9955,Hebbal,401350,69770,331580,0.8261617042481625,0
9955,9956,Horamavu,421050,47250,373800,0.8877805486284289,-1
9956,9957,CV Raman Nagar,26300,66370,-40070,-1.523574144486692,1
9957,9958,Hoodi,254050,3890,250160,0.9846880535327691,-1
9958,9959,Kalyan Nagar,445400,36590,408810,0.9178491243825775,-1
9959,9960,CV Raman Nagar,331050,59260,271790,0.8209938075819363,-1
9960,9961,Vasanth Nagar,32350,76980,-44630,-1.3795981452859352,1
9961,9962,Varthur,26900,66140,-39240,-1.458736059479554,1
9962,9963,Mahadevapura,442400,40040,402360,0.9094936708860759,-1
9963,9964,CV Raman Nagar,68150,83400,-15250,-0.22377109317681584,1
9964,9965,Hebbal,425850,67150,358700,0.8423153692614771,-1
9965,9966,Mahadevapura,280450,115940,164510,0.5865929755749688,1
9966,9967,HBR Layout,218050,70240,147810,0.6778720476954827,0
9967,9968,Kalyan Nagar,149150,83270,65880,0.4417029835735836,1
9968,9969,Whitefield,286800,48770,238030,0.8299511854951186,-1
9969,9970,Varthur,268450,90770,177680,0.6618737195008382,0
9970,9971,Hoodi,313100,71180,241920,0.7726604918556371,-1
9971,9972,Shivajinagar,118700,34510,84190,0.7092670598146588,0
9972,9973,CV Raman Nagar,38600,86970,-48370,-1.2531088082901554,1
9973,9974,Hebbal,102350,26200,76150,0.7440156326331216,-1
9974,9975,Vasanth Nagar,120900,56540,64360,0.5323407775020679,0
9975,9976,Mahadevapura,319050,47950,271100,0.8497100767904717,-1
9976,9977,Mahadevapura,281800,122910,158890,0.5638396025550035,0
9977,9978,Marathahalli,432050,67550,364500,0.8436523550514987,-1
9978,9979,Kalyan Nagar,377250,69310,307940,0.8162756792577867,0
9979,9980,Shivajinagar,428800,67780,361020,0.8419309701492538,0
9980,9981,Varthur,250000,48640,201360,0.80544,-1
9981,9982,Banaswadi,211950,27640,184310,0.8695918848785091,0
9982,9983,HBR Layout,261600,71570,190030,0.7264143730886851,-1
9983,9984,CV Raman Nagar,245300,42240,203060,0.8278026905829596,0
9984,9985,Whitefield,212600,169610,42990,0.2022107243650047,1
9985,9986,Rajajinagar,274900,35810,239090,0.8697344488905057,0
9986,9987,Krishnarajapuram,210150,87770,122380,0.5823459433737807,1
9987,9988,Shivajinagar,442000,79280,362720,0.8206334841628959,-1
9988,9989,Shivajinagar,107900,35160,72740,0.6741427247451344,0
9989,9990,Jalahalli,337600,91110,246490,0.7301244075829384,-1
9990,9991,Varthur,104050,67980,36070,0.3466602594906295,1
9991,9992,Whitefield,389150,81780,307370,0.7898496723628421,0
9992,9993,Hebbal,186750,5310,181440,0.971566265060241,-1
9993,9994,Krishnarajapuram,59700,78480,-18780,-0.314572864321608,1
9994,9995,Vasanth Nagar,404700,60640,344060,0.8501606127996046,-1
9995,9996,Vasanth Nagar,343850,77650,266200,0.7741747855169405,-1
9996,9997,Kalyan Nagar,270100,36160,233940,0.8661236579044799,-1
9997,9998,Hoodi,95250,63680,31570,0.3314435695538058,1
9998,9999,Kammanahalli,64700,43960,20740,0.3205564142194745,1
9999,10000,Shivajinagar,191350,0,191350,1.0,-1
